Abdullah Gul	Abdullah Gül
Kim Daejung	Kim Daejung
National Front	National Front
Hong Kong Division D Football League	Hong Kong Fourth Division League
Songshan District	Songshan District Taipei
Ernst King	Ernest King
Colentis Paulista Sports Club	Sport Club Corinthians Paulista
The Kingdom of Württemberg	Kingdom of Württemberg
IBooks	IBooks
Joachim Gauck	Joachim Gauck
Hohhot	Hohhot
John Wall	John Wall
Gaston Ramelis	Gastón Ramírez
Jesper Grenshire	Jesper Grønkjær
Laconnei	Laconnex
Ernest Rutherford	Ernest Rutherford
Convair	Convair
Federica Mogherini	Federica Mogherini
Ahmed Shah Bahadur	Ahmad Shah Bahadur
Yu Hai	Yu Hai
Govishian	Gwichin language
Ignatius Loyola	Ignatius of Loyola
Linux	Linux
F15E Strike Eagle fighterbomber	McDonnell Douglas F15E Strike Eagle
Ito Hirofumi	Itō Hirobumi
Corey Booker	Cory Booker
Luzhu District	Lujhu District
Vassiliki Sanu	Vassiliki ThanouChristophilou
Feng Guozhang	Feng Guozhang
Perfect Crime	Perfect Crime
Christian Nimet	Krisztián Németh
Semeria	Sammir
Yampa River	Yampa River
nicosia	Nicosia
Eric Harris and Dylan Klebold	Eric Harris and Dylan Klebold
ItalianWestern Romance	ItaloWestern languages
Wanna Mama	Divas in Distress
Block B	Block B
Rong Yiren	Rong Yiren
Dingxi	Dingxi
Au Qianyi	Cindy Au
Ahmed MartinDavtari	Ahmad MatinDaftari
Chinese characters	Chinese characters
Sun Xiang	Sun Xiang
Ishigaya	City of Rockdale
Bukit Jalil National Stadium	Bukit Jalil National Stadium
Malay	Malay language
esbjerg	Esbjerg
Walter Gilbert	Walter Gilbert
Chris Paul	Chris Paul
Shoushan District	Moriyamaku Nagoya
Keiyo Road	Keiyō Road
Universal Studios Hollywood	Universal Studios Hollywood
Aaron Burr	Aaron Burr
Jiang Minshou	Kang Minsoo
Rudolf Hess	Rudolf Hess
Anhui Province	Anhui
The First Confession of Love	Baby One More Time
Lin Fengjiao	Lin Fengjiao
Sai Chong	Say Chhum
London Heathrow Airport	Heathrow Airport
Yunfu City	Yunfu
Zhang Linpeng	Zhang Linpeng
Qatar Star Football League	Qatar Stars League
Rhodesia	Rhodesia
Bob Casey	Bob Casey Jr
Alex Lynn	Alex Lynn
Heechul	Kim Heechul
Samsung Group	Samsung
Kingdom of Iraq	Kingdom of Iraq
alcoy	Alcoy Spain
Igbo	Igbo language
Napoleon I	Napoleon
Alexander Millerand	Alexandre Millerand
Barnsley Football Club	Barnsley FC
Tokyo Incident	Tokyo Jihen
Sardin Skoda Sports	Skoda Xanthi FC
Luan	Luan
2012 Summer Olympics	2012 Summer Olympics
Han Seungsoo	Han Seungsoo
Carl XVI Gustaf	Carl XVI Gustaf of Sweden
Mali	Mari language
woods	Shulin District
sky	Sky
Royal Astronomical Society Gold Medal	Gold Medal of the Royal Astronomical Society
Doom Series	Doom
Vasily Danilovich Sokolovsky	Vasily Sokolovsky
Prince Arthur	Prince Arthur Duke of Connaught and Strathearn
Butterfly	Butterfly
Preston Football Club	Preston North End FC
NVIDIA GeForce 9	GeForce 9 series
Huesca Province	Province of Huesca
Think of me no more tears	Think of Me No More Tears
The Knights Hospitaller	Knights Hospitaller
Girls Generation	Girls Generation
Comcast	Comcast
Imir Haka	Emil Hácha
Kurdish Supreme Council	Kurdish Supreme Committee
Oromo	Oromo people
LOVE PiECE	Love Piece
Britney	Britney
Muse Band	Muse
Kanaan Banana	Canaan Banana
Warringa Council	Warringah Council
Marilyn Manson	Marilyn Manson
srinagar	Srinagar
Vivendi	Vivendi
coalition90 greens	Alliance 90 The Greens
Zhu Zhenmo	Joo Jinmo
Jamal AbdulNasser	Gamal Abdel Nasser
Mabuya Institute of Technology	Mapúa Institute of Technology
Ogiwa Station	Ogikubo Station
Kevin Phillips	Kevin Phillips
Homs	Homs
Shu Chang	Shu Chang
MY SUGAR CAT	My Sugar Cat
Pujie	Pujie
Marlon Jingzhi	Marlon King
AustroHungary	AustriaHungary
2014 Asian Games	2014 Asian Games
Samuel Osgood	Samuel Osgood
Uyghur	Uyghurs
Makino Tomoaki	Tomoaki Makino
Macau Radio and Television Corporation	TDM
Kuibyshev Reservoir	Kuybyshev Reservoir
Orhan I	Orhan of the Ottoman Empire
heavy metal	Heavy metal music
University of Toronto	University of Toronto
Gunnar Thorodesen	Gunnar Thoroddsen
Li Jiawei	Jess Lee
Premier of the State Council of the Peoples Republic of China	Premier of the Peoples Republic of China
Bangkok	Bangkok
Wang Zhaoguo	Wang Zhaoguo
wyoming	Wyoming
UnrealEngine	Unreal Engine
The Pet Girl of Sakurasou	The Pet Girl of Sakurasou
Duran Duran	Duran Duran
Luis Adriano	Luiz Adriano
nor	Nord
Emperor Wei Xiaowen	Emperor Xiaowen of Northern Wei
Pope Felix I	Pope Felix I
China Womens National Football Team	China womens national football team
Real Mallorca Athletic	RCD Mallorca
KATTUN	KATTUN
Trey Cool	Tré Cool
Judy Costa	Jodie Foster
Amerika	Amerika
F4	F4
Fort Pierce	Fort Pierce Florida
Benhua Mandelbrot	Benoit Mandelbrot
Lyman Spitzer	Lyman Spitzer
Elva Hsiao	Elva Hsiao
Li Fangzi	Yi Bangja
CSKA Moscow	PFC CSKA Moscow
Miyazawa Sae	Sae Miyazawa
Qingpu Kuiwu	Kiyoura Keigo
T50 Fighter	Sukhoi PAK FA
IPad	IPad
Kingdom of Bulgaria	Kingdom of Bulgaria
Micronesian	Micronesian languages
Jaya Bakhan	Jaya Bachchan
Edition Lima	Ildefons Lima
HTC One Mini 2	HTC One Mini 2
John Corning	John Cornyn
Junkie XL	Junkie XL
Hurricane Gordon	Hurricane Gordon
Roman Pavlyuchenko	Roman Pavlyuchenko
Louis Saint Laurent	Louis St Laurent
Mauritz of Nassau	Maurice Prince of Orange
Horace Lamb	Horace Lamb
Liu Jiahao	Lau Karho
Xu Xiangqian	Xu Xiangqian
Fennis Morley	Ramiro Funes Mori
Administrative Divisions of Tennessee	List of counties in Tennessee
Bi Shujin	Bii
LatinFalih	LatinoFaliscan languages
Felipe II	Philip II of Spain
Doug Rivers	Doc Rivers
TIME	Time
Lee Tenghui	Lee Tenghui
Li Ka Shing Faculty of Medicine The University of Hong Kong	Li Ka Shing Faculty of Medicine
Zilina Football Club	MŠK Žilina
Ranger 8	Ranger 8
Minangkabau	Minangkabau language
Benevolent Decoding	A Great Way to Care
Numerian	Numerian
LetoRomansian	RhaetoRomance languages
Esbjerg United Football Club	Esbjerg fB
Wales	Wales
HTC First	HTC First
Jiang Bingkun	Chiang Pinkung
Wang Guoming	Wang Guoming
Fujisawa City	Fujisawa Kanagawa
British Virgin Islands	British Virgin Islands
Wing Train	Tsubasa
Grant County	Grant County Washington
Sham Shui Po Sports Association Football Team	Sham Shui Po SA
Beihan	Northern Han
Battle of Bunker Hill	Battle of Bunker Hill
Zhang Jizhong	Zhang Jizhong
missouri	Missouri
Yu Zhengsheng	Yu Zhengsheng
Lotus	Lotus
City of Willoughby	City of Willoughby
Mohenbagan Athletic Club	Mohun Bagan AC
Park Yejin	Park Yejin
Ranger 5	Ranger 5
University of Westminster	University of Westminster
Olusegun Obasanjo	Olusegun Obasanjo
Republic of China	Republic of China
Ma Guoming	Kenneth Ma
Erich Honecker	Erich Honecker
Sun Mingyang	Michael Suen
Hu Xia	Hu Xia
France Perkins	Frances Perkins
University of Science and Technology of China	University of Science and Technology of China
San Stephen Lutu	Shane Stefanutto
XNA Game Studio Express	Microsoft XNA
Fire Ambition 3	Burning Flame III
Lauren Gosney	Laurent Koscielny
Akira Yamaoka	Akira Yamaoka
Nayef bin AbdulAziz alSaud	Nayef bin AbdulAziz Al Saud
LouisElisabeth	Louise Élisabeth of France
shuley	Choulex
Khmer	Khmer alphabet
Mansi	Mansi language
Benito Mussolini	Benito Mussolini
Supernova Flashman	Choushinsei Flashman
Stay by my side	Stay by My Side
Juan Manuel Santos	Juan Manuel Santos
Prince Michael	Prince Michael of Kent
Richard Burton	Richard Burton
Nicolas IV	Pope Nicholas IV
German Chancellor	Chancellor of Germany
Hunan University	Hunan University
Ryoichi Maeda	Ryoichi Maeda
Nguyen Minh Chay	Nguyễn Minh Triết
Nicholas Fissgrat	Nick Fitzgerald
William Howe  5th Viscount Howe	William Howe 5th Viscount Howe
Victor Moses	Victor Moses
Media Go	Media Go
Pashtun	Pashtuns
Blood Devourer	Strike the Blood
Zhong Jinghui	Chung Kingfai
Ergun	Argun River
I am a comedy maniac	30 Rock
Marek Matejowski	Marek Matějovský
Kofu City	Kōfu
William John Duane	William J Duane
Henrik Ibsen	Henrik Ibsen
Victor Zubkov	Viktor Zubkov
Marina County	Princess Marina of Greece and Denmark
Nuri Maliki	Nouri alMaliki
Daniel Forlander	Daniel Vorländer
Meng Jianzhu	Meng Jianzhu
XMen	XMen
Air Transat Flight 236 Accident	Air Transat Flight 236
Ranger 4	Ranger 4
Catholic Diocese of Hexham  Newcastle	Roman Catholic Diocese of Hexham and Newcastle
University of Padova	University of Padua
vampire detective	Vampire Detective
Sicilian	Sicilian language
Alvaro Uribe Velez	Álvaro Uribe
Korea Baseball Committee	Korea Baseball Organization
vatican	Vatican City
Fettlee Sullenson	Frederik Sørensen
Braveheart	Braveheart
Piedmont	Piedmont
Love the world	Love the World
Changshou Yangtze River Bridge	Changshou Yangtze River Bridge
Carlos CoimbraDalus	Carlos Luz
Dont Don	Dont Don
Aleppo Governorate	Aleppo Governorate
George V	George V
Minangjiabaoren	Minangkabau people
Carloman	Carloman of Bavaria
Ozzie Osborne	Ozzy Osbourne
Jin Junsu	Kim Junsu
Windsor	Windsor Berkshire
Liang Zijun	Leung Tsz Chun
Basabawen	Phagspa script
nairobi	Nairobi
Jacques Chirac	Jacques Chirac
Haryana	Haryana
WilhelmAlexander	WillemAlexander of the Netherlands
Superman	Superman
Hong Kong Group C	Hong Kong Third A Division League
Roman Empire	Roman Empire
Atahualpa	Atahualpa
Masselu Karuska	Marcelo Carrusca
tennessee	Tennessee
Timothy Pickering	Timothy Pickering
Mikhail Mikhailovich Kasyanov	Mikhail Kasyanov
Cesar Azpilicueta	César Azpilicueta
Zhang Jianfeng	Cheung Kin Fung
Jaime	Prince Jaime Count of Bardi
Suwa City	Suwa Nagano
Oakland Airport	Auckland Airport
Guo Keying	Kenix Kwok
IPod touch 5	IPod Touch
Bronx	The Bronx
Hina Rabbani Hale	Hina Rabbani Khar
Brooklyn	Brooklyn
Queens University	Queens University
Grigor Mgaloblishvili	Grigol Mgaloblishvili
Jin Chengyong	Kim SongYong
Roberto Carlos	Roberto Carlos
Māori	Māori language
Rolling Stones	The Rolling Stones
Lucas Biglia	Lucas Biglia
Bohemian Rhapsody	Bohemian Rhapsody
Mark Rutte	Mark Rutte
cody	Cody Wyoming
Oromo	Oromo language
Li Yapeng	Li Yapeng
Jetro Williams	Jetro Willems
borneo	Borneo
IU	IU
Qantas flight 32 accident	Qantas Flight 32
Airbus A330	Airbus A330
ChuHan War	ChuHan Contention
Uzbekistan	Uzbekistan
Lauda Airlines	Lauda Air
Keiko Hirono	Mazie Hirono
paraguay	Paraguay
David Perdue	David Perdue
ML language	ML
Victor Cavendish 9th Duke of Devonshire	Victor Cavendish 9th Duke of Devonshire
Mozilla Corporation	Mozilla Corporation
Chen Yuzong	Trần Dụ Tông
Ukrainian Premier League	Ukrainian Premier League
Maria Vladimirovna	Maria Vladimirovna Grand Duchess of Russia
John Barrasso	John Barrasso
Shenzhou IX	Shenzhou 9
Order of the Garter	Order of the Garter
Brigitte Lin	Brigitte Lin
Huajiabao Football Club	Workable FC
William Gladstone	William Ewart Gladstone
Kawagenecho	Kawanehon
SeeSaw	SeeSaw
Ministry of Industry and Information Technology of the Peoples Republic of China	Ministry of Industry and Information Technology
Hippolyto II Este	Ippolito II dEste
Windows Server 2003	Windows Server 2003
Emperor Entertainment	Emperor Entertainment Group
Nish	Niš
Li Yizhen	Ailee
Singapore Airlines	Singapore Airlines
Drums and Bass	Drum and bass
Huang Jingyi	Xiao Xun
Medlin	Medellín Spain
Bulgarian	Bulgarian language
Laramie	Laramie Wyoming
Joseph Desha	Joseph Desha
Adnan Januzaj	Adnan Januzaj
Big Infinity	Do As Infinity
Southern Alps	MinamiAlps Yamanashi
Je tangerine unfinished	Mikan
Tang Shaoyi	Tang Shaoyi
Aurelio	Aurelius of Asturias
Abdullah Sani	Abdullah alThani
Los Angeles International Airport	Los Angeles International Airport
Su Yu	Su Yu
Colin Trevorrow	Colin Trevorrow
Nicholas of Kusa	Nicholas of Cusa
Amad Zahid	Ahmad Zahid Hamidi
Leiden	Leiden
Grand Alliance War	Nine Years War
Belgium national under21 football team	Belgium national under21 football team
Philips Stadium	Philips Stadion
Love Dream	Dream of Love
Na Quotations	Confessions on a Dance Floor
Durham	Durham North Carolina
Delft	Delft
Lavrenti Pavlovich Beria	Lavrentiy Beria
Austrian German	Austrian German
Carol II	Carol II of Romania
Beep Sunshine Sunshine	Beep
Emanuel Levinas	Emmanuel Levinas
Mr Taxi Run Devil Run	Mr Taxi
Central Mountains	Sistema Central
Paul Simon	Paul Simon
Genz Arpad	Árpád Göncz
Croatian Football League	Croatian First Football League
Ateneo de Manila University	Ateneo de Manila University
Crisis Core Final Fantasy VII	Crisis Core
Pope Ho Mi	Pope Hormisdas
Gijón	Gijón
Sven Bender	Sven Bender
Russia under21 national football team	Russia national under21 football team
Dragon Ash	Dragon Ash
2PM	2PM
dawn	Leon Lai
Medinacelli	Medinaceli
Airbus A300	Airbus A300
Cebuano	Cebuano language
Eddie Francis	Eddy Francis
Dundee United Football Club	Dundee United FC
Toyota City	Toyota Aichi
Fang Datong	Khalil Fong
Jin	Jin Chinese
Dish Network	Dish Network
HTC One Max	HTC One Max
Victoria Sports Association	Vitória SC
Bulent Ecevit	Bülent Ecevit
Chivas USA	Chivas USA
Cao Huan	Cao Huan
Working Peoples Progressive Party	Progressive Party of Working People
cali	Cali
Maltese	Maltese language
Iran Professional Football League	Persian Gulf Pro League
UVERworld	Uverworld
Ich tu dir weh	Ich tu dir weh
Samsung Galaxy S4	Samsung Galaxy S4
Malta	Malta
Audi RSQ	Audi RSQ
William I	William I of the Netherlands
Tony Bosta	Toni Polster
Russian Soviet Federal Socialist Republic	Russian Soviet Federative Socialist Republic
Tony Blair	Tony Blair
Gulf of Mexico	Gulf of Mexico
Roadshow Movies	Village Roadshow Pictures
So Into You	So into You
Steven Spielberg	Steven Spielberg
Moments	Moments
The Who	The Who
ITunes Store	ITunes Store
Flaming Team Thunderer	Engine Sentai Goonger
French Second Empire	Second French Empire
Elliott Spitzer	Eliot Spitzer
Queen Tai	Tiye
Sizo	Sizzo Prince of Schwarzburg
Yang Jing	Yang Jing
Jeremy Corbyn	Jeremy Corbyn
Royal Victorian Medal	Royal Victorian Order
Foshan	Foshan
Tianjin Tuanbo Football Stadium	Tianjin Tuanbo Football Stadium
Takanashi Yasuji	Yasuharu Takanashi
Jigme Singh Wangchuck	Jigme Singye Wangchuck
Cao Kun	Cao Kun
Maggie Gyllenhaal	Maggie Gyllenhaal
Mao Anqing	Mao Anqing
Logic Pro	Logic Pro
My Savage Granny	Wars of Inlaws
Des Voeux	William Des Vœux
Florida Administrative Divisions	List of counties in Florida
Zheng Xiujing	Krystal Jung
Emma Thompson	Emma Thompson
buckinghamshire	Buckinghamshire
Hiranuma Kiichiro	Hiranuma Kiichirō
The beginning of the end	The Beginning of the End
Socialist	Parti Socialiste
Lin Zhenyi	Lin Chenyi
MusashiKosugi Station	MusashiKosugi Station
Zheng Jing	Zheng Jing
Coalition Interim Administration in Iraq	Coalition Provisional Authority
Queer III Arena	Quake III Arena
Tocharian	Tocharian languages
Ashikaga Yoshimitsu	Ashikaga Yoshimitsu
MeeGo	MeeGo
lublin	Lublin
Sauley Niinisto	Sauli Niinistö
monarchs of Canada	Monarchy of Canada
Ramiz Alia	Ramiz Alia
Qiu Yuming	Chiu Yu Ming
Deus Ex	Deus Ex
Hun Sen	Hun Sen
Ren Rongxuan	Lorene Ren
Chile	Chile
Sagamihara Sports Association	SC Sagamihara
Nezid Sultanate	Sultanate of Nejd
ChachaiChunhawang	Chatichai Choonhavan
Frank O Horton	Frank O Horton
Nabataean Alphabet	Nabataean alphabet
Tu Xingzhe	Twu Shiingjer
Tokugawa Keirai	Tokugawa Yoshiyori
Cai Peixuan	Wayne Chua
Didier Drogba	Didier Drogba
Steppe Mali	Meadow Mari language
WindsorMaidenhead	Royal Borough of Windsor and Maidenhead
Jetstar	Jetstar Airways
Sultan Tuanku Abdul Halim	Abdul Halim of Kedah
La Palma Island	La Palma
Joetsu Shinkansen	Jōetsu Shinkansen
University of Chicago	University of Chicago
Reading Football Club	Reading FC
Rais Yading	Rais Yatim
Tomiya Nagase	Tomoya Nagase
Archduke Franz Karl	Archduke Franz Karl of Austria
JewishMoroccan	JudeoMoroccan Arabic
The Great Divide	Great Dividing Range
Wen Jiabao	Wen Jiabao
The Long River	River of No Return
Jersey City	Jersey City New Jersey
Shen Zuyao	Joseph Sung
Kanji	Kanji
Apache Software Foundation	Apache Software Foundation
OweniRhôneAlpes	AuvergneRhôneAlpes
Mischievous Kiss	Playful Kiss
Delaware	Delaware
Bernay	Bernex Switzerland
Leland Stanford	Leland Stanford
Subrati Bell	Subrata Pal
Lin Zhengji	Lim Jeonghee
South Ossetia	South Ossetia
Jade Realization	Nami Tamaki
Greenland	Greenland
Marco Jason	Mark Jansen
Kansas City Athletic Conference	Sporting Kansas City
Innocent II	Pope Innocent II
Cádiz Football Club	Cádiz CF
Lakhdar Brahimi	Lakhdar Brahimi
Jung Junhong	Fred Cheng
Jose Antonio Reyes	José Antonio Reyes
Yiwan Railway Wanzhou Yangtze River Bridge	Wanzhou Railway Bridge
Anne of Brittany	Anne of Brittany
Murad II	Murad II
Toledo	Toledo Spain
Herbie Hancock	Herbie Hancock
Toulouse Football Club	Toulouse FC
Mariah Carey	Mariah Carey
Berry Football Club	Bury FC
Libor Sionco	Libor Sionko
Dewey	Du Wei
Hakonemachi	Hakone
London School of Economics	London School of Economics
Robert Gibbs	Robert Gibbs
Zhao Quan	Jo Kwon
ARASHI No1 Arashi Calls the Storm	Arashi No1 Ichigou
quito	Quito
Android Lollipop	Android Lollipop
Awa German	Awadhi language
create	Changjo
Lincoln Township	Lincoln Township Butler County Kansas
Ahmed Gawam	Ahmad Qavam
Eleanor of Aquitaine	Eleanor of Aquitaine
Pope Nile	Pope Eleuterus
Scottish League Two	Scottish Football League Second Division
Whig	Whig Party
PyrénéesOrientales	PyrénéesOrientales
Oxfordshire	Oxfordshire
Wu Qing	Wu Qing
Wang Qishan	Wang Qishan
Sho Tanaka	Masahiro Tanaka
Nazi German Navy	Kriegsmarine
Practicing Medicine	The Oath
Ministry of Railways of the Peoples Republic of China	Ministry of Railways
Kingdom of Bohemia	Kingdom of Bohemia
Lin Wenlong	Frankie Lam
Ashikaga	Ashikaga Tochigi
Alessandro Pertini	Sandro Pertini
Lake Biwa	Lake Biwa
Pensacola	Pensacola Florida
Grow into one	Grow into One
West Himalayan	West Himalayish languages
Newcastle Jets Football Club	Newcastle Jets FC
Gurung	Gurung language
Yu Hongjun	Yu HungChun
Dakar University	Cheikh Anta Diop University
Fukaya	Fukaya Saitama
Santa Cruz de Tenerife	Santa Cruz de Tenerife
Newton Booth	Newton Booth
Sorbian	Sorbian languages
Lin Xinru	Ruby Lin
Incheon International Airport	Incheon International Airport
Li Zhengxiu	Lee Jungsoo
Jia Nailiang	Jia Nailiang
Its Not Me Its You	Its Not Me Its You
CH47 helicopter	Boeing CH47 Chinook
Charles de Freycinet	Charles de Freycinet
ObiUgric Languages	ObUgric languages
starbick football club	Stabæk Fotball
Hata Shunroku	Shunroku Hata
Orange	Natural
Tan Yankai	Tan Yankai
Tang Gaozong	Emperor Gaozong of Tang
Norway national under21 football team	Norway national under21 football team
Beiyang Government	Beiyang government
Brian May	Brian May
Figure154	Tupolev Tu154
Aramgil II	Alamgir II
Northern Wei Dynasty	Northern Wei
Victoria Merita	Princess Victoria Melita of SaxeCoburg and Gotha
Bruno Mars	Bruno Mars
Bandai Namco Entertainment	Bandai Namco Entertainment
Idol Manifesto	Kirarin Revolution
Soviet Occupation	Soviet occupation zone
Yamagata Prefecture	Yamagata Prefecture
new south wales	New South Wales
Toyama City	Toyama Toyama
Etihad Football Club	Ittihad FC
Olav V	Olav V of Norway
International Organization for Standardization	International Organization for Standardization
Isle of Man	Isle of Man
Samsung Galaxy S III	Samsung Galaxy S III
Seattle University	Seattle University
New Line Cinema	New Line Cinema
Gediminas Kirkiras	Gediminas Kirkilas
shanwei	Shanwei
Dewitt Howard	Dwight Howard
St Thomas Hospital	St Thomas Hospital
Belgium National Football Team	Belgium national football team
Richard Hammond	Richard Hammond
Gontis Ulmanis	Guntis Ulmanis
Jilin City	Jilin City
Alfonso XIII	Alfonso XIII of Spain
stalbans	St Albans
avantgarde metal	Progressive metal
DutchAmerican	Dutch Americans
Polish Government in Exile	Polish governmentinexile
blackberry	BlackBerry
Wechli	Vasco Joaquim Rocha Vieira
Auburn Council	City of Auburn
Zuo Penrina	João Pereira
EA Canada	EA Canada
Iwate	Iwate Prefecture
Sodnomu Damuddinbazar	Jalkhanz Khutagt Sodnomyn Damdinbazar
Peng Shiguo	John Prescott
AMD K8	AMD K8
Haakon VI	Haakon VI of Norway
Samsung Galaxy Note 3	Samsung Galaxy Note 3
Kelly Ayotte	Kelly Ayotte
Sanming	Sanming
Apple A6	Apple A6
national language	Kunigami language
Gille Deleuze	Gilles Deleuze
Yang Zhenning	ChenNing Yang
Giovanni Lanza	Giovanni Lanza
Hirota Hony	Kōki Hirota
ClaasJan Huntelaar	KlaasJan Huntelaar
Tianzhangyuan	Tenshōin
Ante Rebic	Ante Rebić
Hino City	Hino Tokyo
National Autonomous University Club	Club Universidad Nacional
Alexander Hamilton	Alexander Hamilton
Mariner 9	Mariner 9
Kaohsiung International Airport	Kaohsiung International Airport
Ye Yunyi	Gloria Yip
John Backus	John Backus
Ayutthaya Kingdom	Ayutthaya Kingdom
Douglas DC9	McDonnell Douglas DC9
Xiaoyi Pure Queen	Empress Xiaoyichun
Lord John Cavendish	Lord John Cavendish
Maximinus	Maximinus II
Gyeonggido	Gyeonggi Province
rollins	Rawlins Wyoming
MuhammadReza Rahimi	Mohammad Reza Rahimi
jaws	Great white shark
This Is It	This Is It
Nightwish	Nightwish
Princeton Institute for Advanced Study	Institute for Advanced Study
Marathi	Marathi language
Royal Netherlands Air Force	Royal Netherlands Air Force
Douglas DC4	Douglas DC4
Saga Prefecture	Saga Prefecture
Music Box	Music Box
Columbus Crews Football Club	Columbus Crew SC
Rene Coty	René Coty
Prime Minister of Russia	Prime Minister of Russia
Najib Abdul Razak	Najib Razak
Inokiela	Enoggera Queensland
FC Dallas	FC Dallas
Yasuda Polytechnic University	Michihiro Yasuda
Masu	Ma Su
bankading	Ben Cardin
Hugh Capet	Hugh Capet
Charles Dickens	Charles Dickens
Niki Minaj	Nicki Minaj
Hiratsuka	Hiratsuka Kanagawa
Wang Zulan	Wong Cholam
Emperor Houguangyan	Emperor GoKōgon
Mexico National Football Team	Mexico national football team
kiss here	Koko de Kiss Shite
Hainan Province	Hainan
bruch	Bruges
Ilkhanate	Ilkhanate
IKON	IKON
The Detective Case of Tsuen Jia Fu Lu Shou	Super Snoops
Karl August	Charles Augustus Hereditary Grand Duke of SaxeWeimarEisenach
STARSHIP Entertainment	Starship Entertainment
Biology Chief	Ikimonogakari
Podapaya	Bodawpaya
Muya	Muya language
Gilan	Gilan Province
Argentina Football League	Argentine Primera División
Zhao Xuri	Zhao Xuri
DC Comics	DC Comics
bilings	Billings Montana
SeeYa	SeeYa
Jane Dee Hull	Jane Dee Hull
Kofi Annan	Kofi Annan
Charles III	Charles the Simple
Nivkh	Nivkh language
Carl Edward	Charles Edward Duke of SaxeCoburg and Gotha
David Martin	David Martin
gem pet Twinkle☆	List of Jewelpet Twinkle episodes
Henry Dearborn	Henry Dearborn
Ye Kuanwen	Sally Yeh
Oregon State University	Oregon State University
Joseon Dynasty	Sunjong of Korea
Luigi Facta	Luigi Facta
South Vietnam National Liberation Front	Viet Cong
Flindersshire Government	Shire of Flinders
cordoba	Córdoba Andalusia
Lee Jong Hyun	Lee Jonghyun
Higashi Maizuru Station	HigashiMaizuru Station
Sean Donovan	Shaun Donovan
Ruprecht	Rupprecht Crown Prince of Bavaria
European United Left Nordic Green Left	European United LeftNordic Green Left
Winter Bells	Winter Bells
Allied military occupation of Germany	Alliedoccupied Germany
Yonezawa	Yonezawa Yamagata
weilan	Janice Vidal
B language	B
Republic of Tatarstan	Tatarstan
Shin Jiongmin	Shin Hyungmin
Qi Qin	Chyi Chin
Yoshihiko Noda	Yoshihiko Noda
States and Territories of India	States and union territories of India
Sergei Nikolaevich Vinogradsky	Sergei Winogradsky
Rainbow Orchestra	LArcenCiel
Dean FCO	Dijon FCO
Craig L Thomas	Craig L Thomas
Li Xiangning	Shannon Lee
Yokkaichi City	Yokkaichi Mie
England Under17 Football Team	England national under17 football team
Bai Chongxi	Bai Chongxi
Sui Wendi	Emperor Wen of Sui
Victory Entertainment	Victor Entertainment
Guangzhou East Railway Station	Guangzhou East Railway Station
Cerritos	Cerritos California
Tony Brown	Tony Brown
Pope Felix III	Pope Felix III
Elisabeth Line	Crossrail
Palauan	Palauan language
Game Boy Advance	Game Boy Advance
Betty Ford	Betty Ford
jesuit	Society of Jesus
Versoix	Versoix
Miguel Monteiro	Miguel Monteiro
Tarren Rue	Tyronn Lue
funk	Funk
Welsh Party	Plaid Cymru
Yang Lan	Yang Lan
Longfordshire	County Longford
Alan Stephenson Boyd	Alan Stephenson Boyd
196869 UEFA Champions League	196869 European Cup
Chinese Canadian	Chinese Canadians
Austrian Premier League	Austrian Football Bundesliga
Sergio Ramos	Sergio Ramos
Sakata City	Sakata Yamagata
Bishkek Dodoi Football Club	FC Dordoi Bishkek
mostar	Mostar
Stoke Harbor Football Club	Stockport County FC
Southwest Airlines	Southwest Airlines
Medal of Honor Series	Medal of Honor
Hannah Arendt	Hannah Arendt
Lee Sangchul	Ri Sangchol
Hainan	Hainanese
Shaw Newsletter	Shaw Communications
entertainment	Variety
Supreme Peoples Assembly	Supreme Peoples Assembly
Irish Premier League	League of Ireland Premier Division
John Abbott	John Abbott
Golden Gale	Gold Typhoon
Yoran Persson	Göran Persson
Michael Bay	Michael Bay
Black Entertainment Television	BET
Yang Xiuhui	Vivien Yeo
Dina Bint Abdul Hamid	Dina bint AbdulHamid
Lawton Collins	J Lawton Collins
Hong Kong Island	Hong Kong Island
Feel my soul	Feel My Soul
Gene Wolfe	Gene Wolfe
Lothar Matthaus	Lothar Matthäus
Boys and Girls Over Flowers	To the Beautiful You
Jalandhar County	Jalandhar district
Burhanuddin Rabbani	Burhanuddin Rabbani
Order of StJohn	Order of Saint John
F A18E F Super Hornet Strike Fighter	Boeing F A18E F Super Hornet
Jerry Yan	Jerry Yan
Eric Edman	Erik Edman
Astro Joy HD	Astro Xi Yue HD
Christian College	Christs Hospital
lily of the valley	Lily of the valley
Gustav V	Gustaf V of Sweden
Real Emotion A thousand words	Real Emotion 1000 no Kotoba
Chengqiang Liu	Low Thia Khiang
Second House of the Dutch Parliament	House of Representatives
Passion	Passion
Snow Pink	Snow Pink
Thomas Hobbes	Thomas Hobbes
Ruhr Stadium	Ruhrstadion
Polish Air Force	Polish Air Force
Wang Gengwu	Wang Gungwu
The Iraq War	Iraq War
Sweet Exit	The Sweet Escape
Jinan	Jinan
Miracle	Kiseki
Paul Wolfowitz	Paul Wolfowitz
KarateUde	Calatayud
Jin Zhourong	Kim Juyoung
Stanislaw I	Stanisław Leszczyński
Even if	Even If
Giannina Athletic Club	PAS Giannina FC
GalloRoman	GalloRomance languages
BeijingGuangzhou Railway	BeijingGuangzhou Railway
Red Star Awards 2004	Star Awards 2004
The Hague	The Hague
Suffering	Sōnan
S7 Aviation	S7 Airlines
Khmer Empire	Khmer Empire
Luo Fanjiaofen	Fanny Law
Part and All DIVE	Ichibu to Zenbu Dive
Brest Football Club	Stade Brestois 29
David Longy	David Lange
Watford Football Club	Watford FC
monthly Comp Ace	Monthly Comp Ace
Iker Casillas	Iker Casillas
Everton Park District	Everton Park Queensland
Urasoe Castle	Urasoe Castle
selangor	Selangor
McDonnell Douglas DC10	McDonnell Douglas DC10
US Senate President pro tempore	President pro tempore of the United States Senate
Giuseppe Saraguete	Giuseppe Saragat
Glasgow Caledonian University	Glasgow Caledonian University
Saint Paul	Saint Paul Minnesota
AbdulHussein Mirza Falman Falma	AbdolHossein Farmanfarma
The longing future longing future	Natsukashii Mirai
Economic Development Committee Executive Yuan	Council for Economic Planning and Development
Joseph Pinkowski	Józef Pińkowski
Ximen Station	Ximen Station
University of Notre Dame	University of Notre Dame
Chant of Colors Lonely Dawn	Irohanihoheto
CANDY GIRL	Candy Girl
Muhammad Iqbal	Muhammad Iqbal
Emperor Takakura	Emperor Takakura
Malaysian League One	Malaysia Premier League
LabVIEW	LabVIEW
Ferdinand I	Ferdinand I of Romania
Liu Chan	Liu Shan
West Sumatra	West Sumatra
Cheltenham	Cheltenham
Adaton Jose Dos Santos Filho	Adaílton José dos Santos Filho
Arthur Griffith	Arthur Griffith
sri Lanka	Sri Lanka
Lu Xun	Lu Xun
Edmund Burke	Edmund Burke
Ennington Stanley Football Club	Accrington Stanley FC
MONSTER	Monster
rosebowl	Rose Bowl
Ben Yusuf Ben Heda	Benyoucef Benkhedda
Goth Metal	Gothic metal
Pascal	Pascal
David Ganluney	David Connolly
Borut Pahor	Borut Pahor
Ashley Gower	Ashley Cole
Vittorio Emanuele III	Victor Emmanuel III of Italy
Hirano blog post	Hirofumi Hirano
James Barber	James Barbour
Frederick John Robinson 1st Viscount Godric	F J Robinson 1st Viscount Goderich
University of Lausanne	University of Lausanne
Friends	Friends
Windows 10	Windows 10
Feel my mind	Feel My Mind
Major League Baseball	Major League Baseball
Huang Xiaoming	Huang Xiaoming
John Carvey	John Carew
Gao Huazhu	Kao Huachu
Mean Mr Mustard	Mean Mr Mustard
Alessandro Gamberini	Alessandro Gamberini
Brazil Cup	Copa do Brasil
Roberto I	Robert I Duke of Parma
Deng Lianru	Lydia Dunn Baroness Dunn
Tang Shiyong	Natalie Tong
Sledgehammer Games	Sledgehammer Games
Shanyouzu	San Diu people
NEC Nijmegen	NEC
Ali Ben Flis	Ali Benflis
Daegu Football Club	Daegu FC
Agent Carter	Agent Carter
The Empire of Japan	Empire of Japan
Ernst	Ernst Prince of SaxeMeiningen
Black Widow	Black Widow
Orange County Storm	The OC
National Army of the Republic of Korea	Republic of Korea Armed Forces
2008 Tropical Storm Edward	Tropical Storm Edouard
Pondicherry	Pondicherry
Sony Xperia Z	Sony Xperia Z
Mediacorp Channel 8	Mediacorp Channel 8
1989  UEFA Cup 90	198990 UEFA Cup
beidou	Hokuto Yamanashi
Hans Geiger	Hans Geiger
Ota Kosuke	Kosuke Ota
Fujita Naoyuki	Naoyuki Fujita
ONE LIFE	One Life
JAR	JAR
Federal Reserve System	Federal Reserve System
Maria Leticia Ramolino	Letizia Ramolino
Space Rock	Space rock
NHK Global Broadcasting Network	NHK World
Alfonso I Durst	Alfonso I dEste Duke of Ferrara
Sony Xperia V	Sony Xperia V
Selkur	Sarikoli language
Idlib Governorate	Idlib Governorate
Obviously	Obviously
Sharadavin	Śāradā script
Nanyang Hall	South Pacific Mandate
Ulla Schmidt	Ulla Schmidt
Rockstar London	Rockstar London
Marie Antoinette	Marie Antoinette
Elio Di Rupo	Elio Di Rupo
Bamir Topi	Bamir Topi
AMD Sempron	Sempron
Vlad Ferrat	Vlad Filat
Angelo Peruzzi	Angelo Peruzzi
Christmas Poo Mr Gold	Mr Hankey the Christmas Poo
A COMPLETE ALL SINGLES	A Complete
Andreas Hinkle	Andreas Hinkel
Du hast	Du hast
Park Geunhye	Park Geunhye
Martin Harnick	Martin Harnik
United Kingdom of Great Britain and Ireland	United Kingdom of Great Britain and Ireland
Cicero	Cicero
Harry S Truman	Harry S Truman
Luzhniki Stadium	Luzhniki Stadium
John Ballance	John Ballance
Steven Pinar	Steven Pienaar
Black Sea	Black Sea
Rosen Plevneliev	Rosen Plevneliev
Google Web Toolkit	Google Web Toolkit
Xixian	Xi County Henan
Lian Zhan	Lien Chan
botanical bay	City of Botany Bay
Kentucky	Kentucky
Khakasians	Khakas people
Amy Chen	Aimee Chan
Saudi Arabia	Saudi Arabia
Hunter Stockton Thompson	Hunter S Thompson
Mirrors Edge	Mirrors Edge
Love Day After Tomorrow	Love Day After Tomorrow
Israel Labour Party	Israeli Labor Party
barbados	Barbados
Kurt Alder	Kurt Alder
Liberal Democratic Peoples Party	Peoples Party for Freedom and Democracy
Newark Liberty International Airport	Newark Liberty International Airport
Prime Minister of Canada	Prime Minister of Canada
Alexis Tsipras	Alexis Tsipras
United States Secretary of State	United States Secretary of State
Friedrich Nietzsche	Friedrich Nietzsche
NHK General Channel	NHK General TV
Pauletta	Pauleta
Lucifer	Lucifer
Guangxu Emperor	Guangxu Emperor
Zheng Ren	Jungin
Saudi Frisian	Saterland Frisian language
Pune	Pune
assam	Assam
AugustaVictoria	Augusta Victoria of SchleswigHolstein
Milan Kundera	Milan Kundera
Dress to kill	Dress to Kill
Friends Team	Frienger
Jiangxi Liansheng Football Club	Jiangxi Liansheng FC
Frederic Ljungberg	Fredrik Ljungberg
David Coulter	David Guetta
Nikola Luzin	Nikolai Luzin
Botswana	Botswana
Hangzhou East Railway Station	Hangzhou East Railway Station
Abdul Majid Mirza	Abdol Majid Mirza
STAR	Star
Criminal Investigation File II	Detective Investigation Files II
Chiliang Miura	Kazuyoshi Miura
Nicholas Cage	Nicolas Cage
Lai Qingde	William Lai
Jason Brown	Jason Brown
Dan Bolen	Dan Boren
Boston College	Boston College
Hui Yinghong	Kara Hui
NHK World Premium	NHK World Premium
Do not doubt	No Doubt
Anton Yugoff	Anton Yugov
The Crimean War	Crimean War
Mauro Boselli	Mauro Boselli
Big Julia	Julia the Elder
Lorient Football Club	FC Lorient
Pakistan Peoples Party	Pakistan Peoples Party
Gustav Hertz	Gustav Ludwig Hertz
NVIDIA	Nvidia
WHITE	White
Prince Claus	Prince Claus of the Netherlands
Nursultan Nazarbayev	Nursultan Nazarbayev
Emperor Movies	Emperor Motion Pictures
Jin Zhongmi	Kim Jongpil
Enrico Letta	Enrico Letta
Angela Merkel	Angela Merkel
Alan Greenspan	Alan Greenspan
Dougsom Bowdo	Dogsomyn Bodoo
Auckland Metropolitan Area	Auckland
Fabio Aurelio	Fábio Aurélio
Filipino	Filipino language
Mohamed Dijerdi	Mohamed Tchité
ESPN	ESPN
Chamdo	Chamdo
Jiangsu Longkendia Basketball Club	Jiangsu Dragons
Grand Theft Auto V	Grand Theft Auto V
Huang Renyu	Ray Huang
Li Xianglan	Yoshiko Yamaguchi
Scratch language	Scratch
Henry	Henri Grand Duke of Luxembourg
Yuan Shundi	Toghon Temür
Quercus	Oak
Gabriel Melkan	Gabriel Melkam
The Knights of Malta	Sovereign Military Order of Malta
Australia	Australia
Egirls	Egirls
Cherry Wright	Chely Wright
Dischord Records	Dischord Records
Manhattan Financial District	Financial District Manhattan
Amdi Faye	Amdy Faye
Microsoft Studio	Microsoft Studios
Philip II	Philip II of Macedon
Benedict Cumberbatch	Benedict Cumberbatch
Everton Football Club	Everton FC
Henry D Gilpin	Henry D Gilpin
Yunyang Yangtze River Bridge	Yunyang Yangtze River Bridge
Ukrainian Orthodox Church	Ukrainian Orthodox Church
Raniere	Prince Ranieri Duke of Castro
Oriya	Odia language
Park Dong Hyuk	Park Donghyuk
Communist Party of Cuba	Communist Party of Cuba
Hamaby Football Club	Hammarby Fotboll
Joaquin Sanchez	Joaquín
Iceland	Iceland
Kuwait	Kuwait
Quarry Bay	Quarry Bay
Cheltenham Football Club	Cheltenham Town FC
Olafur Ragnar Grimsson	Ólafur Ragnar Grímsson
Arizona	Arizona
French Serie B	Ligue 2
University of Zurich	University of Zurich
Zeng Zhixiao	Tsang Chi Hau
Richard Rush	Richard Rush
Lake	Lough Neagh
Zou Language	Tsou language
Steven Eliland	Stephen Ireland
The Soul of the Road Car	Driver
Marie Rejeska	Marie Leszczyńska
Miriam Yeung	Miriam Yeung
Morthali Golihan Hidayat	Morteza Gholi Khan Hedayat
	Take That
Cascading Style Sheets	Cascading Style Sheets
Simon Sabrosa	Simão Sabrosa
Jaime	Jaime Duke of Madrid
Yukio Edano	Yukio Edano
Tekoshi Yuya	Yuya Tegoshi
Aruhun	Arghun
Michael Shibapua	Michael Silberbauer
Daily delivery	Mainichi Broadcasting System
Chowdhury Shujat Hussein	Chaudhry Shujaat Hussain
Wu Bingzhi	Adrienne Clarkson
Company of Heroes	Company of Heroes
MercedesBenz Bicycle	Hashire Bicycle
Qingdao Zhongneng Football Club	Qingdao Jonoon FC
Chinese	Chinese language
IndiaGeography	Geography of India
Hungarian Football League	Nemzeti Bajnokság I
University of NebraskaLincoln	University of NebraskaLincoln
Huddersfield Football Club	Huddersfield Town AFC
Godspeed You Black Emperor	Godspeed You Black Emperor
canadian	Canadians
Jin Pucong	King Putsung
Sherik Ahmetov	Serik Akhmetov
Santa Fe	Santa Fe New Mexico
Alia E Hussein	Alia alHussein
The Fall of the World	After Forever
199091 UEFA Cup	199091 UEFA Cup
Andres Guardado	Andrés Guardado
Taboo	Taboo
John YBrown	John Y Brown
CANT SLEEP CANT EAT IM SICK merman	Cant Sleep Cant Eat Im Sick
Motherwell Football Club	Motherwell FC
Zadominso	Thado Minsaw
HTC Desire Z	HTC Desire Z
Emperor Shaozhi	Thiệu Trị
Lawrence Berkeley National Laboratory	Lawrence Berkeley National Laboratory
Swansea City Football Club	Swansea City AFC
Korpiklaani	Korpiklaani
Wayfield Bonney	Wilfried Bony
Harvard Law School	Harvard Law School
Poland Under21 National Football Team	Poland national under21 football team
European Grand Prix	European Grand Prix
Meiji Shrine	Meiji Shrine
Aymara	Aymara language
Nanbu Town	Nanbu Yamanashi
Ganjiang	Gan River
Scott Skiles	Scott Skiles
Marie de Medici	Marie de Medici
Gongqian District	Miyamaeku Kawasaki
Mac OS X v102	Mac OS X 102
John Irvine	John Irving
David Coulter	David Coulthard
Altaic	Altai language
Andre Bikay	André Bikey
Peter Zeeman	Pieter Zeeman
JeanBaptiste Lamarck	JeanBaptiste Lamarck
Klaus Augenthaler	Klaus Augenthaler
Power Metal	Power metal
Governor of India	GovernorGeneral of India
Bucharest Star Football Club	FC Steaua București
Seoul Eland Football Club	Seoul ELand FC
planleute	PlanlesOuates
List of Mexican monarchs	Emperor of Mexico
George Curzon 1st Marquis of Curzon of Kedleston	George Curzon 1st Marquess Curzon of Kedleston
Italian Football League D	Serie D
Li Dahai	Lee Dahae
Duke University	Duke University
Yang Guo	Yang Guo
Le Duan	Lê Duẩn
Gu Chao	Gu Chao
Ryukyu	Ryukyuan people
Sheffield Wednesday Football Club	Sheffield Wednesday FC
Murcia	Murcia
Zhongli District	Zhongli District
Colours	Colours
pebble beach	Pebble Beach California
Huaian	Huaian
Derrick Ross	Derrick Rose
Simon Kyle	Simon Kjær
Love of My Life	Love of My Life
GE Aviation	GE Aviation
1975  76 UEFA Champions League	197576 European Cup
Ming Wuzong	Zhengde Emperor
Scottish Premier League	Scottish Premiership
Long An Tongxin Football Club	Đồng Tâm Long An FC
Muhammad Rafiq Talal	Muhammad Rafiq Tarar
Jafar Sadiq	Jafar alSadiq
Bon Joffe	Bon Jovi
weekly YOUNG JUMP	Weekly Young Jump
Ellie Wiesel	Elie Wiesel
Johann Wolfgang von Goethe	Johann Wolfgang von Goethe
Josh Ernest	Josh Earnest
Zhang Mian	Chang Myon
PierreEmerick Aubameyang	PierreEmerick Aubameyang
Santa Fe Independence	Independiente Santa Fe
Queen of HipPop	Queen of HipPop
MALICE MIZER	Malice Mizer
shock library MAGAZINE	Dengeki Bunko Magazine
Ibrahim Hashem	Ibrahim Hashem
Norodom Sihamoni	Norodom Sihamoni
Lord William Bentinck	Lord William Bentinck
Wang Yeping	Wang Yeping
tunina	Truganina Victoria
British Columbia Provincial Council	Legislative Assembly of British Columbia
Suibi Park	Subin Bak
Yingkou City	Yingkou
Xiaogao Luoda Lijia	Hugo Rodallega
German Kaiser	German Emperor
20112012 English Football Champions League	201112 Football League Championship
2015 Chinese Football Association Cup	2015 Chinese FA Cup
Christopher Metzelder	Christoph Metzelder
Kwai District	Aoiku Shizuoka
Wagtail	Wagtail
Conservative Peoples Party	Conservative Peoples Party
Greater Caucasus Mountains	Greater Caucasus
Bronislaw Komorowski	Bronisław Komorowski
Hollywood	Hollywood
minion	Minions
benin	Benin
Paris HiTech	ParisTech
Ott Football Club	Odds BK
Martin Schipel	Martin Škrtel
Feel fine	Feel Fine
Battle of Issus	Battle of Issus
philadelphia	Philadelphia
Yongzheng Emperor	Yongzheng Emperor
Emanuel Pogatez	Emanuel Pogatetz
Trayan Basescu	Traian Băsescu
Hakata Station	Hakata Station
The Call of Duty Series	Call of Duty
KCNicholas	K C Nicolaou
Sony Xperia Z1	Sony Xperia Z1
Princess Alice	Princess Alice of the United Kingdom
ShanghaiNanjing Intercity Railway	ShanghaiNanjing Intercity Railway
American Samoa	American Samoa
Mao Zhiguo	Mao Chikuo
Tamil Nadu	Tamil Nadu
Delta 4 launch vehicle	Delta IV
Unrequited Love Two Cities	Outbound Love
BBC Radio 4	BBC Four
Communist Party of the Republic of Moldova	Party of Communists of the Republic of Moldova
How I Met Your Mother	How I Met Your Mother
Central and Western District	Central and Western District
Why So Serious3F  The Misconceptions Of Me	Why So Serious3F  The Misconceptions of Me
Spicy Teacher GTO	Great Teacher Onizuka
Yoshida Shigeru	Shigeru Yoshida
Sherlock Holmes 2	Sherlock Holmes
England Football League	The Football League
Early Cyrillic	Early Cyrillic alphabet
Zhang Jicong	Louis Cheung
Jay Chou	Jay
Carl Valery	Carl Valeri
moon	Moon
Granada Football Club	Granada CF
199899 European Cup Champions Cup	199899 UEFA Cup Winners Cup
Shenyang Dongjin Football Club	Shenyang Dongjin FC
The Great Discovery	Dai Hakken
Yuan Qiongdan	Kingdom Yuen
Maroani Fellaini	Marouane Fellaini
shanmugam	K Shanmugam
Romanian Socialist Republic	Socialist Republic of Romania
KDDI	KDDI
Christos Satsetakis	Christos Sartzetakis
Catholic Diocese of Nanjing	Roman Catholic Archdiocese of Nanking
Portland	Portland Oregon
Alexander Tuchnov	Oleksandr Turchynov
Peter Lowenkrans	Peter Løvenkrands
Nizu LeoTroga	Nigel ReoCoker
Elizabeth	Elizabeth New Jersey
BEST SELECTION 2010	Best Selection 2010
Andorra 1st Football League	Primera Divisió
Xiaomi Phone 2	Xiaomi Mi 2
Pope Jiade	Pope Agatho
Taichung County	Taichung County
Monthly Comic Alive	Monthly Comic Alive
Vietnamese Empire	Empire of Vietnam
Nihat Erim	Nihat Erim
Prince Albert Victor	Prince Albert Victor Duke of Clarence and Avondale
Meyer Jadenak	Mile Jedinak
John Hopecroft	John Hopcroft
Seven Swords	Seven Swords
Algeria National Football Team	Algeria national football team
Adult Swim	Adult Swim
Jin Yina	Kim Eana
Li Kanglian	Lee Hong Lim
Yan Taixiong	Uhm Taewoong
Lakesha Islands	Lakshadweep
Song of Love	Ai no Uta
Manmohan Singh	Manmohan Singh
Herva Gauss Football Club	Heracles Almelo
FIVE	Five
NVIDIA GeForce 100	GeForce 100 series
Mafferson	Peter Mathieson
Piacenza Football Club	Piacenza Calcio 1919
Jung In Hwan	Jung Inwhan
Huaiyuan County	Huaiyuan County
Laos Protectorate	French Protectorate of Laos
LOVE LETTER	Love Letter
Anglican Church of Scotland	Scottish Episcopal Church
Shao Meiqi	Maggie Shiu
Tajik	Tajiks
Black Butler	Black Butler
University of North Carolina System	University of North Carolina
The Magicians Nephew	The Magicians Nephew
Uyghur	Uyghur language
Emirate of Dubai	Emirate of Dubai
Park Sung Chul	Pak Songchol
djibouti	Djibouti
Musa Kazim	Musa alKadhim
George Grenville	George Grenville
Ministry of Justice of the Peoples Republic of China	Ministry of Justice of the Peoples Republic of China
Aragonese	Aragonese language
Jacob Ragon	Jacques Lacan
Peoples Democratic Party	Peoples Democratic Party
Yue Yue	York Chow
2002 Hurricane Kyle	Hurricane Kyle
Peoples Party	Peoples Party
Brazilian Football League C	Campeonato Brasileiro Série C
Hong Kong Sheng Kung Hui	Hong Kong Sheng Kung Hui
Yuto Sato	Yūto Satō
Marco Rubio	Marco Rubio
Alexander Zivkovich	Aleksandar Živković
Prince Edward Earl of Wessex	Prince Edward Earl of Wessex
waterford	Watford
Heinrich Lübeck	Heinrich Lübke
The Big Bang Theory	The Big Bang Theory
Bruno Menegger	Bruno Meneghel
Hongwu32	Relic of an Emissary
Smonkala	Smenkhkare
Vaughan	Vaughan
Victor Bruce 9th Earl of Elgin	Victor Bruce 9th Earl of Elgin
Luhan	Luhan
Li Yijun	Lee Ejun
John Curtin	John Curtin
Mauro Camoranesi	Mauro Camoranesi
Viva La Vida	Viva la Vida
Freddy Adu	Freddy Adu
Constantin Senetescu	Constantin Sănătescu
Joe Baby	Gill Mohindepaul Singh
Leonor	Leonor Princess of Asturias
Tatar	Tatar language
Chen You	Anthony Chan
Zhu Ting	Zhu Ting
Cangas de Onis	Cangas de Onís
Assassination Classroom	Assassination Classroom
George MacDonald	George MacDonald
Tong Liya	Tong Liya
Wuzhou	Wuzhou
How I Met Your Mother	How I Met Your Mother
Ivory Coast National Football Team	Ivory Coast national football team
John Canfield Spencer	John C Spencer
Alcorcon Sports Association	AD Alcorcón
choke hot red pepper	Red Hot Chili Peppers
Joseon Sungjong	Seongjong of Joseon
President of Iran	President of Iran
Love is around you	Love Is All Around
Vedran Corluca	Vedran Ćorluka
Euphrates	Euphrates
Xianyang	Xianyang
Alexander the Great	Alexander the Great
Fangze Kenji	Kenkichi Yoshizawa
Robert Ludren	Robert Ludlum
Chinese American	Chinese Americans
Haya Bint Hussein	Princess Haya bint Hussein
St Vincents Olympic Stadium	Sinan Erdem Dome
Losingborg Football Club	Rosenborg BK
Martin Bowman	Martin Bormann
Feng Huilan	Mari Elka Pangestu
Rod Stewart	Rod Stewart
Croatian Social Democratic Party	Social Democratic Party of Croatia
BBC Radio 2	BBC Two
Deng Yingchao	Deng Yingchao
LibreOffice	LibreOffice
Robert J Walker	Robert J Walker
Hideto Takahashi	Hideto Takahashi
Petro Bagdoglio	Pietro Badoglio
Bundesliga 20122013	201213 Bundesliga
Samir Rifay	Samir Rifai
Singapore Parliament	Parliament of Singapore
Xu Shiyou	Xu Shiyou
Victor Fraser	Viktor Fischer
Hadem Sinan Pasha	Hadım Sinan Pasha
Maidens Prayer	Sometimes
Zuhan Zorro	Johan Djourou
Jack Reed	Jack Reed
never mind	Nevermind
Luke Shor	Luke Shaw
tahiti	Tahiti
Itano Tomomi	Tomomi Itano
Hey	Nee
Iga City	Iga Mie
YES Love Promise	Yes
Yamagata Sanshin	Montedio Yamagata
Zhu Xi	Zhu Xi
Japan Broadcasting Association	NHK
Li Yuchun	Li Yuchun
Peter Arkadyevich Stolypin	Pyotr Stolypin
Polish	Poles
WINNER	Winner
Super Junior Donghae  Eunhyuk	Donghae  Eunhyuk
Jean Dieudone	Jean Dieudonné
Daniel Stulridge	Daniel Sturridge
Naughty Little Kiss	Itazura na Kiss
Koganei City	Koganei Tokyo
Chen Jianren	Chen Chienjen
Deng Zhuoxiang	Deng Zhuoxiang
F16XL Fighter	General Dynamics F16XL
Rescue Private Ryan	Saving Private Ryan
Suzuki Zenyuki	Zenkō Suzuki
The Sims Series	The Sims
Fatherland UnionLithuanian Christian Democrats	Homeland Union
Syrian Armed Forces	Syrian Armed Forces
Lano Romney	Lenore Romney
Odate City	Ōdate
Spratly Islands	Spratly Islands
Hugh McCulloch	Hugh McCulloch
Ricardo Pereira	Ricardo
Xinfeng	Xin Feng
No Regret	No Regret
Xishan Dynasty	Tây Sơn dynasty
Red Star Stadium	Marakana Stadium
SeineSaintDenis	SeineSaintDenis
Andrew Xiaos	Andrew Hughes
Razgrad Ludogorets Football Club	PFC Ludogorets Razgrad
Deep Sea	Shinkai
Vedad Ibisevic	Vedad Ibišević
Doomsday Alarm DestructionRebirth	Minutes to Midnight
Yesterday and Today	Yesterday and Today
Hans Zimmer	Hans Zimmer
President of the Legislative Council of Hong Kong	President of the Legislative Council of Hong Kong
Hawaiian	Hawaiian language
Walter Nernst	Walther Nernst
Patterson	Paterson New Jersey
Italian professional first division football league	Lega Pro Prima Divisione
Mark Gonzalez	Mark González
PanDemocracy	Pandemocracy camp
Wild Charlotte	Good Charlotte
Who and Fight	Die Another Day
Jin Yongsan	Kim Youngsam
University of Aberdeen	University of Aberdeen
Park Soojin	Park Soojin
Hakan Yakin	Hakan Yakin
Belgium Congo	Belgian Congo
Clement Attlee	Clement Attlee
Hungarian Forint	Hungarian forint
Plattville	Prattville Alabama
Shinagawaku	Shinagawa
Dpkg	Dpkg
Tokugawa Hidetada	Tokugawa Hidetada
Alex Bogomolov	Alex Bogomolov Jr
Mauregato	Mauregatus of Asturias
Kayun Farmhouse Course	Craven Cottage
Valencia Football Club	Valencia CF
Wang Han	Wang Han
Tibetan	Tibetan alphabet
Optimus 5 launch vehicle	Atlas V
Siena Football Club	SS Robur Siena
Republic of Venice	Republic of Venice
Dai Jiaoqian	Dai Jiaoqian
Ptolemy I	Ptolemy I Soter
Herman van Rompuy	Herman Van Rompuy
Somali	Somali language
Black Tower V Wolf of Kara	The Dark Tower V
Prince Bernhard	Prince Bernhard of LippeBiesterfeld
Rhine Confederation	Confederation of the Rhine
Song Qian	Victoria Song
David Yarolim	David Jarolím
Andrey Kolmogorov	Andrey Kolmogorov
Vierinia	Vieirinha
Ono City	Ōno Fukui
Executive Yuan	Executive Yuan
Francesco I	Francis I of the Two Sicilies
Haibu City	Ama Aichi
Danny Hugou	Danny Vukovic
Prince Fumihito Akishino Palace	Fumihito Prince Akishino
Lisbon  Benfica Sports Club	SL Benfica
Ron Paul	Ron Paul
country music	Country music
little	Leeteuk
Paul Gilbert	Paul Gilbert
Combined Fleet	Combined Fleet
Faroese	Faroese language
Beyond	Beyond
Guillermo Ochoa	Guillermo Ochoa
Song Ailing	Soong Ailing
Hakka	Hakka Chinese
Thai Chinese	Thai Chinese
ma	Horse
Brian Shades	Brian Schatz
Sichuan University	Sichuan University
Robert II	Robert Curthose
Kingdom of Lithuania	Kingdom of Lithuania
Kenya	Kenya
Jacky Cheung	Jacky Cheung
Ministry of Public Security of the Peoples Republic of China	Ministry of Public Security
Nguyen Hue	Nguyễn Huệ
Dutch East Indies Japanese Occupation Period	Japanese occupation of the Dutch East Indies
Oshima Risen	Tadamori Oshima
Galerius	Galerius
Athens Olympic Stadium	Olympic Stadium
University of Miami	University of Miami
Americas Next Top Model	Americas Next Top Model
RCA Records	RCA Records
P3 Orion Maritime Patrol	Lockheed P3 Orion
Li Shihuan	Selena Li
Roberto Orci	Roberto Orci
RPM Package Administrator	RPM Package Manager
Cyclone Butler	Hayate the Combat Butler
Prince Harry	Prince Harry
Clement XIII	Pope Clement XIII
Yu Tao	Yu Tao
Modern Standard Arabic	Modern Standard Arabic
Christopher Sims	Christopher A Sims
Imperial Russian Navy	Imperial Russian Navy
Fukuchiyama City	Fukuchiyama Kyoto
Tanaka Junya	Junya Tanaka
NintendoDS Lite	Nintendo DS Lite
Georg Schwarzenbeck	HansGeorg Schwarzenbeck
stranger	You Dont Know My Name
Mayday	Mayday
Frederick William I	Frederick William I of Prussia
Indianapolis	Indianapolis
Huang Xinjie	Huang Shinchieh
McDonalds	Richard Graves MacDonnell
Park Hyo Shin	Park Hyoshin
Zeng Shaozong	Figaro Tseng
gem pet Sunshine	List of Jewelpet Sunshine episodes
Amur Musa	Amr Moussa
Criminal Investigation File	Detective Investigation Files
Gary Neville	Gary Neville
Ehime Prefecture	Ehime Prefecture
Bashkir	Bashkirs
Gimpo International Airport	Gimpo International Airport
EastWest Palace	Queens of Diamonds and Hearts
Yellow River	Yellow River
Slovak	Slovak language
Portland Trail Blazers	Portland Trail Blazers
Ezo Republic	Republic of Ezo
Shenzhou VI	Shenzhou 6
Plymouth	Plymouth
Chiba Kazuhiko	Kazuhiko Chiba
Ruan Shengxiong	Nguyễn Sinh Hùng
Theodore Dumitru Stolojan	Theodor Stolojan
Miao Qiaowei	Michael Miu
Chuck Schumer	Chuck Schumer
Left Front	Left Front
Kim Jung Yee	Kim Jungya
Gaojin District	Takatsuku Kawasaki
Belem Football Club	CF Os Belenenses
Goodbye Single Bed	Pillow Talk
Josefina Vazquez Mota	Josefina Vázquez Mota
Lugo Sports Club	CD Lugo
George Clinton	George Clinton
Lu Hao	Lu Hao
Malcolm IV	Malcolm IV of Scotland
Michael Collins	Michael Collins
Jeremy Haywood	Jeremy Heywood
You were BALLAD	You Were
Philadelphia 76ers	Philadelphia 76ers
Ba Jin	Ba Jin
National City Football League	Intercity Football League
Grand National Assembly of Turkey	Grand National Assembly of Turkey
Malcolm Fraser	Malcolm Fraser
Queen Sylvia	Queen Silvia of Sweden
Socket AM2	Socket AM2
Chile League Football	Campeonato Nacional
US Department of the Treasury	United States Department of the Treasury
Toyota Motors	Toyota
guido van Rossum	Guido van Rossum
Ebisu	Ebisu Shibuya
LoHouse	Rob Hulse
Anro Corsas Famagusta Football Club	Anorthosis Famagusta FC
Honduras Professional Football League	Liga Nacional de Fútbol Profesional de Honduras
Cha cha SING	Cha Cha Sing
President of France	President of France
The Power of Love	The Power of Love
United States Department of Defense	United States Department of Defense
Ottawa	Ottawa
Christopher Dodd	Chris Dodd
Ludwig I	Ludwig I of Bavaria
Beihai	Beihai
Prime Minister of South Africa	Prime Minister of South Africa
Kim Il Sung	Kim Ilsung
South Africa	South Africa
Henry I	Henry I of England
Ranieri Mazli	Pascoal Ranieri Mazzilli
William Eyck	Wim Eijk
Charles II	Charles II of England
Medina Province	Al Madinah Region
Park Joo Ho	Park Jooho
1984 Summer Olympics	1984 Summer Olympics
Riau Islands Province	Riau Islands
Sengoku Musou series	Samurai Warriors
Amstelveen	Amstelveen
John Acherley Dew	John Dew
United Nations SecretaryGeneral	SecretaryGeneral of the United Nations
Philip Cocu	Phillip Cocu
Kashima City	Kashima Ibaraki
Royal Thai Army	Royal Thai Army
Multan	Multan
Vaud	Vaud
Denmark National Football Team	Denmark national football team
Ma Yingjeou	Ma Yingjeou
Brescia Football Club	Brescia Calcio
Luzhou	Luzhou
Fidel Valdes Ramos	Fidel V Ramos
Carlo Azelio Ciampi	Carlo Azeglio Ciampi
yuancheng	Yuancheng District
Heart and Soul	Heart and Soul
Lee Hyori	Lee Hyori
Wangzhoudi	Jody WilsonRaybould
Ahmed Davutoglu	Ahmet Davutoğlu
White Star East	Baek Sungdong
Jane Gray	Lady Jane Grey
Wembley Stadium	Wembley Stadium
West Point Military Academy	United States Military Academy
RussianBelarus Union	Union State
Gomeda	Bardiya
PGT Beauregard	P G T Beauregard
Howell Cobb	Howell Cobb
North Zealand Football Club	FC Nordsjælland
Boeing 36780	Boeing 36780
William McKinley	William McKinley
Guilin	Guilin
Phillips College	Phillips Academy
florida	Florida
Order of the British Empire	Order of the British Empire
Manipur	Meithei language
Derbyshire	Derbyshire
Google Maps	Google Maps
Zeng Yongquan	Tseng Yungchuan
Nong Duc Manh	Nông Đức Mạnh
Daiyi	Tay people
Shojuro Shiokawa	Masajuro Shiokawa
Vittorio Emmanuel Orlando	Vittorio Emanuele Orlando
Chukochi	Chukchi language
Dungan	Dungan language
President of Burma	President of Myanmar
Richard Warness	Richárd Vernes
BESTthird universe  8th AL 22UNIVERSE22	Best
GIRL TALK the SPEED STAR	Girl Talk The Speed Star
North Mountain Kingdom	Hokuzan
Asmir Begovic	Asmir Begović
Vladislav Lokwenz	Vratislav Lokvenc
Qian Fu	Frederick Chien
Constantine III	Constantine III
Jia Xiaochen	JJ Jia
The Kingdom of Jerusalem	Kingdom of Jerusalem
Maximiliano Rodriguez	Maxi Rodríguez
Dingyuan County	Dingyuan County
Beauty	Bonamana
US Army	United States Armed Forces
Victoria	Queen Victoria
Charles Evans Hughes	Charles Evans Hughes
Javier Mascherano	Javier Mascherano
Sherpa	Sherpa language
Overwatch Council	Control Yuan
WILL	Will
Divani Di Rosario	Dwayne De Rosario
Ahmedshah Qajar	Ahmad Shah Qajar
Pavel Pogrebniak	Pavel Pogrebnyak
JeanJacques Rousseau	JeanJacques Rousseau
Huang Yingxian	Penny Wong
Huntsburg	Jon Huntsman Jr
John Alexander MacDonald	John A Macdonald
Zhao Liying	Zhao Liying
Hong Kong Police Force	Hong Kong Police Force
Owl City	Owl City
Michael Gray	Michael Gray
Abil Sports Club	Erbil SC
Max Schoms	Mats Hummels
Prince Joachim	Prince Joachim of Belgium Archduke of AustriaEste
Digao	Deco
Yavi	KelantanPattani Malay
Treaty for the Final Settlement of the German Question	Treaty on the Final Settlement with Respect to Germany
Polythene Pam	Polythene Pam
WoollimEntertainment	Woollim Entertainment
Bouljid Gendon	Peljidiin Genden
Brisbane City Council	City of Brisbane
German Communist Party	Communist Party of Germany
Secretary of State for Scottish Affairs	Secretary of State for Scotland
Donald Rumsfeld	Donald Rumsfeld
Iwabuchi Mana	Mana Iwabuchi
Charles River	Charles River
Mark Anthony	Mark Antony
Wilson Rodriguez Fonseca	Wilson Rodrigues Fonseca
Patrick Vieira	Patrick Vieira
StGallen	St Gallen
Lee Youngae	Lee Youngae
Raymond Spruance	Raymond A Spruance
Song Jiashu	Charlie Soong
Joe Biden	Joe Biden
Mitaka City	Mitaka Tokyo
PierreEtienne Frontin	PierreÉtienne Flandin
Later Jin	Later Jin
201213 Hong Kong First Division Football League	201213 Hong Kong First Division League
California House of Representatives	California State Assembly
Kenny Dalglish	Kenny Dalglish
Valdis Zartlers	Valdis Zatlers
Antioch III	Antiochus III the Great
Governor of Canada	Governor General of Canada
Cleopatra V	Cleopatra V of Egypt
Let It Be	Let It Be
Bulgarian Football League	Bulgarian A Football Group
Jiang Zuohan	Kong Cho Ha
Løve Rainbow	Love Rainbow
Wu Dunyi	Wu Denyih
Roque Santa Cruz	Roque Santa Cruz
Kingdom of Castile	Kingdom of Castile
Sit Stay Wait Down Love Story	Sit Stay Wait Down Love Story
Zimbabwe	Zimbabwe
Queen Zhang Jing	Queen Janggyeong
Katsushikaku	Katsushika
Yiling Yangtze River Bridge	Yiling Yangtze River Bridge
Royal Australian Air Force	Royal Australian Air Force
jinsha	Kym
Led Zeppelin	Led Zeppelin
Wonderful Hands	Healing Hands
kaka	Kaká
Shaoguan	Shaoguan
Christina Milian	Christina Milian
ADO The Hague	ADO Den Haag
Industrial Metals	Industrial metal
Ubuntu	Ubuntu
Henry Clay	Henry Clay
Lai Xingyuan	Lai Shinyuan
PepGuardiola	Pep Guardiola
Something	Something
Matthew Paul Miller	Matisyahu
Joe Gower	Joe Cole
Sony Xperia E	Sony Xperia E
Leila Pahlavi	Leila Pahlavi
Ingvar Carlsson	Ingvar Carlsson
Sepahan Football Club	Sepahan FC
Banhan Siba Acha	Banharn Silpaarcha
Monaghanshire	County Monaghan
melaka	Malacca
Chen Shuibian	Chen Shuibian
Gou Yunhui	Christine Kuo
Wakayama Prefecture	Wakayama Prefecture
Wang Liang	Wang Liang
Erna Solberg	Erna Solberg
Ryukyu Islands	Ryukyu Islands
Rwandan	Kinyarwanda
Delphi	Delphi
Catalan	Catalan language
Xinjiang Guanghui Feihu Basketball Club	Xinjiang Flying Tigers
Post Rock	Postrock
Bill Nelson	Bill Nelson
Joseph Lyons	Joseph Lyons
Andrew Jackson	Andrew Jackson
Zhu Lilun	Eric Chu
I remember you	I Remember You
Riverside	Riverside California
Claude Henry Count of SaintSimon	Claude Henri de Rouvroy comte de SaintSimon
Carouge	Carouge
Mihai Razwan Ungureanu	Mihai Răzvan Ungureanu
Cavan	County Cavan
Empress Xiao Mucheng	Empress Xiaomucheng
Dolly Amos	Tori Amos
Eastern League	Eastern Conference
Benjamin Franklin Butler	Benjamin Franklin Butler
Muhammad Hussein Tantawi	Mohamed Hussein Tantawi
Wan Chai District	Wan Chai District
Bolo County	Boluo County
Fabricio Coloccini	Fabricio Coloccini
Ping An Dao dialect	Pyongan dialect
SNSD	Girls Generation
CAROLS	Carols
Park Eunhyun	Park Eunbin
Deer Heart Society	Lu Xinshe
Turkish Premier League	Süper Lig
BBC News	BBC News
Basque Country	Basque Country
IPad Air 2	IPad Air 2
Joseon Sejo	Sejo of Joseon
County Louth	County Louth
lucknow	Lucknow
Alfonso Carlos	Infante Alfonso Carlos Duke of San Jaime
Shaoyom Laszlo	László Sólyom
Old Norse	Old Norse
Charles Bonaparte	Charles Prince Napoléon
Ferdinand Eisenstein	Gotthold Eisenstein
Di Bogardi	Dirk Bogarde
One ride is a thousand	Ikki Tousen
River Scherber	Liev Schreiber
Habsburg Dynasty	House of Habsburg
Paraguay National Football Team	Paraguay national football team
Alberto Aquilani	Alberto Aquilani
Women are not easy to do	La Femme Desperado
Thinking II	Pope Sylvester II
Jensen Lehmann	Jens Lehmann
Treaty of Verdun	Treaty of Verdun
Valencian	Valencian
Ma Junwei	Steven Ma
William Eustice	William Eustis
Lincoln Chaffey	Lincoln Chafee
Shadow of the Wind	The Shadow of the Wind
Isaac Newton	Isaac Newton
Houari Boumediene	Houari Boumediene
The court on the tongue and sword	Return of the Silver Tongue
Guo Chunquan	Guo Chunquan
Tao Hong	Tao Hong
Meeting National Stadium	Mỹ Đình National Stadium
China is standing in the universe	China Heroically Stands in the Universe
UEFA	UEFA
Klaus Johannes	Klaus Iohannis
Benjamin Franklin	Benjamin Franklin
SCANDAL	Scandal
Stoke City Football Club	Stoke City FC
Judd Trump	Judd Trump
Qu Qiubai	Qu Qiubai
Dearborn	Dearborn Michigan
Bayern München FC Second Team	FC Bayern Munich II
staring shoe rock	Shoegazing
BBC iPlayer	BBC iPlayer
Boertie	Börte
Joseph Bedero	Giuseppe Bertello
Chen Yun	Chen Yun
Zheng Ke 𡒉	Zheng Kezang
François Mitterrand	François Mitterrand
Shiina Ringo	Ringo Sheena
FIFA Series	FIFA
Rocky Mountains	Rocky Mountains
Carlxian Naby	KarlHeinz Lappe
STYLE	Style
Jingpo	Jingpo people
Lu Yan	Lisa Lu
Shi Hongjun	Shi Hongjun
Hestia	Hestia
Digital Versatile DVD	DVD
Jumpin	Jumping
Liu Yandong	Liu Yandong
Invincible Destruction King	WreckIt Ralph
LOVE  TRUTH	Love  Truth
Osiris	Osiris
Teresa Teng	Teresa Teng
New Horizons	New Horizons
Kidderminster	Kidderminster
Phil Collins	Phil Collins
Hafez alAssad	Hafez alAssad
Silent Hill 3	Silent Hill 3
Maridimo Athletic Association	CS Marítimo
John JMcIntyre	John J McIntyre
Pilot	Pilot
Labour	Labour Party
Maurice Couff Demville	Maurice Couve de Murville
Future Track	Tsugi no Ashiato
NBA	National Basketball Association
Nobu Iwamatsu	Mako Iwamatsu
Gerald Green	Gerald Green
Bill Clinton	Bill Clinton
Takahiro Matsumoto	Tak Matsumoto
Busan IPark Football Club	Busan IPark
Def Jam Records	Def Jam Recordings
Wu Baozhu	Ngô Bảo Châu
Ito Joichi	Joi Ito
Schuylkill River	Schuylkill River
Chris Dixon	Chris Dickson
Tibetan	Tibetan people
Enesto Samper Pisano	Ernesto Samper
ONE DROP	One Drop
Troll	Teror
Shang Tiane	Kiki Sheung
Splinter Cell	Tom Clancys Splinter Cell
Fazlullah Zahedi	Fazlollah Zahedi
Guam	Guam
Leding III	Pope Celestine III
Joseph M Carey	Joseph M Carey
Karl Alexander	Charles Alexander Grand Duke of SaxeWeimarEisenach
Brian Griffin	Brian Griffin
Ming Sejong	Jiajing Emperor
Tan Baide	Norman Tebbit
1985  Euro 86 Champions Cup	198586 European Cup Winners Cup
Ultra soul	Ultra Soul
Rudd	Kevin Rudd
Huang Zhanhong	Wong Chin Hung
Grover Cleveland	Grover Cleveland
Guiyang	Guiyang
Millwall Football Club	Millwall FC
David Suter	David Souter
Turkish	Turkish language
EX All Time Favourites	EX All Time Favourites
Pope Alexander VI	Pope Alexander VI
Raja Pervez Ashraf	Raja Pervaiz Ashraf
Ancient Spirits	DIE
Duby Idavillete	Toby Alderweireld
Recep Madani	Rexhep Meidani
Kathleen Kennedy	Kathleen Kennedy
Over Load	Over Load
is here	Koko ni Ita Koto
myth	Shinhwa
Elizabeth I	Elizabeth I of England
Hong Xiuquan	Hong Xiuquan
Afar	Afar language
hera	Hera
Matthew Leckie	Mathew Leckie
Li Yanan	Leanne Li
Gurney Kardashian	Kourtney Kardashian
Gerard Jay Sussman	Gerald Jay Sussman
Gary Cahill	Gary Cahill
M	M
Laurent Fabius	Laurent Fabius
Christian Zapata	Cristián Zapata
Sacred Heart University	Sacred Heart University
Lyishshire	County Laois
Yanez Dernovsek	Janez Drnovšek
Made in Germany 19952011	Made in Germany 19952011
Federated States of Micronesia	Federated States of Micronesia
General Office of the Central Committee of the Communist Party of China	General Office of the Communist Party of China
Enoch Shuhume	Enoch Showunmi
arkansas	Arkansas
halmstad	Halmstad
Nokia Lumia 830	Nokia Lumia 830
The Ultimate Class	KO One
Meno Figueroa	Maynor Figueroa
Sergey Badap	Sergei Bagapsh
Sapporo Dome	Sapporo Dome
Delicious Relationship	Sweet Relationship
CyanogenMod	CyanogenMod
Tokyo Metropolitan Government	Special wards of Tokyo
Cherry Girl Fate	Cherry Girl Unmei
Omar Bradley	Omar Bradley
Angie Xie	Kay Tse
rocket canvas shoes One × Time	Rocket Sneaker One x Time
Liao Zhonglai	Liow Tiong Lai
Wang Shengjun	Wang Shengjun
Texas	Texas
Tanaka Yusuke	Yusuke Tanaka
Flower	Flower
Yilan County	Yilan County Taiwan
Gregory VIII	Pope Gregory VIII
Seoul World Cup Arena	Seoul World Cup Stadium
Shenzhen Bay Sports Center	Shenzhen Bay Sports Center
Manazuru Station	Manazuru Station
Adventure Time	Adventure Time
Clarence Thomas	Clarence Thomas
Zhang Zhijun	Zhang Zhijun
Punjab	Punjab India
Finnish Orthodox Church	Finnish Orthodox Church
Niigata Prefecture	Niigata Prefecture
Carson	Carson California
Diego Godin	Diego Godín
Amos Kendall	Amos Kendall
Bronislav Malinowski	Bronisław Malinowski
IPhone 4	IPhone 4
Georgian	Georgian language
Mike Catonbao	Mark Clattenburg
Disneyland Paris Resort	Disneyland Paris
Frieze Toth	Fritz Todt
Pope Gerasius I	Pope Gelasius I
Salah alDin	Saladin Governorate
Tehran Province	Tehran Province
He Weijian	Derrick Hoh
Omeroo	Kenneth Omeruo
Sony Xperia P	Sony Xperia P
The Exorcist Boy	DGrayman
Yang Rong	Yang Rong
199091 European Cup Champions Cup	199091 European Cup Winners Cup
Chen Ju	Chen Chu
Ayyubid Dynasty	Ayyubid dynasty
Princess Dagmar	Princess Dagmar of Denmark
Oliver Letwin	Oliver Letwin
South Slavic	South Slavic languages
Kim Jongil	Kim Jongil
Shannan	Shannan Tibet
Lech Kaczynski	Lech Kaczyński
Huang Yongsheng	Huang Yongsheng
Mac OS X Leopard	Mac OS X Leopard
Kingdom Hearts	Kingdom Hearts
Belgrade	Belgrade
John Diefenbaker	John Diefenbaker
Danish Football Association	Danish Football Association
West Gotaland	Västra Götaland County
The one who left is you	The One That Got Away
Fanhara Takahiro	Takahiro Ogihara
Yuan Mingzong	Khutughtu Khan Kusala
Xia Yu	Xia Yu
Minimal Song	Songs in A Minor
Fujii Hirohisa	Hirohisa Fujii
Virginia Military Academy	Virginia Military Institute
Prince Takahito Mikasa	Takahito Prince Mikasa
Bremerton	Bremerton Washington
Yizu City	Yaizu Shizuoka
Uya Morvisen	Yura Movsisyan
Bardo Billy	Pelé
Worcester City Football Club	Worcester City FC
Uralic	Uralic languages
Li Kai	Li Kai
BLUE BIRD	Blue Bird
Chen Zihan	Chen Zihan
John G Downey	John G Downey
Rice University	Rice University
SO female	So Girls
Karl Schmidt	Carl Schmitt
Second Hellenic Republic	Second Hellenic Republic
poppunk	Pop punk
David Witt	David Vitter
Karl Friedrich	Charles Frederick Grand Duke of SaxeWeimarEisenach
Neely	Nenê
Black Cherry	Black Cherry
Christian Ansaldi	Cristian Ansaldi
Peter Costello	Peter Costello
Diego Maradona	Diego Maradona
Chocolove from AKB48	Chocolove from AKB48
Zalman Shazar	Zalman Shazar
Nagano Slim	Osami Nagano
Iberian Romance	Iberian Romance languages
Lhasa	Lhasa
BBC	BBC
Yakir Akaronov	Yakir Aharonov
George Uhlenbeck	George Uhlenbeck
Qingdao Hailifeng Football Club	Qingdao Hailifeng FC
Naughty Dog	Naughty Dog
Jaguar Land Rover	Jaguar Land Rover
Henry Sewell	Henry Sewell
German TV 1	Das Erste
The wind is la la la	Kaze no La La La
Tokyo Disneyland	Tokyo Disneyland
James B McCreary	James B McCreary
Kenny Cunningham	Kenny Cunningham
Chen Chong	Joan Chen
Russian Tsardom	Tsardom of Russia
Ashton Kutcher	Ashton Kutcher
National Assembly	National Assembly
Shenzhou VII	Shenzhou 7
Nanqi	Cochinchina
Hong Kong University of Science and Technology	Hong Kong University of Science and Technology
SBS 6	SBS 6
love slave	Im a Slave 4 U
Ukrainian Soviet Socialist Republic	Ukrainian Soviet Socialist Republic
Charlene Choi	Charlene Choi
Kaminocho	Komono Mie
Nexus 5X	Nexus 5X
Albanian	Albanian language
ACTION	Action
Pingxi District	Pingxi District
Chrome OS	Chrome OS
Lu Guohua	Lu Kuohua
Aniel	Anières
Stefaner Henkerz	Stéphane Henchoz
Zinetin Zidane	Zinedine Zidane
Ke Wenzhe	Ko Wenje
Du Jia	Du Jia
Valdemar Pavlac	Waldemar Pawlak
Agatha Barbara	Agatha Barbara
Andaman Sea	Andaman Sea
Vardas Adamkus	Valdas Adamkus
Marquinhos	Marquinhos
George Clement Perkins	George Clement Perkins
The Hottest Partner 2	Unriddle 2
Konstantin Konstantinovich Rokossovsky	Konstantin Rokossovsky
100000 Why	100000 Whys
DDD feat SOULHEAD	DDD
Newport	Newport Wales
Ardabil Province	Ardabil Province
S×W×A×G	Swag
Rosenwen	Luo Senwen
Nishio	Nishio Aichi
Fairyland	Fairyland
Yao Yilin	Yao Yilin
Mach	Mach
Xu Zigen	Koh Tsu Koon
Boeing 720	Boeing 720
Marianne Raven	Marion Raven
Argentina	Argentina
The Legend of the Condor Heroes	The Legend of the Condor Heroes
Pope Hadrian III	Pope Adrian III
Starz	Starz
Nicholas I	Nicholas I of Russia
Love Game	LoveGame
Agrippina Greater	Agrippina the Elder
My Alternative Romance	My Chemical Romance
William Jones	William Jones
Mark Gertler	Mark Gertler
Vietnamese	Vietnamese language
Zhang Yixing	Lay
FAIRY TALE	Fairy Tale
The British Monarch	Monarchy of the United Kingdom
Edge of Crisis	Fringe
education	Kyōiku
Juan Silvera dos Santos	Juan Silveira dos Santos
Final Fantasy X	Final Fantasy X
Augustine of Hippo	Augustine of Hippo
Kwon Yuri	Kwon Yuri
Wang Jingwei	Wang Jingwei
Alan Sandage	Allan Sandage
Pierre Freyden	Pierre Frieden
Lucas Barrios	Lucas Barrios
Swedish House Mafia	Swedish House Mafia
Keith Richards	Keith Richards
Quezon City	Quezon City
Yanagihara Aiko	Yanagihara Naruko
Shiga Prefecture	Shiga Prefecture
tajikistan	Tajikistan
catalonia	Catalonia
Princess Elaine	Princess Irene of Hesse and by Rhine
Passionate Midsummer	Summer x Summer
Hendrik Casimir II	Henry Casimir II Prince of NassauDietz
Nikola Mikhailovich Shvernik	Nikolay Shvernik
Croatian	Croatian language
Prince Friedrich Johan	Prince Friedrich of SaxeMeiningen
SaxonyCoburgGotha	SaxeCoburg and Gotha
Han Zheng	Han Zheng
Sky CityMetra	Meteora
Shelley Moore Capito	Shelley Moore Capito
Penibetico Mountains	Penibaetic System
George Ivanov	Gjorge Ivanov
Luton Football Club	Luton Town FC
Jeb Bush	Jeb Bush
Hong Kong Football Association	Hong Kong Football Association
Pablo Neruda	Pablo Neruda
Galatasaray Sports	Galatasaray SK
Tottenham Hotspur Football Club	Tottenham Hotspur FC
Savo Milosevic	Savo Milošević
Turpan	Turpan
Yun Rong	Yunreng
Winfield Scott Hancock	Winfield Scott Hancock
Williams College	Williams College
High Energy Accelerator Research Institute	KEK
Royal Spanish Football Association	Royal Spanish Football Federation
Jan Iliescu	Ion Iliescu
KON  light voice	KOn
Xu Caihou	Xu Caihou
Crazy 4 U	Crazy 4 U
WindowsStore	Windows Store
YESUNG	Yesung
JeanMarc Herrault	JeanMarc Ayrault
Seo Taiji and children	Seo Taiji and Boys
Monument Field	Estadio Monumental Antonio Vespucio Liberti
Pingdingshan	Pingdingshan
Li Chao	Lý dynasty
John Blair Bickerstaff	J B Bickerstaff
H	H
Philippe Luis Kasmirski	Filipe Luís
Neversoft	Neversoft
Junior Team	Shonentai
Fukuda Takeo	Takeo Fukuda
ghana	Ghana
7color rainbow	Rainbow
Roger Penrose	Roger Penrose
Auvergne	Auvergne
St Pauls College	St Pauls College Hong Kong
Jeremiah Paul Ostrak	Jeremiah P Ostriker
Clementi	Cecil Clementi
Maccabi Tel Aviv	Maccabi Tel Aviv FC
River Plate Sports	Club Atlético River Plate
Bakardine District Government	Barcaldine Region
Shanxian Youyou	Yamagata Aritomo
Apple A7	Apple A7
Democratic Party	Democrat Party
Outer Ring Jiangjin Yangtze River Bridge	Guanyinyan Bridge
Jurgen Habermas	Jürgen Habermas
Bertrand Russell	Bertrand Russell
Alajuelens Sports Club	Liga Deportiva Alajuelense
Jane Lynch	Jane Lynch
Costaia	Costinha
Joetsu City	Jōetsu Niigata
Australian Senate	Australian Senate
Ptolemy X	Ptolemy X Alexander I
Olivier Duckett	Olivier Dacourt
Lake Suwa	Lake Suwa
APRIL	April
Wladyslaw Sikorski	Władysław Sikorski
COLOR OF SOUL	Color of Soul
Alan Turing	Alan Turing
NGT48	NGT48
Taro Aso	Tarō Asō
Western Roman Empire	Western Roman Empire
Kamakura Shogunate	Kamakura shogunate
Merry Streep	Meryl Streep
Louisiana Administrative Divisions	List of parishes in Louisiana
Scott Jameson	Scott Jamieson
LAST ANGEL feat TVXQ	Last Angel
IM Pei	I M Pei
Central Plains	Zhongyuan
A song written with the cry of my heart  Love take it all	Kokoro no Sakebi o Uta ni Shitemita  Love Take It All
The Medici Family	House of Medici
Soraya IvandialiBhaktiari	Soraya EsfandiaryBakhtiari
Wang Dongcheng	Jiro Wang
Ten Years of NishangChampion Full Record	The Singles Collection
Princess Iman	Princess Iman bint Abdullah
speed metal	Speed metal
Stony Brook University	Stony Brook University
Peru Chinese	Chinese Peruvians
Tan Zhaowei	Tam Siu Wai
MenuetOS	MenuetOS
beat music	Beat music
Olomouc Football Club	SK Sigma Olomouc
Margaret Tudor	Margaret Tudor
Nu Su language	Nusu language
Youre my sunshine	Youre My Sunshine
Lokomotiv Zagreb Football Club	NK Lokomotiva
Back to Three Kingdoms	Three Kingdoms RPG
Daft Punk	Daft Punk
Kobe	Kobe
Lithuanian Parliament	Seimas
Ange Postkoglu	Ange Postecoglou
Paraná	Paraná
Fyodor Mikhailovich Dostoevsky	Fyodor Dostoyevsky
Leticia	Queen Letizia of Spain
bucky road	Bagyidaw
hannibal	Hannibal
IPad mini 2	IPad Mini 2
They Dont Care About Us	They Dont Care About Us
Durham University	Durham University
Martin Luther	Martin Luther
Mura	Mula Spain
Kasper Gusk	Kasper Kusk
Edward ReitzHimigvi	Edward RydzŚmigły
Peking Union Medical College	Peking Union Medical College
Spain under21 national football team	Spain national under21 football team
Xiao Zhengnan	Edwin Siu
James Newton Howard	James Newton Howard
HIStory	HIStory
Latin Alphabet	Latin script
Heart War	Master of Play
Sony Xperia sola	Sony Xperia sola
Hendrik Frensch Verwald	Hendrik Verwoerd
Eva Green	Eva Green
Faruksia	Farrukhsiyar
East Imphal County	Imphal East district
Sony Xperia miro	Sony Xperia miro
Idam Khalid	Idham Chalid
Henry Temple 3rd Viscount Palmerston	Henry John Temple 3rd Viscount Palmerston
blackpool	Blackpool
British Crazy Car Show	Top Gear
Salatan Lumby Calendar	Zlatan Ljubijankić
Sanmenxia	Sanmenxia
nevada	Nevada
TheDream	TheDream
Piedmontese	Piedmontese language
Qing Taizu Dafei	Lady Abahai
Taemin Lee	Lee Taemin
Lehigh River	Lehigh River
Nogi Nogi	Nogi Maresuke
Baham	PaHng language
CharleMattia Simmons	CharlesMathias Simons
Republican	The Republicans
Big Shots	Mr Big
Andrew Carroll	Andy Carroll
Welsh Premier League	Welsh Premier League
Ariège	Ariège
Zurab Nogajli	Zurab Noghaideli
Safari	Safari
Lawrence Gonzi	Lawrence Gonzi
Alison Krauss	Alison Krauss
Elena Kagan	Elena Kagan
Zheliu Zherev	Zhelyu Zhelev
Blanche Lincoln	Blanche Lincoln
Podiancha	Henry Pottinger
John William Snow	John W Snow
GFRIEND	GFriend
This Is It	Michael Jacksons This Is It
Shota Hirayama	Sōta Hirayama
William IV	William IV Grand Duke of Luxembourg
AMD Athlon 64	Athlon 64
John Tsang	John Tsang
Jurky Katainen	Jyrki Katainen
Shenzhou II	Shenzhou 2
Yamanashi Hanzo	Yamanashi Hanzō
Khloe Kardashian	Khloé Kardashian
Massimo Otto	Massimo Oddo
Macross	Random Access Memories
Yokai Watch Collection	YoKai Watch
Charles  Prince of Wales	Charles Prince of Wales
new city	Shinshiro Aichi
Guo Shaoyun	Florence Kwok
ONE 4 U	One 4 U
IOS 9	IOS 9
Conservative	Conservative Party
Serbian	Serbian language
Lezier III	Letsie III of Lesotho
Alex Bruce	Alex Bruce
Pandeli Maiko	Pandeli Majko
South Vietnam Republic	Provisional Revolutionary Government of the Republic of South Vietnam
oneworld	Oneworld
Nikola Tesla	Nikola Tesla
Yonsei University	Yonsei University
Puning	Puning
Queensland	Queensland
Frederick Reinfeldt	Fredrik Reinfeldt
Underground Haoduo	Kouta Jige
petty girls rush forward	Office Girls
PlayStation 3	PlayStation 3
Ismet Inonu	İsmet İnönü
manhattan	Manhattan
KhyberPashtun	Khyber Pakhtunkhwa
PhoenixSun	Phoenix Suns
Petko Karavilov	Petko Karavelov
Hong Tianguifu	Hong Tianguifu
Icy Sea Start in my life	Tsumetai Umi Start in My Life
Phil Jackson	Phil Jackson
I Wanna Dance	I Wanna Dance
Su30MKK Fighter	Sukhoi Su30MKK
William Rehnquist	William Rehnquist
Duzhiyuan	Do Jiwon
Lukacs Gyorgy	György Lukács
Marcel Desailly	Marcel Desailly
Anyang	Anyang
Hulk	Hulk
Tottori Fly	Gainare Tottori
Eric Abidal	Éric Abidal
Zeng Qinghong	Zeng Qinghong
Taihu Film	Taihu Wu dialects
Emanuele Filiberto	Prince Emanuele Filiberto Duke of Aosta
skateboard boy	Sk8er Boi
Spanish Football Second Division	Segunda División B
Timothy F Geithner	Timothy Geithner
Binhai New Area	Binhai
Sky Sports	Sky Sports
Sayad Krasinac	Sead Kolašinac
Fantastic Girls	Fantastic Girls
Transnistria	Transnistria
Taiwan Austronesian Language	Formosan languages
Oklahoma City	Oklahoma City
Matthew Ridgway	Matthew Ridgway
IndoEuropean	IndoEuropean languages
Chief Executive of the Hong Kong Special Administrative Region	Chief Executive of Hong Kong
Jin Jun	Kim Joon
Shanghai SIPG Football Club	Shanghai SIPG FC
Zhou Liqi	Niki Chow
Verona FC	Hellas Verona FC
Ministry of Science and Technology of the Republic of China	Ministry of Science and Technology
China Eastern Airlines	China Eastern Airlines
Emperor Gomizuo	Emperor GoMizunoo
Lost	Lost
Oasis	Oasis
Fantasy	Fantasy
Emmanuel Fripon	Emmanuel Frimpong
Humbaritu Baruchis Tessina	Humberlito Borges
Second Polish Republic	Second Polish Republic
Kievan Rus	Kievan Rus
Chandler Ibrahim Pasha Jr	Çandarlı Ibrahim Pasha the Younger
Merrimack River	Merrimack River
AKS	AKS
Philip Sharp	Phillip Allen Sharp
Anna of Austria	Anne of Austria Queen of Poland
Friends	Friends
Al Ain Football Club	Al Ain FC
Konstantin Ustinovich Chernenko	Konstantin Chernenko
Shandong Sports Center Stadium	Shandong Provincial Stadium
Iwamasa Taiki	Daiki Iwamasa
Interplay Entertainment	Interplay Entertainment
INSPIRE	Inspire
Wang Yu	Jimmy Wang Yu
Consbyshire	Hornsby Shire
Hong Kong Olympic Football Team	Hong Kong national under23 football team
Tauer Matan Ruak	Taur Matan Ruak
Hong Kong Under17 Football Team	Hong Kong national under17 football team
Rosa Luxembourg	Rosa Luxemburg
Crown Princess Masako	Masako Crown Princess of Japan
Disney Channel	Disney Channel
Shizuoka	Shizuoka Shizuoka
University of California Berkeley	University of California Berkeley
strong5	Nanchang Q5
zambia	Zambia
Henry Brisson	Henri Brisson
Lin Ruilin	Stephen Lam
MAD	Mad
Mary of Turk	Mary of Teck
Highbury Stadium	Arsenal Stadium
Yanbian Fude Football Club	Yanbian Fude FC
Grolla Poncarno Stadium	Gelora Bung Karno Stadium
Bali Alphabet	Balinese alphabet
President of India	President of India
Wenzhou Baolong Football Club	Wenzhou Provenza FC
John Hancock	John Hancock
Japan Airlines	Japan Airlines
Democratic	Democratic Party
Huang Jiaju	Wong Ka Kui
Beast Boy	Beastie Boys
Boer	BoA
Jean Chretien	Jean Chrétien
Adobe Flash Player	Adobe Flash Player
Jack Black	Jack Black
Curtain Around	Guruguru Curtain
William Adams Richardson	William Adams Richardson
MacLehose	Murray MacLehose Baron MacLehose of Beoch
Middlesbrough Football Club	Middlesbrough FC
No Protection	No Protection
French National League	Championnat National
Israel National Mens Soccer Team	Israel national football team
Bardone	Bardonnex
William Henry Bragg	William Henry Bragg
American Airlines	American Airlines
Jin Tai Lung	Kim Taeyeon
Princess Louise of Sweden	Louise of Sweden
John Strat 3rd Baron Rayleigh	John William Strutt 3rd Baron Rayleigh
Touch Me	Touch Me
Mark Player	Mark Pryor
Ethan Ruan	Ethan Juan
Tlingit	Tlingit language
Navajo	Navajo
Chen Changyuan	Xavier Chen
George Maximilianovich Malenkov	Georgy Malenkov
Quechua	Quechuan languages
Falisk	Faliscan language
Spanish Parliament	Cortes Generales
Lu Dingyi	Lu Dingyi
please please me	Please Please Me
199900 UEFA Champions League	19992000 UEFA Champions League
Asano Takuma	Takuma Asano
Google X	X
The RomanSyrian War	RomanSeleucid War
Faroes Sports Club	SC Farense
Hatoyama Ichiro	Ichirō Hatoyama
Mauricio Pochettino	Mauricio Pochettino
Cao Binh Province	Cao Bằng Province
Sissi	Empress Elisabeth of Austria
Fujian Province	Fujian
James Gosling	James Gosling
Koryak	Koryak language
Moric	Ernie Merrick
StPatricks Athletic Football Club	St Patricks Athletic FC
Donnie Yen	Donnie Yen
Zayed bin Sultan Al Nahyan	Zayed bin Sultan Al Nahyan
Carlo Bonaparte	Carlo Buonaparte
Abby Road	Abbey Road
Burenli	Gerard Brennan
Halo	Halo
Portimonense Athletic Club	Portimonense SC
Angelababy	Angelababy
Yijia Youxi	Show Me the Happy
Elder Postiga	Hélder Postiga
Iri Rusnock	Jiří Rusnok
Utsunomiya City	Utsunomiya
Macau	Macau
Chris Griffin	Chris Griffin
Fyodor III	Feodor III of Russia
virgil	Virgil
Isamu Abe	Yuki Abe
Osaka International Airport	Osaka International Airport
Cant forget your love PERFECT CRIME Single Edit	Cant Forget Your Love Perfect Crime
Pope Zephline	Pope Zephyrinus
Henry III	Henry III of England
An Xiyan	Hani
Silver Mt Zion	Thee Silver Mt Zion Memorial Orchestra
Foxborough	Foxborough Massachusetts
Omachi	Ōmachi Nagano
Augustus	Augustus
Warner Music Group	Warner Music Group
Odds	Doctor Who
Tutsi	Tutsi
Bolivia National Football Team	Bolivia national football team
Slovenian Football League	Slovenian PrvaLiga
fuzzy	Blur
Myanmar	Burmese alphabet
Frederick William De Clark	F W de Klerk
Boom Dance	Dance de Bakōn
Moses Katsav	Moshe Katsav
Henry II	Henry II of England
Reubisa Tubakovic	Ljubiša Tumbaković
University of Jena	University of Jena
Rebecca Mader	Rebecca Mader
London	London
Universidad Autónoma de Nuevo Leon Tigers Football Club	Tigres UANL
Lucky Star	Kamelot
Leo IV	Pope Leo IV
Jesse Dylan	Jesse Dylan
Kelly Hilson	Keri Hilson
Irish War of Independence	Irish War of Independence
Forensic Pioneer II	Forensic Heroes II
Malouf Bahit	Marouf alBakhit
Konstantin Sharienlov	Konstantin Zyryanov
New Brunswick	New Brunswick
President of Mexico	President of Mexico
Kamikawa Yoko	Yōko Kamikawa
Royal Wista Road Football Club	KVC Westerlo
Zhang Yuning	Zhang Yuning
Comedy Central	Comedy Central
Xidan text	Siddhaṃ script
HerzegovinaNeretva Region	HerzegovinaNeretva Canton
Zhu Qianxue	Tracy Chu
San Marino National Football Team	San Marino national football team
Saint Bernard	Bernard of Clairvaux
Renaissance	Ennahda Movement
Gary McAristotle	Gary McAllister
Deng Ziqi	GEM
Taipei City Government	Taipei City Government
Wang Changqing	Wang Changqing
Prince of Xinzi Nei	Princess Yoshiko
Thein Sein	Thein Sein
Carl Linnaeus	Carl Linnaeus
Christine Gregoire	Christine Gregoire
new metal	Nu metal
The confession of love	Oops I Did It Again
Stuy Griffin	Stewie Griffin
Tanaka Touri King	Marcus Tulio Tanaka
Martin Heidegger	Martin Heidegger
What turns you on3F	What Turns You On3F
MUSIC Perfect Jiayin	Music
Ouyang Zhenhua	Bobby Auyeung
PlayStation Vita	PlayStation Vita
Youlan	Youlan
Samuel D Ingham	Samuel D Ingham
Krasnodar Kuban Football Club	FC Kuban Krasnodar
Soren Ober Kierkegaard	Søren Kierkegaard
Queen Maria Fyodorovna	Maria Feodorovna
Allied Military Occupation of Japan	Occupation of Japan
The Siren	The Siren
Kashubian	Kashubian language
Nanzi	Chữ nôm
HTC One S	HTC One S
South African Business Airlines	Comair
memphis	Memphis Tennessee
Saint Barthelemy	Saint Barthélemy
Tim Duncan	Tim Duncan
Mizuhocho	Mizuho Tokyo
Commercial	Comoros
Taoyuan City	Taoyuan Taiwan
Quanxingxing	Jun Hyoseong
QBASIC	QBasic
Grand Duchess Maria Theresa	Maria Teresa Grand Duchess of Luxembourg
Tudor	House of Tudor
Beth Truman	Bess Truman
Jan Vertonghen	Jan Vertonghen
Theodoros Pangalos	Theodoros Pangalos
True love is like blood	True Blood
Zhou Xuan	Zhou Xuan
dorset	Set
IPad	IPad
Hirofumi Nakasone	Hirofumi Nakasone
Haarlem Tennyson 2nd Baron Tennyson	Hallam Tennyson 2nd Baron Tennyson
China Television Corporation	China Television
DebreziniVSC	Debreceni VSC
Exodus 04	Exodus 04
United Workers Party of Poland	Polish United Workers Party
John Paul Stevens	John Paul Stevens
beachboys	The Beach Boys
Asamoah Gian	Asamoah Gyan
UK House of Commons	House of Commons of the United Kingdom
Kingdom of Albania	Albanian Kingdom
Heyuan City	Heyuan
Indian Space Research Organization	Indian Space Research Organisation
LEGEND	Legend
Oklahoma City Thunder	Oklahoma City Thunder
Choctaw	Choctaw language
Fang Yinglin	Michael Fallon
Lucrezia Borgia	Lucrezia Borgia
Steve Clifford	Steve Clifford
Sean Lennon	Sean Lennon
Nusra Front	AlNusra Front
Yuko Obuchi	Yūko Obuchi
Toyota Stadium	Toyota Stadium
Robert Mueller	Robert Mueller
Tone	Thônex
Fukushima Prefecture	Fukushima Prefecture
Kiss	Kiss
Secret	Secret
Courtney Hodges	Courtney Hodges
Bulgarian Socialist Party	Bulgarian Socialist Party
Robin Gibb	Robin Gibb
The Emperor	Empress Jitō
Oliver Kahn	Oliver Kahn
Gregory IV	Pope Gregory IV
Batislava Sloan Sports Club	ŠK Slovan Bratislava
Academia Sinica	Academia Sinica
Gan Chinese	Gan Chinese
youde	Edward Youde
Mario Gotze	Mario Götze
Cary	Cary North Carolina
Kisarazu	Kisarazu
Republic of Congo	Republic of the Congo
Allan Poe	Edgar Allan Poe
Eddie Redmayne	Eddie Redmayne
Royal Ontario Museum	Royal Ontario Museum
Paul Bremer	Paul Bremer
Takeshi Kobayashi	Takeshi Kobayashi
Hanshan Qianlong	Ghost Dragon of Cold Mountain
Kean Johnson	Keen Johnson
Lee Seung Hyun	Lee Seunghyun
2014 Summer Youth Olympic Games	2014 Summer Youth Olympics
2015 AFC Champions League	2015 AFC Champions League
imagine	Imagine
MuhammadReza Pahlavi	Mohammad Reza Pahlavi
Martin V	Pope Martin V
Hu Zhaojun	Hu Zhaojun
John Tuzzo Wilson	John Tuzo Wilson
Mastena Stadium	Mestalla Stadium
Shioya Division	Tsukasa Shiotani
Chester William Nimitz	Chester W Nimitz
Navi	Narwee New South Wales
Mai Qiguang	Mak Chaikwong
Fabricio dos Santos Messias	Fabrício dos Santos Messias
Buffy the Vampire Slayer	Buffy the Vampire Slayer
Liang Hanwen	Edmond Leung
Hugo Lloris	Hugo Lloris
Catholic PortoSanta Rufina Roman Suburbs	Suburbicarian Diocese of Porto e Santa Rufina
Medway	Medway
Barende Bishouville	Barend Biesheuvel
Channel 1	Channel One Russia
Roger Myerson	Roger Myerson
Chen Jiaqiang	KC Chan
Sydney Airport	Sydney Airport
Dmitry Stepanovich Polyansky	Dmitry Polyansky
Inner Mongolia Zhongyou Football Club	Nei Mongol Zhongyou FC
Zhu Huimin	Queenie Chu
Mei Hanli	Francis Henry May
Olof Palme	Olof Palme
Ronald Fisher	Ronald Fisher
Prince Fushimi Palace Zhenai	Prince Fushimi Sadanaru
Lang Son Province	Lạng Sơn Province
Romain Jacobson	Roman Jakobson
Matilda of Flanders	Matilda of Flanders
Resident Evil Series	Resident Evil
Senard Lulich	Senad Lulić
Li Xini	Licinius
Sports Club Hamburg	Hamburger SV
Brazil Football League	Campeonato Brasileiro Série A
Jorge Andrade	Jorge Andrade
GLAMOROUS SKY	Glamorous Sky
Jinshen Tu	James To
Suganuma	Shunya Suganuma
Jeonsumamin	Jung Somin
Harris Sirajditch	Haris Silajdžić
Ernst Happel Stadium	ErnstHappelStadion
Southern Rhodesia	Southern Rhodesia
Zhongtian International Station	CTi International
Jan Peter Balkenende	Jan Peter Balkenende
Polish Prime Minister	Prime Minister of Poland
Park Tae Joon	Park Taejoon
Tsumi Jingping	Kyōhei Tsutsumi
Chang Wanquan	Chang Wanquan
West Virginia Administrative Divisions	List of counties in West Virginia
Lin Yixiong	Lin Yihsiung
Ayn Rand	Ayn Rand
Tehran	Tehran
Arsinois IV	Arsinoe IV of Egypt
Switzerland under21 national football team	Switzerland national under21 football team
County Tipperary	County Tipperary
Chech Marin	Cheech Marin
University of Western Ontario	University of Western Ontario
Black Tower III Trial of the Wasteland	The Dark Tower III
Hunting Valley	Hunting Valley Ohio
JavaScript	JavaScript
Hong Zhe	Hong Chul
Gustav Stresemann	Gustav Stresemann
Nakaimachi	Nakai Kanagawa
Isuzu Elf	Isuzu Elf
2012 Chinese Football Association Cup	2012 Chinese FA Cup
Yasuo Fukuda	Yasuo Fukuda
Garfield County	Garfield County Utah
Freeform	Freeform
Voice of EARTH	Voice of Earth
Batman Forever	Batman Forever
Shandong University	Shandong University
Yang Tieliang	Yang Tiliang
Kumi Koda	Kumi Koda
Xu Ruoxuan	Vivian Hsu
Latvian	Latvian language
Empress Xiaocigao	Empress Ma
like  a person	Pleasantly Surprised
Tyne Castle Stadium	Tynecastle Stadium
Alan Tomson	Alan Thompson
SEASONS	Seasons
August Wilhelm von Hoffmann	August Wilhelm von Hofmann
BrazilianPortuguese	Brazilian Portuguese
Hirosaki	Hirosaki Aomori
Sub Pop	Sub Pop
Kevin Cash	Kevin Cash
Alexander the Greats campaigns in the Balkans	Alexanders Balkan campaign
shires	The Hills Shire
Maurice BourgetMonouli	Maurice BourgèsMaunoury
Menlo Park	Menlo Park California
CastileLeon	Castile and León
Prince Carl Philip	Prince Carl Philip Duke of Värmland
Adib Shakri	Adib Shishakli
George Papadopoulos	Georgios Papadopoulos
Entertainment Time Network	Showtime
Lusio	Lúcio
ActionScript	ActionScript
Stanislaw Mikovajczyk	Stanisław Mikołajczyk
Quang Tri Province	Quảng Trị Province
MT Framework	MT Framework
President of the Philippines	President of the Philippines
Windows Server 2008	Windows Server 2008
Wang Shouting	Wang Shouting
Albanian Democratic Party	Democratic Party of Albania
Mongolia	Mongolia
SISTAR19	Sistar19
Shin Eun Soon	Shin Inseob
Neil Pelt	Neil Peart
John Quincy Adams	John Quincy Adams
Jeremy Bentham	Jeremy Bentham
Albert Gallatin	Albert Gallatin
glorious	Koei
Babe Ruth	Babe Ruth
He Yingqin	He Yingqin
Criterion Games	Criterion Games
Wang Dingchang	Ong Teng Cheong
Rolandas Paxas	Rolandas Paksas
Wolfgang Schaeuble	Wolfgang Schäuble
Li Rong	Lee Yong
Faye Disc	Faye Disc
Denis Diderot	Denis Diderot
Republic of Vietnam Army	Army of the Republic of Vietnam
Giorgio Chiellini	Giorgio Chiellini
SDF	Japan SelfDefense Forces
Stan Loos	Storm Roux
Tajimi City	Tajimi Gifu
devon	Devon
201213 English Premier League	201213 Premier League
Jalan Besar Stadium	Jalan Besar Stadium
Mateo Renzi	Matteo Renzi
CW Television Network	The CW
Mario Gavlanovic	Mario Gavranović
National Geographic Channel	National Geographic Channel
Norfolk Island	Norfolk Island
Xu Ruyun	Valen Hsu
Luo Minzhuang	Mimi Lo
Guy de Maupassant	Guy de Maupassant
Fuminis Football Club	Fluminense FC
TVBS News	TVBSNEWS
Lu Camp Stadium	Camp Nou
Sunderland	Sunderland Tyne and Wear
Song Ji Eun	Song Jieun
Winners	The Wynners
Percy Byshe Shelley	Percy Bysshe Shelley
Dalian Shide Football Club	Dalian Shide FC
brisbane	Brisbane
Batangas Province	Batangas
Chanis Tsanetakis	Tzannis Tzannetakis
Ferrit Mellen	Ferit Melen
J8	Shenyang J8
Middle Tibetan	Old Tibetan
Tim Krell	Tim Krul
Talkin 2 myself	Talkin 2 Myself
Los Alamos National Laboratory	Los Alamos National Laboratory
Victory Tour	Victory Tour
Peter Eisenman	Peter Eisenman
Hilary Whitehall Putnam	Hilary Putnam
Feddy Taylor	Fatih Terim
Luo Zhien	Lo Chihen
School Police Sniper	EU
Jan Kazimierz	John II Casimir Vasa
Lake Michigan	Lake Michigan
Zhao Yuanxi	Cho Wonhee
JeanPierre Raffarin	JeanPierre Raffarin
Song Wenjie	Song Wenjie
Boyi IX	Pope Boniface IX
Daisuke Matsui	Daisuke Matsui
Guan Zhen	Guan Zhen
Windows 81	Windows 81
Hu Zhijun	Hu Zhijun
The Hidden Wolf	Ōkami Kakushi
Ota City	Ōta Gunma
Avila Province	Province of Ávila
Stanko Todorov	Stanko Todorov
Han Xue	Han Xue
Milton Township	Milton Township Butler County Kansas
NEVER GONNA GIVE YOU UP	Never Gonna Give You Up
Suzuki Airi	Airi Suzuki
Liu Cixin	Liu Cixin
Suzuki Escudo	Suzuki Escudo
Football Association of the Republic of China	Chinese Taipei Football Association
Harbin	Harbin
Giuliano Amato	Giuliano Amato
Washington Bartlett	Washington Bartlett
Philip Rosler	Philipp Rösler
Alex Sange	Alex Song
Ferrando Morendis	Fernando Morientes
Lokomotiv Plovdiv Football Club	PFC Lokomotiv Plovdiv
WANT ME WANT ME	Want Me Want Me
Juan Guillermo Cuadrado	Juan Cuadrado
Chen Boyu	Jason Chan
Zhang Jinchuang	Trương Tấn Sang
OS X Mavericks	OS X Mavericks
Ayaka Umeda	Ayaka Umeda
LIFE	Life
United States Attorney General	United States Attorney General
Chiayi City	Chiayi
Assassins Creed	Assassins Creed
Guoneng Li	Andrew Li
Bellevue Hill	Bellevue Hill New South Wales
SUMMER SONG	Summer Song
Angu	Anggun
Stefan Effenberg	Stefan Effenberg
Maoming	Maoming
Pat Hingle	Pat Hingle
Bright Eyes Shana	Shakugan no Shana
grunge	Grunge
Edmund Barton	Edmund Barton
Woodrow Wilson	Woodrow Wilson
Ken Salazar	Ken Salazar
Hergen Football Club	BK Häcken
Shanghai Greenland Shenhua Football Club	Shanghai Greenland Shenhua FC
200405 UEFA Cup	200405 UEFA Cup
Drake	Drake
Hu Baiquan	Woo Pakchuen
Edward Shevardnadze	Eduard Shevardnadze
Sarajevo	Sarajevo
Zhuge Liang	Zhuge Liang
Jedda Al Ali Sports Club	AlAhli Saudi FC
David Cameron	David Cameron
Naxi	Naxi language
Leandro Neto	Leandro Netto de Macedo
Park Juyoung	Park Chuyoung
Leichardt	Municipality of Leichhardt
Pope Dewu I	Pope Adeodatus I
New Zealand Defence Force	New Zealand Defence Force
Wu Jing	Wu Jing
J6 Fighter	Shenyang J6
south dakota	South Dakota
Naji Imre	Imre Nagy
Love across the ocean	Love Across the Ocean
Helen Ma	Helen Ma
Pope Alexander I	Pope Alexander I
Hurricane Dean	Hurricane Dean
Latvia National Under21 Football Team	Latvia national under21 football team
Russian	Russian language
Benjamin Harrison	Benjamin Harrison
Huang Jiading	Ong Ka Ting
Komi	Komi language
Malawi	Malawi
Leo XII	Pope Leo XII
Lazio	Lazio
Kamenashi Kazuya	Kazuya Kamenashi
University of California	University of California
Sports Club Hertha Berlin	Hertha BSC
Greg Oden	Greg Oden
Jiang Jihong	Jiang Jihong
Lu Huiyi	Koni Lui
Sato Sato	Hisato Satō
Fernando Enrique Cardoso	Fernando Henrique Cardoso
Wins Cable	Vince Cable
Always Be My Baby	Always Be My Baby
Wang Junxin	Grace Wong
kerala	Kerala
Beat It	Beat It
30 seconds to Mars	Thirty Seconds to Mars
Gloucestershire	Gloucestershire
Reims	Reims
Sapsburg 08 Football Club	Sarpsborg 08 FF
Fuling District	Fuling District
Surface	Surface
Pol Pot	Pol Pot
Atlantic Records	Atlantic Records
Nobel Prize in Economics	Nobel Memorial Prize in Economic Sciences
algeria	Algeria
Pete de Jong	Piet de Jong
JapanRyukyu	Japonic languages
3rd Army of the Republic of Vietnam	III Corps
The student council president is a maid	Maid Sama
Czech Football League	Czech First League
Thomas Sorenson	Thomas Sørensen
County Galway	County Galway
Career Challenge Series 3	Pro Challenge Series  Event 3
Clear Water Council	Pittwater Council
Goa Football Club	FC Goa
Rakuten	Rakuten
Jorge Luis Pinto	Jorge Luis Pinto
Somerset	Somerset
Sunrise Sunset LOVE is ALL	Sunrise Sunset
Eason Chan	Eason Chan
DreamWorks	DreamWorks
Haikou	Haikou
lane	Nani
SEVEN	Seven
Li Shuangjiang	Li Shuangjiang
North Plains Mile	Rie Kitahara
North Korean Peoples Committee	Provisional Peoples Committee for North Korea
Kevin Durant	Kevin Durant
Joe Smith	Joe Smith
BOLERO	Bolero
Hadrian V	Pope Adrian V
JiangThe Warring States of the Princesses	Gō
Susan Collins	Susan Collins
Alexis Tocqueville	Alexis de Tocqueville
Kingdom of Georgia	Kingdom of Georgia
Irving	Irvine California
Pirates of the Caribbean	Pirates of the Caribbean
Daniel Van Buiten	Daniel Van Buyten
Umbro	Umbro
Pierre Morroy	Pierre Mauroy
Like a virgin	Like a Virgin
Saad Daula	Saad adDaula
Hamid Altintop	Hamit Altıntop
Barrie Sports Club	FC Bari 1908
Shandong Province	Shandong
Ghent	Ghent
Ku Hye Sun	Ku Hyesun
Zhongxian Yangtze River Bridge	Zhongxian Yangtze River Bridge
Martin ONeal	Martin ONeill
Los Llanos de Aridane	Los Llanos de Aridane
Speedy Otaku	Yowamushi Pedal
Ingush	Ingush language
IndusAmsis	Indulis Emsis
Labour	Labour Party
Pope John V	Pope John V
Shini Bhamo	Seni Pramoj
An Yixuan	Ady An
Mary Adelaide County	Princess Mary Adelaide of Cambridge
Jewelry	Jewelry
Edwin van der Sar	Edwin van der Sar
George Patton	George S Patton
The Condor Heroes	The Return of the Condor Heroes
Jay Carney	Jay Carney
Howard Webby	Howard Webb
Li Weihan	Li Weihan
Eindhoven	Eindhoven
Justin Yifu Lin	Justin Yifu Lin
Jacob Faulhard	Jacob Volhard
Leeds Football Club	Leeds United FC
Princess Little Sister	Romantic Princess
Algerian War	Algerian War
Joseph Kabila	Joseph Kabila
Mai Ruobin	Robin McLaren
Nicholas II	Nicholas II of Russia
Shenzhou III	Shenzhou 3
Northern Ireland Varsity	Northern Ireland national football team
Gothenburg	Gothenburg
Clement VIII	Pope Clement VIII
Ben Sass	Ben Sasse
The End of the World	Kono Yo no Kagiri
Lace Master	Gossip Girl
British Airways	British Airways
New York Yankees	New York Yankees
SMTHE BALLAD	SM the Ballad
James Rodriguez	James Rodríguez
Zdenek Grigera	Zdeněk Grygera
DanishParliament	Folketing
Alexander Fyodorovich Kerensky	Alexander Kerensky
Huang Debin	Kenny Wong
Ministry of Justice of the Republic of China	Ministry of Justice
Sexy Free  Single	Sexy Free  Single
Communist Party of Czech and Moravia	Communist Party of Bohemia and Moravia
Bless4	Bless4
Mikael Landero	Mickaël Landreau
Bunun	Bunun language
George Napolitano	Giorgio Napolitano
George Reid	George Reid
HTC One	HTC One
Samsung Galaxy Note Edge	Samsung Galaxy Note Edge
Dara	Sandara Park
Emperor Wei Xiaowu	Emperor Xiaowu of Northern Wei
Maicon Douglas Cicendo	Maicon Sisenando
Mike Havinal	Mike Havenaar
Colorado River	Colorado River
Secretary of the Central Commission for Discipline Inspection of the Communist Party of China	Secretary of the Central Commission for Discipline Inspection
Getafe	Getafe
Brunei National Football Team	Brunei national football team
Tom Herning Overreb	Tom Henning Øvrebø
Fusheng City	Fussa Tokyo
Mark Bisianu	Mark Bresciano
I am	I Am
Yueyang	Yueyang
Central Kalimantan	Central Kalimantan
Kato Takaaki	Katō Takaaki
gabon	Gabon
Alexander III	Alexander III of Russia
Quanzhang Pian	Hokkien
The Battle of Qingchang Ryukyu	Invasion of Ryukyu
Charles WatsonWentworth 2nd Marquess of Rockingham	Charles WatsonWentworth 2nd Marquess of Rockingham
Windows Mobile	Windows Mobile
Cambodia Japanese Occupation Period	Japanese occupation of Cambodia
Kim Shellstrom	Kim Källström
Liu Xianhua	Henry Lau
Taian	Taian
Thai text	Thai alphabet
Javanese alphabet	Javanese script
Bruce Dieter	Bruce Djite
Binan City	Hekinan
Shan	Shan people
Nicolas Ledescu	Nicolae Rădescu
1860 Munich Athletic Conference	TSV 1860 München
2014 AFC Champions League	2014 AFC Champions League
Square Enix Europe	Square Enix Europe
David James	David James
Nara City	Nara Nara
Windows Phone 81	Windows Phone 81
Buono	Buono
Frozen	Frozen
WebOS	WebOS
Stefana Mbia	Stéphane Mbia
Michael Jackson	Michael Jackson
Lhasa Gonggar Airport	Lhasa Gonggar Airport
Hannah Montana	Hannah Montana
Weng Jinzhu	Wong Chinchu
Haim Herzog	Chaim Herzog
Tokugawa Jiada	Tokugawa Iesato
Zambia National Football Team	Zambia national football team
Oxford United Football Club	Oxford United FC
Eiji Kawashima	Eiji Kawashima
Jiaxing	Jiaxing
Wah Yan College Hong Kong	Wah Yan College Hong Kong
Ludwig III	Ludwig III of Bavaria
Legislative Yuan	Legislative Yuan
Shnisha Mihlo domain	Siniša Mihajlović
Xie Fuzhi	Xie Fuzhi
Domzal Football Club	NK Domžale
Eugene	Eugene Oregon
Vikings Football Club	Viking FK
England B Division	Football League Second Division
€	Euro
Beijing Workers Stadium	Workers Stadium
Qianlong Emperor	Qianlong Emperor
Carlos	Carlos Duke of Parma
Super JuniorM	Super JuniorM
HarvardCollege	Harvard College
University of Chile Football Club	Club Universidad de Chile
Coats Road Sports Club	Cruzeiro Esporte Clube
Ali Muhammad Mujawar	Ali Muhammad Mujawar
2008 South Ossetia War	RussoGeorgian War
Takaichi Sanae	Sanae Takaichi
Danielle Diordonu Suarez	Danilo Soares
England Football Team B	England national football B team
Theora	Theora
Russell Brand	Russell Brand
Miami FC	Miami FC
Dear J	Dear J
Anaheim	Anaheim California
Valencia Mastina	Valencia CF Mestalla
Duncan Edward Odgerton	Duncan Oughton
Kozhikode County	Kozhikode district
Sofia Loren	Sophia Loren
Didier Deschamps	Didier Deschamps
KDE	KDE
Ottoman Empire	Ottoman Empire
University of Liverpool	University of Liverpool
Kaohsiung MRT Orange Line	Orange Line
Huang Rong	Huang Rong
Irtysh	Irtysh River
Benedict Arnold	Benedict Arnold
Baron Straker	Baron Strucker
Tami Baldwin	Tammy Baldwin
Kenhisa Tamura	Norihisa Tamura
hamburg	Hamburg
German	German language
Red Star Awards 2003	Star Awards 2003
Rostin Griffith	Rostyn Griffiths
Edinson Cavani	Edinson Cavani
Lees Korea	Joseon
Alexandra of Denmark	Alexandra of Denmark
2007 AFC Champions League	2007 AFC Champions League
Charlotte	Charlotte
Salvatore Sirigu	Salvatore Sirigu
Anda Weiss	André Weis
Xie Chen Gaowei	Jason Crowe
Todor Bulmov	Todor Burmov
John VIII	Pope John VIII
Ester Family	House of Este
Queen Frederick	Victoria Princess Royal
Ulchi	Ulch people
Mai Changqing	Evergreen Mak Cheungching
Sunrise	Hi Izuru Tokoro
Xu Fan	Xu Fan
abkhazia	Abkhazia
Azerbaijani	Azerbaijani language
University of Turin	University of Turin
Liu Shishi	Liu Shishi
Nintendo Network	Nintendo Network
Tochigi Prefecture	Tochigi Prefecture
La Mirada	La Mirada California
Karel Schwarzenberg	Karel Schwarzenberg
Berlin	Berlin
Kluwera Orchestra	Krewella
Nino Burjanadze	Nino Burjanadze
Tom Caton	Tom Cotton
Shadley Ben Jadid	Chadli Bendjedid
Williamsong	Wilhelmus
Sigismund August	Sigismund II Augustus
Jack Thor	JackTor
Pat Toomey	Pat Toomey
John Taylor	John Tyler
Social Democratic Labour Party	Social Democratic and Labour Party
Republic of Singapore Air Force	Republic of Singapore Air Force
Hatsune Miku	Hatsune Miku
Bradford	Bradford
Bratislava	Bratislava
Daniel Zitka	Daniel Zítka
Yang Peian	Yang PeiAn
Buryat	Buryat language
surrey	Surrey British Columbia
Austria National Football Team	Austria national football team
Anthony Kennedy	Anthony Kennedy
Glasgow	Glasgow
honduras	Honduras
Michael Schumacher	Michael Schumacher
Charleston	Charleston South Carolina
Christian Macho	Christian Maggio
Pierre Curie	Pierre Curie
Tachira Athletic Football Club	Deportivo Táchira
PKK	Kurdistan Workers Party
Niko Kovacs	Niko Kovač
Artaxerxes I	Artaxerxes I of Persia
Cambridge United Football Club	Cambridge United FC
Zhejiang Province	Zhejiang
Naha City	Naha
Côte dIvoire	Ivory Coast
Alan Ball	Alan Ball
Cai Xili	Chua Soi Lek
A ONE	A One
Mahmoud Ahmadinejad	Mahmoud Ahmadinejad
Tubo	Tibetan Empire
Exeter City Football Club	Exeter City FC
Sergey Aksyonov	Sergey Aksyonov
Valais	Valais
Tang Dechao	Tang Dechao
Matthew Hancock	Matthew Hancock
Upper IJssel	Overijssel
Jens Jeremias	Jens Jeremies
Nicolas I	Pope Nicholas I
BioWare	BioWare
Wang Yunlong	Wang Yunlong
Aziz Ibrahimov	Aziz Ibragimov
blackberryworld	BlackBerry World
Ito Masayoshi	Masayoshi Ito
Akita	Akita Akita
Lu Junyi	Lo Kwan Yee
Ezquel Lavizzi	Ezequiel Lavezzi
Vasily Tallev	Vasile Tarlev
Ireland Football Association	Football Association of Ireland
Robert Stewart Viscount Cassuri	Robert Stewart Viscount Castlereagh
Nexus 9	Nexus 9
bedfordshire	Bedfordshire
Princess Marta	Princess Märtha of Sweden
Rise Records	Rise Records
Ugaki Kazunari	Kazushige Ugaki
Henry Gray 1st Duke of Suffolk	Henry Grey 1st Duke of Suffolk
Little Rock	Little Rock Arkansas
Soka	Sōka
Ruben Baraja	Rubén Baraja
Isabel	Isabel Princess Imperial of Brazil
Naoto Kan	Naoto Kan
Sepa Football Club	Saipa FC
Masri Sports Club	AlMasry SC
Carolyn	Caroline Princess of Hanover
NorthCalais	NordPasdeCalais
Ezel Weizmann	Ezer Weizman
Li Keqiang	Li Keqiang
Ochanomizu Station	Ochanomizu Station
Yau Tenghua	Edward Yau
Golden Eagle	Golden eagle
Dizzy Storm	Blackout
Juan Arango	Juan Arango
WatchOS	WatchOS
Chase	Chase
All Japan Air Transport	All Nippon Airways
Manchester	Manchester New Hampshire
George Darwin	George Darwin
Kazakh Soviet Socialist Republic	Kazakh Soviet Socialist Republic
Kurt Meyer	Kurt Meyer
Addison Baraga	Ademilson
Visual Basic	Visual Basic
The Headless Horseman Leaks DuRaRaRa	Durarara
Indiana University	Indiana University
Mumbai Football Club	Mumbai City FC
Jiaqingdi	Jiaqing Emperor
Republic of Buryatia	Buryatia
Game of Thrones	Game of Thrones
Ariel Lin	Ariel Lin
Baroness Frances da Sousa	Frances DSouza Baroness DSouza
Yokohama International Arena	International Stadium Yokohama
Wu Yufei	Kary Ng
true love while now	Love Now
city of gothenburg	Gothenburg Municipality
Lao Dai	Tai Tham alphabet
William Owen	William Irwin
Liu Zhijun	Liu Zhijun
Boeing717	Boeing 717
Love  Peace	Love  Peace
Socrates	Socrates
Christian Democrats	Christian Democrats
Emmanuel Adebayo	Emmanuel Adebayor
Zhang Chengxiang	Zhang Chengxiang
pope	Pope
ONE OK ROCK	One Ok Rock
Safavid	Safavid dynasty
Tonami City	Tonami Toyama
ShinOsaka Station	ShinŌsaka Station
Lars Bender	Lars Bender
Shogakukan	Shogakukan
Darius II	Darius II
Nice Olympic Gymnastics	OGC Nice
Columbia Films	Columbia Pictures
Juan Antonio Samaranch	Juan Antonio Samaranch
Diablo series	Diablo
Ossetian	Ossetian language
Ferdinand Schener	Ferdinand Schörner
Mitsuhiro Iwagi	Mitsuhide Iwaki
Eva Braun	Eva Braun
Carl Pearson	Karl Pearson
Naruto	Naruto
Nicole Keeman	Nicole Kidman
South India	South India
Paraguay Football League	Paraguayan Primera División
David Packard	David Packard
Heye	Hre people
Wanzhou Yangtze River Bridge	Wanxian Bridge
The Third Battle of Kharkiv	Third Battle of Kharkov
Blanko Crvenkowski	Branko Crvenkovski
Pius IX	Pope Pius IX
President of Singapore	President of Singapore
Sogdian alphabet	Sogdian alphabet
Thomas Graveson	Thomas Gravesen
Hu Chunhua	Hu Chunhua
Chandler Khalil Pasha	Çandarlı Halil Pasha the Younger
McCann Tumble	Malcolm Turnbull
Galicia	Galician language
Frank Murkowski	Frank Murkowski
zusu	Josué Anunciado de Oliveira
Old Persian	Old Persian
Georg Friedrich	Georg Friedrich Prince of Prussia
Cosmin Contra	Cosmin Contra
Xianning	Xianning
Zhuang Hansheng	Alan Johnson
John Whittingdale	John Whittingdale
Zhonghui	Zhong Hui
Su Jiaquan	Su Chiachyuan
Earl Page	Earle Page
Meizhou	Meizhou
SAKURA Sea of Cherry Blossoms and Mist	Sakura Hanagasumi
Guerrilla Football Club	FK Partizan
Helmut Schmidt	Helmut Schmidt
Metro Manila	Metro Manila
Nagai Kensuke	Kensuke Nagai
Galileo Galilei	Galileo Galilei
MySQL	MySQL
Peoples Unity	Popular Unity
Jay Bothroyd	Jay Bothroyd
Cmon	Cmon
jews	Jews
Robert Smith	Robert Smith
Fuchu City	Fuchū Tokyo
Fengtai County	Fengtai County
Albrecht	Albrecht Duke of Bavaria
Lionel Messi	Lionel Messi
A Song for ××	A Song for ××
French Navy	French Navy
Manchu	Manchu people
Wu Zhaoxie	Joseph Wu
Tel Aviv Sharpe Football Club	Hapoel Tel Aviv FC
The Third Crusade	Third Crusade
Big Huge Games	Big Huge Games
Maryborn	Marylebone
Suzuka	Suzuka Mie
Aleksey Nikolaevich Romanov	Alexei Nikolaevich Tsarevich of Russia
William Randolph Steele	William Randolph Steele
Ali Sastro Amizyoyo	Ali Sastroamidjojo
Zhang Junning	Janine Chang
Louis Mountbatten Earl of Mountbatten 1st Burmese	Louis Mountbatten 1st Earl Mountbatten of Burma
Peng Huainan	Perng Fainan
South America Libertadores Cup	Copa Libertadores
AJAX	AJax
New Caledonia	New Caledonia
My Generation Understand	My Generation Understand
Vasily Berezutsky	Vasili Berezutski
nigeria	Nigeria
Seth Harris	Seth Harris
National Great Hural	State Great Khural
Chen Jianzhou	Blackie Chen
pop	Pop music
PSV Yan Haofen	PSV Eindhoven
Fukui City	Fukui Fukui
Mochimilin Sports Club	Mogi Mirim Esporte Clube
Wang Qiang	Wang Qiang
Lim Dong Province	Lâm Đồng Province
Jules Bianchi	Jules Bianchi
Maze	Maze
syrian alphabet	Syriac alphabet
2011 Chinese Super League	2011 Chinese Super League
Werner Heisenberg	Werner Heisenberg
Johnny Banglan	Jonny Buckland
Walter Model	Walter Model
Gary Medel	Gary Medel
Prince Leopold	Prince Leopold Duke of Albany
Jenjay Morachevsky	Jędrzej Moraczewski
SNSD	Girls Generation
Got it3F	Got It3F
Cormack MurphyOConnor	Cormac MurphyOConnor
Kamehameha I	Kamehameha I
Robert Bird	Robert Byrd
Shikawa	Shibukawa Gunma
Tongzhi Emperor	Tongzhi Emperor
Wang Xi	Wong He
Paul von Hindenburg	Paul von Hindenburg
Super Avenue of Stars	One Million Star
National Stadium	Beijing National Stadium
City University of Hong Kong	City University of Hong Kong
Maori	Māori people
Charles Lyle	Charles Lyell
Rockstar Toronto	Rockstar Toronto
Wigan Athletic Football Club	Wigan Athletic FC
Gordon Sprigg	Gordon Sprigg
David Thornton	Davide Santon
Scottish Conservative Party	Scottish Conservative Party
Julius Caesar	Julius Caesar
Lotus Software	Lotus Software
President of South Africa	President of South Africa
Matthew Debig	Mathieu Debuchy
Astana Arena	Astana Arena
Billy Hughes	Billie Hughes
SaxonyAnhalt	SaxonyAnhalt
Gyeongsang dialect	Gyeongsang dialect
Tsai Ingwen	Tsai Ingwen
Klin Powell	Colin Powell
Slobodan Rajkovic	Slobodan Rajković
Dallas Mavericks	Dallas Mavericks
Agents of SHIELD	Agents of SHIELD
Karakoram	Karakoram
Poznan Lake Football Club	Lech Poznań
Oliver Bozanich	Oliver Bozanic
Douglas DC2	Douglas DC2
Xia Yu	Ha Yu
Taichung City	Taichung
Luo Yingxue	Luo Yingshay
Amir Sharifuddin	Amir Sjarifuddin
Ma Yun Madibi	Marvin Matip
Monaco Grand Prix	Monaco Grand Prix
Jansa Gowewani	Kriengsak Kovitvanit
Battle of Berlin	Battle of Berlin
Big Black General	Masashi Oguro
Anderson Varejao	Anderson Varejão
Tom Udall	Tom Udall
Auburn University	Auburn University
ouben	Auburn Alabama
Mazda Cosmo	Mazda Cosmo
crack	Hiatus
Paul III	Pope Paul III
Carrie Lam	Carrie Lam
Los Angeles County	Los Angeles County California
british columbia	British Columbia
Weekly Shonen Magazine	Weekly Shōnen Magazine
Semyon Konstantinovich Timoshenko	Semyon Timoshenko
blank	Tabula Rasa
Sophiane Figuly	Sofiane Feghouli
Zhu Xiaotian	Ken Chu
BMW 1Series	BMW 1 Series
Tadeusz Mazowiecki	Tadeusz Mazowiecki
Graham Alexander	Graham Alexander
Zaragoza	Zaragoza
Ramzan Kadyrov	Ramzan Kadyrov
Kyoto Station	Kyōto Station
Palestine Mandate	Mandatory Palestine
Army Distinguished Service Medal	Distinguished Service Medal
Lev Borisovich Kamenev	Lev Kamenev
Saul Campbell	Sol Campbell
Cambyses II	Cambyses II
Atsuko Maeda	Atsuko Maeda
Toncay Sanli	Tuncay Şanlı
Novak Djokovic	Novak Djokovic
Avitch	Avicii
Lin Zixiang	George Lam
Vasily Vasilyevich Kuznetsov	Vasili Kuznetsov
Transcaucasian Socialist Federal Soviet Republic	Transcaucasian Socialist Federative Soviet Republic
Two and a half heroes	Two and a Half Men
Hidero Hashimoto	Hideo Hashimoto
Oscar Luigi Scalfaro	Oscar Luigi Scalfaro
Vladimir Vladimirovich Putin	Vladimir Putin
Patrick McLoughlin	Patrick McLoughlin
Kevin Kuranyi	Kevin Kurányi
2008 Tropical Storm Arthur	Tropical Storm Arthur
Newcastle United Football Club	Newcastle United FC
Chineburg	ChêneBourg
South Sudan	South Sudan
Neposha Malian High	Nebojša Marinković
Diago Corran	Diego Forlán
Greater Community	Dashe District
Zheng Shaoqiu	Adam Cheng
Yang Gongru	Kristy Yang
Potomac River	Potomac River
Abe Akie	Akie Abe
Dave Mustaine	Dave Mustaine
Norman Mineta	Norman Mineta
Sukhbaatar Yanjima	Sükhbaataryn Yanjmaa
Jonathan Morse	Jonathan Moss
BrandenburgPrussia	BrandenburgPrussia
FBI Director	Director of the Federal Bureau of Investigation
Oliver Walcott Jr	Oliver Wolcott Jr
Aaron Ramsay	Aaron Ramsey
Camellia	Camellia
Little Dragon Girl	Xiaolongnü
Sekydianus	Sogdianus of Persia
bangalore	Bangalore
BEAST	Beast
SaintYiden Sports Club	AS SaintÉtienne
Charles Lieber	Charles M Lieber
University of Michigan	University of Michigan
Can We Go Back	Can We Go Back
Ishikawa Naohiro	Naohiro Ishikawa
Fearless Records	Fearless Records
AndersFrisk	Anders Frisk
Xinyibao Records	Cinepoly Records
Sikkim	Sikkimese language
Cesc Fabigas	Cesc Fàbregas
bogu	Bo Gu
Angel Di Maria	Ángel Di María
Azores	Azores
The Prime Minister of the Republic of Korea	Prime Minister of South Korea
199697 Euro 1997 Champions Cup	199697 UEFA Cup Winners Cup
Songchai Wangshawar	Somchai Wongsawat
Toyota Yangping	Yohei Toyoda
Eurostar	Eurostar
Rune Alphabet	Runes
Heinrich Himmler	Heinrich Himmler
SouthPyrenees	MidiPyrénées
Wangchuck Dynasty	House of Wangchuck
Mikhail Yefimovich Fradkov	Mikhail Fradkov
Wishing On The Same Star	Wishing on the Same Star
Limbu	Limbu language
Navarra	Navarre
Chen Yi	Chen Yi
Jackie Chan	Jackie Chan
Everyone is happy	Virtues of Harmony
Pope Leo III	Pope Leo III
MTV Video Music Awards	MTV Video Music Award
vidis	Vitesse Arnhem
AmericanJewish	American Jews
Christian Vieri	Christian Vieri
Simply Wonderful	Simply Wonderful
Goo Jaechul	Koo Jacheol
Pete Utaka	Peter Utaka
Queen Zhenchun	Queen Jeongsun
Prague University of Economics	University of Economics Prague
Zeng Peiyan	Zeng Peiyan
Joachim Murat	Joachim Murat
Rod Blagojevich	Rod Blagojevich
Shameless	Shameless
Mengxian Li	Ed Lee
Cayo Lara	Cayo Lara
Adu Ghani	Abdul Ghani Ahmad
Hong Kong Federation of Trade Unions	Hong Kong Federation of Trade Unions
Tainan	Tainan
Dara	Daraa Governorate
Celtic Football Club	Celtic FC
Haruhi Suzumiya series	Haruhi Suzumiya
Justice League Dark	Justice League Dark
Bengali	Bengali language
Khadgar Prasad Oli	Khadga Prasad Sharma Oli
Zhang Wuchang	Steven N S Cheung
Zheng Zhenyun	Jeong Jinwoon
Peoples Republic of Bulgaria	Peoples Republic of Bulgaria
Julian Draxler	Julian Draxler
Zulfikar Ali Bhutto	Zulfikar Ali Bhutto
esiha	Écija
Mimi CLUB	Kome Kome Club
National Assembly	National Council
Tao I	Senakhtenre Ahmose
Andrzej Duda	Andrzej Duda
Richard Blumenthal	Richard Blumenthal
Ryan Lynn	Lene Lai
Iduyadu Dashua	Eduardo da Silva
Cebu Province	Cebu
Hishammuddin Hussin	Hishammuddin Hussein
Yushu Tibetan Autonomous Prefecture	Yushu Tibetan Autonomous Prefecture
Nie Zhulong	Nhiek Tioulong
Chester Alan Arthur	Chester A Arthur
Dongchengwei	Dong Cheng Wei
John Simon 1st Viscount Simon	John Simon 1st Viscount Simon
Altai Republic	Altai Republic
The University of Hong Kong	University of Hong Kong
Nivkh	Nivkh people
Cantonese	Yue Chinese
Russian Army	Russian Ground Forces
Spring Offensive 1975	1975 Spring Offensive
Qin Hailu	Qin Hailu
Yasuhiro Nakasone	Yasuhiro Nakasone
Wan Azizah	Wan Azizah Wan Ismail
Little Bulgarian Sports Club	Boca Juniors
SHINee	Shinee
Georg	Georg Prince of SaxeMeiningen
F ♯	F Sharp
New England Revolution	New England Revolution
Tokugawa Yoshimune	Tokugawa Yoshimune
Mayor of New Taipei City	Mayor of New Taipei
Park Han Sung	Park Hanbyul
William Paley	William S Paley
Taiwan Railway Administration	Taiwan Railways Administration
BMW F30	BMW 3 Series
Hus Hiddink	Guus Hiddink
Dong Xuesheng	Dong Xuesheng
Western Yugur	Western Yugur language
Arthur Charles Clark	Arthur C Clarke
Dasin Chinawa	Thaksin Shinawatra
Richard Garcia	Richard Garcia
Niigata Swan	Albirex Niigata
George Macartney 1st Earl of Macartney	George Macartney 1st Earl Macartney
Kingdom of Sardinia	Kingdom of Sardinia
Magdalen College University of Oxford	Magdalen College Oxford
FUNKY TOWN	Funky Town
Patrice McMahon	Patrice de MacMahon Duke of Magenta
Chris Cornell	Chris Cornell
Gail Halder	Geir Haarde
Kikuyu	Kikuyu people
Kuwait Athletic Club	Kuwait SC
National Football Club	Club Nacional de Football
Wisla Krakow Football Club	Wisła Kraków
Taliban	Taliban
Nvidia Shield	Shield Portable
Pratt  Whitney PW4000	Pratt  Whitney PW4000
Pope Iqi	Pope Hyginus
Cantonese	Cantonese
Heart Storm	Heart of Greed
The Emperor of India	Emperor of India
Ahmed Taufik Pasha	Ahmet Tevfik Pasha
My Ruyi Wolf	Bottled Passion
Kanuri	Kanuri language
andalusia	Andalusia
Americas Next Top Model	Americas Next Top Model
Park Si Yeon	Park Siyeon
Renwu District	Renwu District
James Monroe	James Monroe
Nur Bekri	Nur Bekri
Leo IX	Pope Leo IX
Elite Team	SBV Excelsior
Communist Party of the Soviet Union	Communist Party of the Soviet Union
Steve McQueen	Steve McQueen
Okegawa	Okegawa Saitama
Fate Series	The Fast and the Furious
Kyohisa Shiozaki	Yasuhisa Shiozaki
Axis Powers	Axis powers
Dag Hammarskjöld	Dag Hammarskjöld
Barnett Football Club	Barnet FC
Windows 9x	Windows 9x
Taiwan Public Radio and Television Group	Taiwan Broadcasting System
Greek Football League	Football League
Tanigaki Zhenichi	Sadakazu Tanigaki
Daniel D Tompkins	Daniel D Tompkins
Lucky	Get Lucky
Amuse	Amuse Inc
Kyuhyun	Cho Kyuhyun
Zeng Wenhui	Tseng Wenhui
Prince Kenren Takaengiya	Norihito Prince Takamado
University of Exeter	University of Exeter
Ryuhei Maruyama	Ryuhei Maruyama
Jordan National Football Team	Jordan national football team
gospel music	Gospel music
Joffrey Borgia	Gioffre Borgia
Democritus	Democritus
Hu Ge	Hu Ge
Albania National Football Team	Albania national football team
Brahmaputra	Yarlung Tsangpo River
folk metal	Folk metal
Modern English	Early Modern English
Ultimate Mobilization Order Series	Command  Conquer
Zhang Yesui	Zhang Yesui
Fender Stratocaster	Fender Stratocaster
Joachim Loew	Joachim Löw
Luang Than Long Navasawa	Thawan Thamrongnawasawat
Yomiuri TV	Yomiuri Telecasting Corporation
Christian Ziger	Christian Ziege
OHiggins Sports Club	OHiggins FC
Prince Caspian	Prince Caspian
UK House of Lords	House of Lords
Erd	Odo of France
Cocoa	Cocoa
Qing Gaozong Ji Empress	Ulanara the Step Empress
Toda Kazuyuki	Kazuyuki Toda
Western College	Occidental College
Gera Zoltan	Zoltán Gera
CNN	CNN
Dongfeng Citroen Elysee	Citroën Elysée
BRAVIA	Bravia
Rangto	Genthod
Korsoi Viktor	Viktor Kassai
Yoshihide Suga	Yoshihide Suga
William Tecumseh Sherman	William Tecumseh Sherman
Stade Louis II	Stade Louis II
Danilo Turck	Danilo Türk
Fantastic Horses and Legends	The Horse and His Boy
Colombo	Colombo
Yang Hao	Yang Hao
Park Min Young	Park Minyoung
Journey to the West	Journey to the West
Satellite TV Chinese Channel	Star Chinese Channel
Leading V	Pope Celestine V
Minnesota Timberwolves	Minnesota Timberwolves
greenbrier	Green Rose
Robert Tevers	Robert Trivers
Max Born	Max Born
The Spitfire	Foo Fighters
New Zealand National Party	New Zealand National Party
Walt Disney Studios Movies	Walt Disney Studios Motion Pictures
Dome	PuydeDôme
Alaves Sports	Deportivo Alavés
Shan Liwen	Pal Sinn
China Video Main Frequency	CTS Main Channel
Muktar Ould Dadah	Moktar Ould Daddah
List of Byzantine Emperors	List of Byzantine emperors
Jin Wuxing	Kim Moosung
TriCities	TriCities Washington
Prime Minister of New Zealand	Prime Minister of New Zealand
Zhang Zuming	Jaycee Chan
Free Sham Islamic Movement	Ahrar ashSham
Etruscan Kingdom	Kingdom of Etruria
Nippori Station	Nippori Station
USA TV	USA Network
Yi branch	Loloish languages
Maatya Kežman	Mateja Kežman
Emirates Stadium	Emirates Stadium
Nam Tae Hee	Nam Taehee
Norodom Norindalana	Norodom Narindrapong
Nancy Reagan	Nancy Reagan
Asian Football Confederation	Asian Football Confederation
Takahashi is Qing	Takahashi Korekiyo
Ann Daniel	Ahn Daniel
Dongguanyi	Wang Guanyi
Zhu Xuan	Océane Zhu
Louise	Princess Louise of Orléans
Love for the Three Worlds	Always and Ever
Kim Campbell	Kim Campbell
Rewrite	Rewrite
qatar	Qatar
Pope Lide	Pope Evaristus
Sister	Apple in Your Eye
Dmitry Anatolyevich Medvedev	Dmitry Medvedev
Governor of Washington	List of Governors of Washington
Robbie Williams	Robbie Williams
Ladder	The Last Steep Ascent
Alexander Anyukov	Aleksandr Anyukov
Pemmeras Athletic Association	Sociedade Esportiva Palmeiras
garage rock	Garage rock
Las Palmas	Las Palmas
Like a star in the night	Like a Star in the Night
Wang Jie	Dave Wong
Portugal	Portugal
Mahatma Gandhi	Mahatma Gandhi
Casey Affleck	Casey Affleck
RedOne	RedOne
Two and a Half Heroes	Two and a Half Men
Komuro Guizi	Keiko
Pablo Sabaleda	Pablo Zabaleta
Turkish Football Association	Turkish Football Federation
San Jose Earthquakes	San Jose Earthquakes
Ray Magus	Rui Marques
Maximian	Maximian
JeanPaul Sartre	JeanPaul Sartre
Armenian	Armenians
HKT48	HKT48
Geng Biao	Geng Biao
OFK Belgrade	OFK Beograd
Dream Pigeon	Meng Ge
Luxembourg	Luxembourg
Spencer Compton 1st Earl of Wilmington	Spencer Compton 1st Earl of Wilmington
Wei Guoqing	Wei Guoqing
Mary	Marie of Romania
Pan Wenkai	Phan Văn Khải
Leopold III	Leopold III of Belgium
Herman Holt	Hermann Hoth
Omiya Station	Ōmiya Station
Venezuela Football League	Venezuelan Primera División
Eamon de Valera	Éamon de Valera
South China Football Team	South China AA
Thomas Schaff	Thomas Schaaf
Firefox OS	Firefox OS
Alexander Grothendieck	Alexander Grothendieck
England Football Association	The Football Association
Robert von Graeme	Robert Ritter von Greim
Gelderland	Gelderland
Housekeeper Mita	Kaseifu no Mita
Hussein bin Talal	Hussein of Jordan
Richard I	Richard I of England
Kei Uemura	Kei Uemura
Bioshock	BioShock
Mouth Organ	Melodica
Tulane University	Tulane University
Nagaland	Nagaland
BUT Proof of Love	But Aishō
Ichinomiya	Ichinomiya Aichi
RollsRoyce RB211	RollsRoyce RB211
Catholic University Athletics Club	Club Deportivo Universidad Católica
Ted Cruz	Ted Cruz
Ghost in the Shell 2 INNOCENCE	Ghost in the Shell 2
Tim BernersLee	Tim BernersLee
Meteor	Nagareboshi
Super popular female devil	The Fame Monster
Felipe Nasr	Felipe Nasr
Magnolia	Magnolia
Jin Zaizhong	Kim Jaejoong
Zhang Fakui	Zhang Fakui
Queen Zeta	Zita of BourbonParma
eat slave	Gilded Chopsticks
gervinho	Gervinho
President of the European Council	President of the European Council
Sebastian Giovinco	Sebastian Giovinco
Alawites	Alawites
Vicente del Bosque	Vicente del Bosque
Bundestag	Federal Assembly
China Central Television	China Central Television
Armen Sarkisian	Armen Sargsyan
lunarillo	Lunalilo
Wladyslaw IV	Władysław IV Vasa
Xia Weilin	William Hague
F22 Raptor	Lockheed Martin F22 Raptor
Huizhou	Huizhou
Bhojpuri	Bhojpuri language
201314 Hong Kong FA Cup	201314 Hong Kong FA Cup
Xi Jinping	Xi Jinping
Dai	Dai people
Ono Tomo	Satoshi Ohno
Persian	Persian language
Indonesian Premier League	Indonesia Super League
Pilsen Victory Football Club	FC Viktoria Plzeň
dallas	Dallas
madrid	Madrid
Yihara Station	Maibara Station
Fred Thompson	Fred Thompson
Mohammed bin Zayed Stadium	Mohammed Bin Zayed Stadium
Zhu Zhaoji	Chu Siu Kei
janice japlin	Janis Joplin
Thiago Mendes	Tiago Mendes
county listing	Gujō
Zhu Chenli	Rebecca Zhu
Wolfsburg Football Club	VfL Wolfsburg
Richard Pohl	Richard Burr
Chen Ziyao	Yoyo Chen
Bayannaoer	Bayannur
Isle of Wight	Isle of Wight
Daisuke Sakata	Daisuke Sakata
Alfredo Cristiani Burcard	Alfredo Cristiani
Tamil	Tamil language
Kim Jong nam	Kim Jongnam
Lawrence Wetherby	Lawrence Wetherby
Hugh Everett III	Hugh Everett III
Wonderboy	Fabolous
Chongqing	Chongqing
General Secretary of the Central Committee of the Communist Party of Vietnam	General Secretary of the Communist Party of Vietnam
Victoria Louise	Princess Victoria Louise of Prussia
Mutter	Mutter
Henry Kissinger	Henry Kissinger
Break It Get Myself Back	Break It Get Myself Back
Phoenix Satellite TV Information Channel	Phoenix InfoNews Channel
Kim Yongnam	Kim Yongnam
Fedora	Fedora
Muar	Muar
Takamoto Hui	Megumi Takamoto
Norman Ramsay	Norman Foster Ramsey Jr
V6	V6
DiVA	Diva
Ayaka Golden Songs Selection 20062009	Ayakas History 20062009
Alice Munro	Alice Munro
Yamase Koji	Koji Yamase
Ming Xuanzong	Xuande Emperor
Higashi Kurume City	Higashikurume Tokyo
Christopher Dugarry	Christophe Dugarry
Edward Witten	Edward Witten
Alistair Carmichael	Alistair Carmichael
grasshopper	Grasshopper
Sanli Metropolitan Station	SET Metro
Yaromir Blazek	Jaromír Blažek
Isido Rabbi	Isidor Isaac Rabi
ULTRA BLUE	Ultra Blue
Yamaguchi Firefly	Hotaru Yamaguchi
The Hebrew University of Jerusalem	Hebrew University of Jerusalem
MDNA	MDNA
Xiyuan Temple Gongwang	Saionji Kinmochi
do thats right	Do Somethin
Traveling	Traveling
Torsten Frings	Torsten Frings
Democratic Peoples Republic of Korea	North Korea
Superboy	NSYNC
Whitesnake	Whitesnake
ava	Inwa
Lee Jung Hyun	Lee Junghyun
List of Afghan monarchs	List of monarchs of Afghanistan
Fort DalyStepheno Domain	Dalibor Stevanović
Aberdeen Football Club	Aberdeen FC
Churlim Tatars	Chulyms
Electromagnetic Team Million Company	Denji Sentai Megaranger
Mozilla Thunderbird	Mozilla Thunderbird
Pedro Rodriguez Redsma	Pedro
Duff McKagan	Duff McKagan
Prince Carl Oscar Duke of Southmanland	Prince Carl Oscar Duke of Södermanland
Utah Administrative Divisions	List of counties in Utah
Guarani Football Club	Guarani FC
City College of New York	City College of New York
Nicklaus Wirth	Niklaus Wirth
Mamadou Shagao	Mamadou Sakho
Zheng Jiaying	Kevin Cheng
Paul Ferrana	Paulo Ferreira
John Milton	John Milton
Sea of the Moon	Luna Sea
Abhisit Wichachiwa	Abhisit Vejjajiva
Firefox	Firefox
Chapter 7 Its so beautiful Im sorry	Dai Nana Shō Utsukushikutte Gomen ne
Lena Watling	Leonor Watling
Leslie Cheung	Leslie Cheung
Shiding District	Shiding District
Argildas Brazoskas	Algirdas Brazauskas
Jiang Ruolin	Elanne Kong
Alonzo Church	Alonzo Church
Prince Sigwald	Sigvard Bernadotte
Amami Oshima	Amami Ōshima
LaurentDesiree Kabila	LaurentDésiré Kabila
William Faulkner	William Faulkner
carlisle	Carlisle Pennsylvania
David Alaba	David Alaba
William Lamb 2nd Viscount Melbourne	William Lamb 2nd Viscount Melbourne
Washington  DC	Washington DC
Maliwi Parliament	Marrickville Council
Cool Lazy Taste	Clazziquai
Xu Xinliang	Hsu Hsinliang
Shenyouji	IQue Player
This Is Love	This Is Love
Nenets	Nenets people
impetuous	Fuzao
Niccolò Machiavelli	Niccolò Machiavelli
Benevolence III	Healing Hands III
Kenji Ogiya	Kenji Ogiya
Martin Berdoff	Martin Petrov
Mitt Romney	Mitt Romney
Princess Maria Antonia	Princess Marie Antoinette of Schwarzburg
Toronto	Toronto
Friends	Friends
Star Wars Story	Rogue One
Li Haiquan	Lee Hoichuen
Hubert Humphrey	Hubert Humphrey
1st Division	1st Division
IPad	IPad
ARASHIC	Arashic
ObjectiveC	ObjectiveC
Dario Simic	Dario Šimić
Duangu Mijan ZainerAbidin	Mizan Zainal Abidin of Terengganu
Nirvana	Nirvana
Hassan Sarkar	Hasan Saka
University of Sheffield	University of Sheffield
Phoenician Alphabet	Phoenician alphabet
TMG	Tak Matsumoto Group
Vegatech Sendai	Vegalta Sendai
Sima Yi	Sima Yi
007 Battle Royale	Casino Royale
hamamatsu	Hamamatsu
William Bentinck 4th Duke of Portland	William Bentinck 4th Duke of Portland
County Wicklow	County Wicklow
Chuck Hagel	Chuck Hagel
Chilian Dempsey	Clint Dempsey
Xincai County	Xincai County
Gu Ling Jing Detective B	DIE Again
Liang Lifang	Tiffany Leong
harrisburg	Harrisburg Pennsylvania
Mitsubishi Fuso Canter	Mitsubishi Fuso Canter
Ohannes Sports Club	SC Olhanense
Huang Yanyan	Ng Yen Yen
northern ireland	Northern Ireland
Elkerson	Elkeson
Zhu Yuanzhang	Hongwu Emperor
Ganges	Ganges
Islamic Army	Jaysh alIslam
Yukon	Yukon
Hua Guofeng	Hua Guofeng
West Bromwich Albion Football Club	West Bromwich Albion FC
Avex trax	Avex Trax
Santali	Santali language
Wei Junan	John Reid Baron Reid of Cardowan
Gustav Heinemann	Gustav Heinemann
United States Supreme Court	Supreme Court of the United States
Bellisario Betancur Quartas	Belisario Betancur
Kassimjomart Tokayev	KassymJomart Tokayev
Titan 4 launch vehicle	Titan IV
University of Maryland College City	University of Maryland College Park
Echacella Sports and Culture Club	Al Jazira Club
Patty Murray	Patty Murray
Li Yunzhi	Lee Yoonji
Batman	Batman
John Barrio	John Balliol
Danslan Bilge Dawgsson	Dansranbilegiin Dogsom
Sima Zhao	Sima Zhao
LØVE Love Endless	Love
Musashino City	Musashino Tokyo
Italian	Italian language
Hugo de Pain	Hugues de Payens
Together When	Together When
Patrick Mueller	Patrick Müller
Sami	Sami people
Su30 Fighter	Sukhoi Su30
NintendoDSi	Nintendo DSi
Li Yingyuan	Lee Yingyuan
New Media Pte Ltd	Mediacorp
CrossBay Tunnel	Transbay Tube
Chinese Football Association Super League	Chinese Super League
Elbe	Elbe
William Astbury	William Astbury
Fenghua	Fenghua
EXID	EXID
DATE City	Date Fukushima
Kuroda Nagamasa	Kuroda Nagamasa
Pope Sistus II	Pope Sixtus II
Haji Pasha	Hacı Pasha
Gene Macun	Jean Makoun
full of wealth	Ariamaru Tomi
Carangtowell Hill	Carrauntoohil
Los Alamos	Los Alamos New Mexico
Love so sweet	Love So Sweet
Hussein Fahri Khalidi	Husayn alKhalidi
Phu Thou Province	Phú Thọ Province
Democratic Congress Party	Democratic Rally
Robert I	Robert I of France
Alex OxladeChamberlain	Alex OxladeChamberlain
Princess Iman Bint Hussein	Princess Iman bint Hussein
Okayama International Circuit	Okayama International Circuit
belize city	Belize City
Philippe Petain	Philippe Pétain
Xinyi Line	Xinyi Line
Law Kelly	R Kelly
Zhang Xueliang	Zhang Xueliang
Seya Ward	Seyaku Yokohama
Dmitri Fyodorovich Ustinov	Dmitriy Ustinov
Love neighbor distance	Love or Spend
Arkansas River	Arkansas River
SheHulk	SheHulk
Nokia Lumia 800	Nokia Lumia 800
Procopius Pavlopoulos	Prokopis Pavlopoulos
miami	Miami
Jiang Yihua	Jiang Yihuah
Growing of my heart	Growing of My Heart
Harrow Shapley	Harlow Shapley
Bourbons	House of Bourbon
Zhang Meng	Zhang Meng
University of Paris VII	Paris Diderot University
SinoJapanese War	First SinoJapanese War
Scottish Football Association	Scottish Football Association
Chinese Basketball Association	Chinese Basketball Association
Uji City	Uji Kyoto
Super JuniorKRY	Super JuniorKRY
Non Chea	Nuon Chea
soft and hard Tianshi	Softhard
Artur SethInquart	Arthur SeyssInquart
Stephanie	Stephanie
David Trezeguet	David Trezeguet
Marco Divoyo	Marco Di Vaio
William I	William the Silent
Zhou Libo	Zhou Libo
Erwin Schrödinger	Erwin Schrödinger
Francisco de Paula Rodriguez Alves	Francisco de Paula Rodrigues Alves
Wen Yali	Alexandra Countess of Frederiksborg
Wu Zhuoxi	Ron Ng
Valtari	Valtari
Julian Schwinger	Julian Schwinger
Order of St Michael and St George	Order of St Michael and St George
STS46	STS46
Linnie Strong Sports Club	Lillestrøm SK
Tsai Chin	Tsai Chin
Japan Baseball Organization	Nippon Professional Baseball
Virginity	Virginity
Green Township	Green Township Adams County Ohio
love	Shinai
Theodor Hensch	Theodor W Hänsch
Peter Griffin	Peter Griffin
Leopold	Leopold Prince of Hohenzollern
Ministry of Health and Welfare of the Republic of China	Ministry of Health and Welfare
Besiktas Gymnastics Club	Beşiktaş JK
Sen Hokies	Sam Vokes
Kimi Raikkonen	Kimi Räikkönen
Denmark	Denmark
Belarus	Belarus
John Boehner	John Boehner
Angola Air Force	National Air Force of Angola
Chen Hao	Moses Chan
Boys Meet U	Boys Meet U
Uli Hoeness	Uli Hoeneß
Weblin	Pontus Wernbloom
Arthur Kornberg	Arthur Kornberg
Franz I	Francis I Holy Roman Emperor
GLib	GLib
Hong Kong First Division Football League	Hong Kong First Division League
Masuda Oath	Chikashi Masuda
Microsoft Lumia	Microsoft Lumia
Chen Yongkang	Chen Yeongkang
Android Pay	Android Pay
Isa City Government	City of Mount Isa
Tiger Fish Group	Team Syachihoko
Lu Wei	Lu Wei
Annie	Anne Queen of Great Britain
David Lloyd George	David Lloyd George
Johannes Blaskowitz	Johannes Blaskowitz
Misael Pastrana Borrero	Misael Pastrana Borrero
Here Comes the Sun	Here Comes the Sun
Truman Capote	Truman Capote
New Zealand Labour Party	New Zealand Labour Party
James Beatty	James Beattie
Joseph Estrada	Joseph Estrada
Li Mingguo	Ri Myongguk
William IV	William IV Prince of Orange
Radoslav Kovacs	Radoslav Kováč
Jesper Christiansen	Jesper Christiansen
Destiny Tour	Destiny World Tour
White River	White River
Robert Pires	Robert Pirès
Malay Islands	Malay Archipelago
Medieval Japanese	Late Middle Japanese
Jurgen Kramney	Jürgen Kramny
Gao Xiaosong	Gao Xiaosong
Alan Martin	Alan Martin
Life and death series	Dead or Alive
Su Rong	Su Rong
Lighting Entertainment	Illumination Entertainment
Rochdale Football Club	Rochdale AFC
Cao Yu	Cao Yu
Jossi Benayoun	Yossi Benayoun
Yuan Jing	Hara Takashi
Hagi	Hagi Yamaguchi
Crissium Athletic Club	Criciúma Esporte Clube
PlayStation Portable	PlayStation Portable
Ninfu Squadron Breaker	Ninpuu Sentai Hurricaneger
Old Lisu	Fraser alphabet
Gold Coast United Football Club	Gold Coast United FC
Francisco Flores	Francisco Flores Pérez
MrChildren	Mr Children
Royal Zaragoza	Real Zaragoza
Grannette Zhaka	Granit Xhaka
Burhandin Harrahap	Burhanuddin Harahap
GREEN	Green
Slough	Slough
Democratic Party of Slovenia	Slovenian Democratic Party
Wen Lan	Landy Wen
Giuseppe Favalli	Giuseppe Favalli
Belgian Football Association	Royal Belgian Football Association
Ainu	Ainu people
James Abram Garfield	James A Garfield
Guangzhou Baiyun International Airport	Guangzhou Baiyun International Airport
John Heitinga	John Heitinga
Shizuoka Prefecture	Shizuoka Prefecture
North Korea Football League	DPR Korea League
Kuwana City	Kuwana Mie
Not yet	Not Yet
Frank W Mondial	Franklin Wheeler Mondell
Mikhail Saakashvili	Mikheil Saakashvili
Chancellor of the Exchequer	Chancellor of the Exchequer
TABOO	Taboo
Ichihara	Ichihara Chiba
Vice President Executive Yuan	List of vice premiers of the Republic of China
Daman language	Tamangic languages
Malaysian Chinese	Malaysian Mandarin
Jiang Ning	Jiang Ning
Song Meiling	Soong Meiling
Duns Scott	Duns Scotus
Kenneth Hall	Kenneth O Hall
Chen Delin	Norman Chan
Roll over Egg Fried Rice	Rolling Love
Kurdistan Province	Kurdistan Province
Zhanyu	Cham language
Queen Yangmin	Empress Xiao
James Clark Maxwell	James Clerk Maxwell
The German November Revolution	German Revolution of 191819
North Frisian	North Frisian language
Ludwig Boltzmann	Ludwig Boltzmann
JScriptNET	JScriptNET
Eric Lechaji	Eric Lichaj
Kenneth Kaunda	Kenneth Kaunda
Hermes Rodriguez da Fonseca	Hermes da Fonseca
Nokia Lumia 530	Nokia Lumia 530
⊿	Triangle
everywhere	Overexposed
Emile Lahoud	Émile Lahoud
Tom Ford	Tom Ford
KC135 aerial tanker	Boeing KC135 Stratotanker
Mississippi	Mississippi
Alexander III	Pope Alexander III
Cai Chuchuan	Cai Chuchuan
Goban Guyabanlov	Gurban Gurbanov
SinoTibetan Language Department	SinoTibetan languages
Roque Junior	Roque Júnior
Aleksey Berezutsky	Aleksei Berezutski
LOVE 2000	Love 2000
George Stoneman	George Stoneman
Akiko Taniguchi	Shogo Taniguchi
Maebashi City	Maebashi
Staffordshire	Staffordshire
Yokoyama Yui	Yui Yokoyama
Andy Lau	Andy Lau
United Airlines	United Airlines
Dorgon	Dorgon
ALGOL 68	ALGOL 68
Nizu Martin	Nigel Martyn
The Borgia Family	House of Borgia
Andrei Antonovich Grechko	Andrei Grechko
Sui Dynasty	Sui dynasty
Murray Rothbard	Murray Rothbard
HBO	HBO
North Week	Northern Zhou
US Virgin Islands	United States Virgin Islands
University of Glasgow	University of Glasgow
Zheng Yaotang	Cheng Yiutong
MIUI	MIUI
Bishkek	Bishkek
Serapan Nathan	S R Nathan
ABBA	ABBA
Independent Athletic Club	Club Atlético Independiente
Josip Delmic	Josip Drmić
Quang Binh Province	Quảng Bình Province
20142015 Europa League	201415 UEFA Europa League
Philippines National Football Team	Philippines national football team
beaver	Beaver
Wan Qiwen	Joey Meng
Matsumoto	Matsumoto Nagano
Nguyen Van Nhan	Pierre Nguyễn Văn Nhơn
Bao Dadi	Bảo Đại
Kemu	Khmu people
Lu Taiyu	Roh Taewoo
Muammar Gaddafi	Muammar Gaddafi
Oda Nobunaga	Oda Nobunaga
Hadi Awang	Abdul Hadi Awang
Almeria Sports Federation	UD Almería
Luo Wenjia	Luo Wenjia
LOVE Destiny	Love
Qingwu Hongsi	Hiroshi Kiyotake
Changhua County	Changhua County
Bozhou	Bozhou
Ledley King	Ledley King
Minardi Team	Minardi
Piplan Day	Puplinge
New York Red Bull	New York Red Bulls
Kataro	Katsura Tarō
Li Zaicheng	Lee Jaesung
University of Texas at Austin	University of Texas at Austin
Najd and Hassa Emirate	Emirate of Nejd and Hasa
Neil DeGrasse Tyson	Neil deGrasse Tyson
LollipopF	Lollipop F
Luigi Inodi	Luigi Einaudi
Heraclius Dynasty	Byzantine Empire under the Heraclian dynasty
Keeper	Storm in a Cocoon
Koichi Domoto	Koichi Domoto
Fly high	Fly High
Wu Lei	Wu Lei
Emile Borrell	Émile Borel
Google	Google
Kiss me I love you	Kiss Me Aishiteru
Yodo Hijacking Incident	Japan Airlines Flight 351
LouisFerdinand Selina	LouisFerdinand Céline
George Canning	George Canning
Charles Scott Sherrington	Charles Scott Sherrington
Lech Walesa	Lech Wałęsa
Bernard Mandeville	Bernard Mandeville
Francis of Assisi	Francis of Assisi
Chad language family	Chadic languages
Kim Jongun	Kim Jongun
Kai Dialect	Kajkavian
Mozambique	Mozambique
Ludwig Wittgenstein	Ludwig Wittgenstein
Robot	Robot
Nicolas Anelka	Nicolas Anelka
West India	Western India
Slovenia National Football Team	Slovenia national football team
Nanaicho	Nanae Hokkaido
Wang Shangyuan	Wang Shangyuan
France Womens National Football Team	France womens national football team
Hong Qigong	Hong Qigong
Li Ao	Li Ao
Taiwan Television Corporation	Taiwan Television
MoonHoly College	Mount Holyoke College
Kenneth Wilson	Kenneth G Wilson
Jordan Rhodes	Jordan Rhodes
Nathan	Matthew Nathan
Sigismund III	Sigismund III Vasa
Ranasingha Premadasa	Ranasinghe Premadasa
Damshui Line	Tamsui Line
1982  83 European Cup Champions Cup	198283 European Cup Winners Cup
Makoto Hasebe	Makoto Hasebe
Jose Bernardo de Tagle	José Bernardo de Tagle y Portocarrero Marquis of Torre Tagle
Azerbaijan Football Premier League	Azerbaijan Premier League
Weimar Republic	Weimar Republic
Ming Xizong	Tianqi Emperor
Jiangsu Province	Jiangsu
Korean Air	Korean Air
PEACH HEART	Peach Heart
Sami Hypia	Sami Hyypiä
Scotland Under21 Football Team	Scotland national under21 football team
Mnet Media	CJ EM Music Performance Division
An Zhijie	Andy On
Kitchenah	Kitchener Ontario
Mariner 10	Mariner 10
Orlando City Football Club	Orlando City SC
198384 UEFA Champions League	198384 European Cup
Neville Chamberlain	Neville Chamberlain
Knights Templar	Knights Templar
Covenant	The Journey
Todor Zhivkov	Todor Zhivkov
Burwood Council	Municipality of Burwood
Sodirios Cagia Gauss	Sotirios Kyrgiakos
Paul Digoff	Paul Dickov
Alfonso	Infante Alfonso Duke of Calabria
George McGovern	George McGovern
President of Tunisia	President of Tunisia
Hangul	Hangul
Child of Death	Children of Bodom
Musha Shisugao	Moussa Sissoko
Las Palmas Athletic Union	UD Las Palmas
Hu Jintao	Hu Jintao
Joe Hart	Joe Hart
Frederick Hopkins	Frederick Gowland Hopkins
Sui Yangdi	Emperor Yang of Sui
Wolf in the Night	Underworld
Li Huiqiong	Starry Lee
Phoenix Sky Harbor International Airport	Phoenix Sky Harbor International Airport
Okaya City	Okaya Nagano
Sherlock	Sherlock
Huainan	Huainan
Taiwanese	Taiwanese people
Leon Mba	Léon Mba
Taipei Track and Field	Taipei Municipal Stadium
Jérôme Rotten	Jérôme Rothen
Patrick Kluivert	Patrick Kluivert
Flevoland	Flevoland
Gerhard Schroeder	Gerhard Schröder
HesseDarmstadt	Grand Duchy of Hesse
NBA Live series	NBA Live
Skeleton	Skeleton
Viratko Glodanoski	Vlatko Grozdanoski
King Sayawady	Tharrawaddy Min
Mini DisplayPort	Mini DisplayPort
Low German	Low German
BEST first things	Best
Goias Sports	Goiás Esporte Clube
Harvard University	Harvard University
Tim Kerry	Tim Curry
zhuozhuo	Gerard Ambassa Guy
Kitasenju Station	KitaSenju Station
Ranma½	Ranma ½
Hungarian	Hungarian language
University of Colorado Boulder	University of Colorado Boulder
Xu Wen	Xu Wen
colorado rapids	Colorado Rapids
Italian Professional Football League	Lega Pro
Indiana Pacers	Indiana Pacers
James Dewey Watson	James Watson
Meizhou Meixian District Hakka Football Club	Meixian Hakka FC
United Kingdom of Saudi Arabia	Unification of Saudi Arabia
Kelly Cuoco	Kaley Cuoco
Janes Fairmont	Janice Filmon
Taihu	Lake Tai
Hiroyuki Hosoda	Hiroyuki Hosoda
Choo Ja Hyun	Choo Jahyun
North Central American and Caribbean League Champions Cup	CONCACAF Champions League
Golda Meir	Golda Meir
Luton	Luton
Jim Morrison	Jim Morrison
Vince McMahan	Vince McMahon
Reise Reise	Reise Reise
Raymond Domenech	Raymond Domenech
Banton Hammel	Brendan Hamill
Peter	Saint Peter
Xinshadong Tiger	Shinsadong Tiger
Wei Jianxing	Wei Jianxing
Milard Fillmore	Millard Fillmore
Muhyiddin	Muhyiddin Yassin
adult	Adult
Paul Krugman	Paul Krugman
Hanyang University	Hanyang University
Bannan Line	Taipei Metro Line 5
Beijing	Beijing
Sony Music Entertainment	Sony Music Entertainment
Fukui Prefecture	Fukui Prefecture
Boeing 377	Boeing 377 Stratocruiser
Albacete Football Club	Albacete Balompié
JohnLennon Plastic Ono	John Lennon Plastic Ono Band
John Stewart 3rd Earl of Butte	John Stuart 3rd Earl of Bute
Frank Capra	Frank Capra
Adair Janos	János Áder
AZ	AZ Alkmaar
Johannes Peter Muller	Johannes Peter Müller
Its all Love	Its All Love
Royal Standard Rich	Standard Liège
Fuzhou dialect	Fuzhou dialect
Moon Hee Jun	Moon Heejoon
Li Xiaolu	Li Xiaolu
Taizhou	Taizhou Zhejiang
Beverly McLachlin	Beverley McLachlin
Thomas Hardy	Thomas Hardy
Kenneth Joseph Arrow	Kenneth Arrow
Valekano Lightning	Rayo Vallecano
Zhenjiang	Zhenjiang
George IV	George IV of the United Kingdom
Socket 939	Socket 939
ItalianAmerican	Italian Americans
Uemi City	Ageo Saitama
true self	Sunao na Mama
Max Perutz	Max Perutz
Anjo	Anjō
Nikola Ivanovich Vavilov	Nikolai Vavilov
Ptolemy XII	Ptolemy XII Auletes
George Walker Bush	George W Bush
Tokugawa	Tokugawa clan
Chen Kexin	Peter Chan
Qiu Zhengxiong	Paul Chiu
McFly	McFly
Ivan Stepanovich Konev	Ivan Konev
Jiuquan Satellite Launch Center	Jiuquan Satellite Launch Center
your poison	Toxic
GCC	GNU Compiler Collection
Empress Dowager Zhaoxian	Empress Shōken
Pythagoras	Pythagoras
François Barouin	François Baroin
Surface Pro	Surface Pro
Chen Boliang	Chen Poliang
CounterStrike	CounterStrike
Pedro Arexo	Pedro Aleixo
loaded with lover	Rear Mirror
Constantin Karamanlis	Konstantinos Karamanlis
Rudy Worrall	Rudi Völler
st albans	City of St Albans
Prime Minister of Japan	Prime Minister of Japan
Nishikido Ryo	Ryo Nishikido
Oculus VR	Oculus VR
Michigan	Michigan
Shuhan	Shu Han
Croydonshire Government	Shire of Croydon
Radcliffe College	Radcliffe College
Chen Huishan	Flora Chan
NET 5	NET 5
Hejian Dimer	Volkan Demirel
What kind of love is this YOU KNOW3F	Nanchū Koi o Yatterū You Know3F
Drogheda	Drogheda
Yang Kang	Yang Kang
MY LONELY TOWN	My Lonely Town
trabzonsport	Trabzonspor
Antonio Nocerino	Antonio Nocerino
James Guthrie	James Guthrie
NASA	NASA
Kihara Kijuro	Kijūrō Shidehara
OHare International Airport	OHare International Airport
Gu Weijun	Wellington Koo
gansu province	Gansu
Welsh	Welsh language
Cadizia Sports	Qadsia SC
Lott M Morrill	Lot M Morrill
Patricia Arquette	Patricia Arquette
On Call 36 hours II	The Hippocratic Crush ll
Li Lanqing	Li Lanqing
Liamina Zerouale	Liamine Zéroual
Martin Brian Mulroney	Brian Mulroney
Sugiyama Yuan	Hajime Sugiyama
Baruch Spinoza	Baruch Spinoza
Sony Xperia ZR	Sony Xperia ZR
Italian Serie B	Serie B
Game Boy Color	Game Boy Color
Akadian	Akkadian language
MazdaRX8	Mazda RX8
Milan Zuyunnu Domain	Milan Jovanović
Dannyson Cordoba	Danilson Córdoba
Sakura blooms in sweet and sour spring	Amazuppai Haru ni Sakura Saku
AFC Champions League	AFC Champions League
Paris School of Business Studies	HEC Paris
The Dragon Series	Yakuza
Spanish Provinces	Provinces of Spain
Broadwell Microarchitecture	Broadwell
Sami	Sami languages
Livonian Crusaders	Livonian Crusade
CRY NO MORE	Cry No More
José Kleberson	José Kléberson
Black wood is frame	Kuroki Tamemoto
Will Charn	Will Champion
Pope Pascal II	Pope Paschal II
Xi Zhongxun	Xi Zhongxun
New England Association of Schools and Colleges	New England Association of Schools and Colleges
ALGOL W	ALGOL W
Kazakh Premier League	Kazakhstan Premier League
Jigme Kesar Namgyel Wangchuck	Jigme Khesar Namgyel Wangchuck
Lao Cai Province	Lào Cai Province
Kyla Diogo Dio	Kara DioGuardi
Financial Secretary of the Hong Kong Special Administrative Region	Financial Secretary
Wendi Deng	Wendi Deng Murdoch
List of Permanent Representatives of the United States to the United Nations	United States Ambassador to the United Nations
Chen Wei	Alice Chan
Bernadotte Dynasty	House of Bernadotte
Constantine the Great	Constantine the Great
Hong Yingzao	Hong Yongjo
Big Ten	Big Ten Conference
FriendFeed	FriendFeed
Hurricane Gonzalo	Hurricane Gonzalo
Fred Vinson	Fred M Vinson
Urawa Red Diamonds	Urawa Red Diamonds
Qingdao Huanghai Football Club	Qingdao Huanghai FC
sevilla	Seville
SaxonyMeiningen	Duchy of SaxeMeiningen
Joseon Youngjo	Yeongjo of Joseon
Hong Kong Baptist University	Hong Kong Baptist University
Xiangfei	Consort Xiang
BMO Stadium	BMO Field
Polandia Football Competition	Botafogo de Futebol e Regatas
The Church of Denmark	Church of Denmark
Kemal Quirida Oulu	Kemal Kılıçdaroğlu
HUNTER×HUNTER	Hunter × Hunter
Ovid	Ovid
Villa Park	Villa Park
Kobayashi Yuki	Yuki Kobayashi
Nicky Romilo	Nicky Romero
Mito City	Mito Ibaraki
Tan Hai	Tan Hai
East Sussex	East Sussex
Chen Jianbin	Chen Jianbin
Sanchez Watt	Sanchez Watt
Victor Borisovich Khristenko	Viktor Khristenko
Shaanxi Province	Shaanxi
Rian Shechen	Leon Jessen
Tianjin Jingtie Locomotive Football Club	Jingtie Locomotive FC
University of North Carolina at Chapel Hill	University of North Carolina at Chapel Hill
Duas Football Club	Tours FC
Giovanni Leona	Giovanni Leone
Yuri Mikhailovich Luzhkov	Yury Luzhkov
Zoran Tosic	Zoran Tošić
Anos Fogg Rasmussen	Anders Fogh Rasmussen
Arthur Cecil Pigou	Arthur Cecil Pigou
Juan Carlos Belleron	Juan Carlos Valerón
Corcier	Corsier
George RR Martin	George R R Martin
ALL FOR YOU	All for You
Harald Schumacher	Harald Schumacher
Shlash	Slash
Vanosa Katane	Vannozza dei Cattanei
Germany National Under21 Football Team	Germany national under21 football team
bristol	Bristol
Dutch East Indies	Dutch East Indies
Haider Abadi	Haider alAbadi
Karl I	Charles I of Austria
Ahmed Oyahia	Ahmed Ouyahia
Greece	Greece
Emile Constantinesco	Emil Constantinescu
The Voice of Fame	Decadent Sound of Faye
Mehdi Goli Hidayat	Mehdi Qoli Hedayat
Olympic Lyon	Olympique Lyonnais
Matt McKay	Matt McKay
Mark Milley	Mark A Milley
Helsinki Olympic Stadium	Helsinki Olympic Stadium
Wanli	Wan Li
Pope Simplicius	Pope Simplicius
Lily Allen	Lily Allen
Harold McMillan	Harold Macmillan
guiltcrown	Guilty Crown
Makoto Tanaka	Makoto Tanaka
Charles Grey 2nd Earl Grey	Charles Grey 2nd Earl Grey
Xu Yihong	Anthony Zee
The Big Bang Theory	The Big Bang Theory
Montpellier Sports	Montpellier HSC
Jetconnect	Jetconnect
Ernst August I	Ernest Augustus I of Hanover
Seto City	Seto Aichi
Romanian Orthodox Church	Romanian Orthodox Church
RKC Huayike	RKC Waalwijk
Hanjiatuo Yangtze River Bridge	Hanjiatuo Yangtze River Bridge
slovakia	Slovakia
Joel Griffith	Joel Griffiths
Feidong County	Feidong County
Xiao Yang	Xiao Yang
Malcolm III	Malcolm III of Scotland
SH3 Sea King Helicopter	Sikorsky SH3 Sea King
US CENTCOM	United States Central Command
Sad Britney	From the Bottom of My Broken Heart
Prince Constantine	Prince Constantijn of the Netherlands
Injustice	Looking Back in Anger
Robert Kunz	Robert Coontz
Juan Gutierrez Moreno	Juanito
Prince Victoria	Victoria Crown Princess of Sweden
Ian Rush	Ian Rush
Sichuan dialect	Sichuanese Mandarin
Frank ABarrett	Frank A Barrett
Catherine of Aragon	Catherine of Aragon
burundi	Burundi
Nicholas Zozenson	Nicolai Jørgensen
Johnny Marr	Johnny Marr
Richard von Mises	Richard von Mises
Rafiq Charliege	Rafik Halliche
somali	Somalis
Yokohama City	Yokohama
The Great Eunuch	The Confidant
Thomas Huberkan	Tomáš Hubočan
Guns and Roses	Guns N Roses
Penn State University	Pennsylvania State University
Qing Dynasty	Qing dynasty
madhya	Madhya Pradesh
Scottish Football League	Scottish Football League First Division
The Kingdom of the Two Sicilies	Kingdom of the Two Sicilies
Enomoto Takeyo	Enomoto Takeaki
Wesley Sneijder	Wesley Sneijder
Kuragi Mai	Mai Kuraki
Chrysanthemum	Chrysanthemum
North Ward	Kita Tokyo
Ramasin Osjan	Ramazan Özcan
Meg Griffin	Meg Griffin
Li Zhilong	Li Zhilang
Socialist Peoples Republic of Albania	Peoples Socialist Republic of Albania
Leslie Lamport	Leslie Lamport
Jopp Denuer	Joop den Uyl
Gigi Lai	Gigi Lai
Sweden National Football Team	Sweden national football team
Norob Altankhuyag	Norovyn Altankhuyag
landau	Lev Landau
Milian Madkovic	Miljan Mrdaković
China National Olympic Football Team	China national under23 football team
metal band	Metallica
Ichiro Ozawa	Ichirō Ozawa
Heilongjiang	Heilongjiang
Emma Goldman	Emma Goldman
Wusau Duura	Vossug ed Dowleh
Roger Wick	Roger Wicker
Ireland National Football Team	Republic of Ireland national football team
Hakata language	Bodo language
StarCraft	StarCraft
Hungarian National Football Team	Hungary national football team
Thomas Henry Huxley	Thomas Henry Huxley
Rishi Kapoor	Rishi Kapoor
Romanov Dynasty	House of Romanov
Wuhan Zall Professional Football Club	Wuhan Zall FC
Red Star Awards 2000	Star Awards 2000
Lon Nol	Lon Nol
Brad Paisley	Brad Paisley
wisconsin	Wisconsin
Guard Division	Imperial Guard
VH1	VH1
Roger Adams	Roger Adams
Federico Maceda	Federico Macheda
Phoenix TV Hong Kong	Phoenix Hong Kong Channel
Whose stove is smokeless	Be Home for Dinner
Shah Alam II	Shah Alam II
Miyagi Prefecture	Miyagi Prefecture
Akiko Fujiwara	Empress Shōshi
Ministry of Health of the Peoples Republic of China	Ministry of Health of the Peoples Republic of China
Republic of Crimea	Republic of Crimea
Andrei Andreevich Gromyko	Andrei Gromyko
Spanish Football League	Segunda División
knotpointlie love	Til Love Do Us Lie
Nokia Lumia 1520	Nokia Lumia 1520
Diga Stroup	De Graafschap
Spitzer Space Telescope	Spitzer Space Telescope
Mikhail Sergeyevich Solometsev	Mikhail Solomentsev
BBC Congress	BBC Parliament
Resa Khan	Reza Shah
Swindon Football Club	Swindon Town FC
Zhangjiakou	Zhangjiakou
Trinity College Cambridge	Trinity College Cambridge
Diago Costa	Diego Costa
Mike D Angelo	Golf  Mike
Yotani Station	Yotsuya Station
Charlie Pace	Charlie Pace
highprofile	Anticipating
Alfred Domet	Alfred Domett
Zhang Yaokun	Zhang Yaokun
Bruce Golding	Bruce Golding
Mohammad Shidan	Mohamed Zidan
Communist Party of Cambodia	Communist Party of Kampuchea
Australian House of Representatives	Australian House of Representatives
Red Star Belgrade	Red Star Belgrade
Wycombe Rangers Football Club	Wycombe Wanderers FC
Kyung Hee University	Kyung Hee University
Caesar ARodney	Caesar Augustus Rodney
Qijishi	Michael David Irving Gass
Tom Capo	Tom Carper
Nagasaki Prefecture	Nagasaki Prefecture
springfield	Springfield Illinois
Dennis Rodman	Dennis Rodman
Central Japan Broadcasting	ChubuNippon Broadcasting
Kasugai City	Kasugai Aichi
Country Girls	Country Musume
University of Calcutta	University of Calcutta
Edward the Black Prince	Edward the Black Prince
Aleut	Aleut
Marco Miso	Marco Maciel
Zhaoqing	Zhaoqing
Leonhard Euler	Leonhard Euler
Dutch League Two	Eerste Divisie
Jerm Friedman	Jerome Isaac Friedman
Toronto Blue Jays	Toronto Blue Jays
