BBC Radio 1	BBC One
Haarlem Tennyson 2nd Baron Tennyson	Hallam Tennyson 2nd Baron Tennyson
George Papandreou	George Papandreou
Chinese Taipei Womens National Football Team	Chinese Taipei womens national football team
Ruhr Stadium	Ruhrstadion
Outbound Love	Outbound Love
National Cheng Kung University	National Cheng Kung University
Ministry of Culture of the Peoples Republic of China	Ministry of Culture of the Peoples Republic of China
John Acherley Dew	John Dew
Adachi Tokyo	Adachi Tokyo
Ibán Cuadrado	Ibán Cuadrado
Pauletta	Pauleta
Surface Pro 2	Surface Pro 2
Robert Tevers	Robert Trivers
Iwate	Iwate Prefecture
Herman van Rompuy	Herman Van Rompuy
Sony Animation	Sony Pictures Animation
Chris Weitz	Chris Weitz
MALICE MIZER	Malice Mizer
Fraser alphabet	Fraser alphabet
Shenzhou 6	Shenzhou 6
Kwak Taehwi	Kwak Taehwi
IPhone 5s	IPhone 5S
STAR	Star
Jack W Szostak	Jack W Szostak
Kuniaki Koiso	Kuniaki Koiso
Kyōiku	Kyōiku
Daisuke Sakata	Daisuke Sakata
Salar language	Salar language
Tomo Hemed	Tomer Hemed
County Durham	County Durham
Egirls	Egirls
Hebei	Hebei
Kunitachi	Kunitachi Tokyo
Indonesian	Indonesian language
Ichibu to ZenbuDive	Dive
President of the European Council	President of the European Council
Golden Gale	Gold Typhoon
Grand Duke Guillaume	Guillaume Hereditary Grand Duke of Luxembourg
IPad Pro	IPad Pro
Lee Taemin	Lee Taemin
Branko Ilić	Branko Ilić
Aramaic	Aramaic alphabet
Donnie Yen	Donnie Yen
Okayama Prefecture	Okayama Prefecture
Prince Takahito Mikasa	Takahito Prince Mikasa
Nikola Petkovic	Nikola Petković
Michael Marrone	Michael Marrone
Jermaine Beckford	Jermaine Beckford
McLaren Automotive	McLaren Automotive
Chakra	Chakra
Duncan Edward Odgerton	Duncan Oughton
Wang Liang	Wang Liang
Monaco Athletic Association Football Club	AS Monaco FC
Kawasakiku	Kawasakiku Kawasaki
Vladimir Kirillovich	Grand Duke Vladimir Kirillovich of Russia
Li Keqiang	Li Keqiang
SaintMartin	Collectivity of Saint Martin
Maxi Rodríguez	Maxi Rodríguez
2012 Summer Olympics Mens 400m Freestyle	Swimming at the 2012 Summer Olympics  Mens 400 metre freestyle
Zlatan Ibrahimovic	Zlatan Ibrahimović
Communist Party of Cuba	Communist Party of Cuba
University of Freiburg	University of Freiburg
Kara Wai	Kara Hui
Haha	Haha
Henry Brockholst Livingston	Henry Brockholst Livingston
Grand Duchess Alexandra Nikolaevna	Grand Duchess Alexandra Nikolaevna of Russia
Biljilio Barco Vargas	Virgilio Barco Vargas
San Jose State University	San Jose State University
Wallalunga Football Club	Vålerenga Fotball
Litex Football Club	PFC Litex Lovech
Cinemax	Cinemax
Nanjing University	Nanjing University
Pallava Grantha	Grantha alphabet
Juventus Football Club	Juventus FC
New Mexico Thunderbird	New Mexico Thunderbirds
Lech Wałęsa	Lech Wałęsa
Hüseyin Hilmi Pasha	Hüseyin Hilmi Pasha
Carlos	Carlos Duke of Parma
Hsu Shuiteh	Hsu Shuiteh
Ringo Starr	Ringo Starr
Zhu Xi	Zhu Xi
Ōyama Iwao	Ōyama Iwao
Park Jungmin	Park Jungmin
Alexander Kokolin	Aleksandr Kokorin
Tang Ruizong	Emperor Ruizong of Tang
Yuen Long Football Club	Yuen Long FC
Úrvalsdeild	Úrvalsdeild
chandigarh	Chandigarh
Urasoe Okinawa	Urasoe Okinawa
Royal Dutch Football Association	Royal Dutch Football Association
Carl Valery	Carl Valeri
Worcester City Football Club	Worcester City FC
Otto Weininger	Otto Weininger
Piotr Jaroszewicz	Piotr Jaroszewicz
Suzuki Escudo	Suzuki Escudo
Rahm Emanuel	Rahm Emanuel
Nusra Front	AlNusra Front
Harmony CRH3 EMU	China Railways CRH3
Victor Francois 2nd Duke of Brouil	VictorFrançois 2nd duc de Broglie
Maximinus Daza	Maximinus II
Ri Kwangchon	Ri Kwangchon
Watford	Watford
Muhammad Qadir	Mohamed Kader
Yao Chiawen	Yao Chiawen
2013 Chinese Football Association Super Cup	2013 Chinese FA Super Cup
Freeman FreemanThomas 1st Marquess of Willingdon	Freeman FreemanThomas 1st Marquess of Willingdon
Kingdom of France	Kingdom of France
Astro Wah Lai Toi	Astro Wah Lai Toi
Tupac Valpa	Túpac Huallpa
American Life	American Life
SS501	SS501
Reza Ghoochannejhad	Reza Ghoochannejhad
Sean Connery	Sean Connery
Fight Fever J	Battle Fever J
Simon Kjær	Simon Kjær
Abdul Rahman of Negeri Sembilan	Abdul Rahman of Negeri Sembilan
Ranieri Mazli	Pascoal Ranieri Mazzilli
Sweden National Football Team	Sweden national football team
Ainu languages	Ainu languages
Ulanf	Ulanhu
Disneyland	Disneyland
Nemzeti Bajnokság I	Nemzeti Bajnokság I
Jonathan Spector	Jonathan Spector
Queen Xiaogongren	Empress Xiaogongren
Kingdom of Italy	Kingdom of Italy
The Cribs	The Cribs
Tatsuya Sakai	Tatsuya Sakai
Cape Canaveral Air Force Station Space Launch Complex 40	Cape Canaveral Air Force Station Space Launch Complex 40
Aleksey Kudrin	Alexei Kudrin
Nintendo Entertainment System	Nintendo Entertainment System
Jimmy Bullard	Jimmy Bullard
University of Florence	University of Florence
bow	Bow Wow
Tetum	Tetum language
soft rock	Soft rock
Love Dream	Dream of Love
Portia SimpsonMiller	Portia SimpsonMiller
Love across the ocean	Love Across the Ocean
California State Senate	California State Senate
Belgrade	Belgrade
Kara	Kara
Botswana	Botswana
JeanPaul Sartre	JeanPaul Sartre
Warner Bros	Warner Bros
Michele Alboreto	Michele Alboreto
Louisiana Administrative Divisions	List of parishes in Louisiana
Empress Myeongseong	Empress Myeongseong
LollipopF	Lollipop F
Jiujiang Yangtze River Bridge	Jiujiang Yangtze River Bridge
Celeron	Celeron
Meine	Meinier
Ministry of State Security	Ministry of State Security
LibreOffice	LibreOffice
Stefan Effenberg	Stefan Effenberg
Yuan Shanshan	Yuan Shanshan
Glen Murray	Glen Murray
Jet Evans	Ched Evans
Andres Herzog	Andi Herzog
Tulsa Oklahoma	Tulsa Oklahoma
William Rehnquist	William Rehnquist
Ram Chiang	Ram Chiang
mauritius	Mauritius
Friends	Friends
The Kushan Empire	Kushan Empire
Walloon Behrami	Valon Behrami
National Health and Family Planning Commission	National Health and Family Planning Commission
Kohei Kawata	Kohei Kawata
Marton Fulop	Márton Fülöp
Kim Youngkwang	Kim Youngkwang
west Virginia	West Virginia
SC Olhanense	SC Olhanense
China Television	China Television
Syrian Armed Forces	Syrian Armed Forces
Secretary of the Central Commission for Discipline Inspection	Secretary of the Central Commission for Discipline Inspection
Asamoah Gian	Asamoah Gyan
Patty Murray	Patty Murray
Ken Mattingly	Ken Mattingly
EXID	EXID
Northern Han	Northern Han
Pedro I	Pedro I of Brazil
China National Youth Football Team	China national under20 football team
Jahangir	Jahangir
Todor Bulmov	Todor Burmov
Hong Yongjo	Hong Yongjo
Riccardo Montolivo	Riccardo Montolivo
Heechul	Kim Heechul
Foxborough	Foxborough Massachusetts
RC Lens	RC Lens
Takasaki	Takasaki Gunma
Sugasa Dasa Stadium	Sugathadasa Stadium
ShanghaiKunming Line	ShanghaiKunming Railway
Thomas Vermaelen	Thomas Vermaelen
Luton Town FC	Luton Town FC
UtahAztec	UtoAztecan languages
Marcos Rojo	Marcos Rojo
Raúl Albiol	Raúl Albiol
Morocco National Football Team	Morocco national football team
Keine Lust	Keine Lust
Kingone Wang	Kingone Wang
Sulli	Sulli
Republic of Korea Armed Forces	Republic of Korea Armed Forces
Bosnian	Bosnian language
Jessica Jung	Jessica Jung
hardcore punk	Hardcore punk
Cleo	Cléo
FUSE OF LOVE	Fuse of Love
jiaozhe	Jiao Zhe
Ada	Ada
Arabic Alphabet	Arabic alphabet
Inha University	Inha University
Michael Sheen	Michael Sheen
Abd Raab Mansour Hadi	Abd Rabbuh Mansur Hadi
Bill Nelson	Bill Nelson
Al Qaeda	AlQaeda
National League Nort	National League North
Lingya District	Lingya District
Philip II	Philip II of Macedon
OGC Nice	OGC Nice
JeanBaptiste Lamarck	JeanBaptiste Lamarck
Western Yugur	Western Yugur language
Albert II	Albert II of Belgium
Guy de Maupassant	Guy de Maupassant
Swiss Federal Council	Swiss Federal Council
Takuya Terada	Takuya Terada
Friends	Friends
Joe Cole	Joe Cole
Hong Kong Fourth Division League	Hong Kong Fourth Division League
Indian Premier League	Indian Super League
Taipa	Taipa
Tropical Storm Hannah	Tropical Storm Hanna
Royal Australian Air Force	Royal Australian Air Force
Fabio Capello	Fabio Capello
Omonia Sports	AC Omonia
Russian Soviet Federal Socialist Republic	Russian Soviet Federative Socialist Republic
Subin Park	Subin Bak
Shō Shin	Shō Shin
Club Atlético Boca Juniors	Boca Juniors
Juken Sentai Gekiranger	Juken Sentai Gekiranger
FC Basel	FC Basel
Nu metal	Nu metal
Phoenix Sky Harbor International Airport	Phoenix Sky Harbor International Airport
Callixter III	Pope Callixtus III
Paris	Paris
Queen Noor	Queen Noor of Jordan
Marianne Raven	Marion Raven
Carson	Carson California
Muhammad Ali of Egypt	Muhammad Ali of Egypt
University of Alabama	University of Alabama
Hachinohe	Hachinohe Aomori
Sistus V	Pope Sixtus V
Ronan Keating	Ronan Keating
Kingdom of Yugoslavia	Kingdom of Yugoslavia
Ptolemy I Soter	Ptolemy I Soter
Ernie Merrick	Ernie Merrick
PepGuardiola	Pep Guardiola
ATTACK	Attack
Phil Jagielka	Phil Jagielka
Lithuanian	Lithuanians
Yuri Mikhailovich Luzhkov	Yury Luzhkov
Wii U	Super Smash Bros for Nintendo 3DS and Wii U
Joinville Athletic Club	Joinville Esporte Clube
Giorgio Chiellini	Giorgio Chiellini
Cyrus the Great	Cyrus the Great
Run Devil Run	Mr Taxi
Prague University of Economics	University of Economics Prague
Belgium Football League	Belgian Pro League
Ingrid Bergman	Ingrid Bergman
University of Jena	University of Jena
Drake McInnes	Derek McInnes
Windows Phone	Windows Phone
Des Voeux	William Des Vœux
Simon Yam	Simon Yam
Liquivea Sports	Lekhwiya SC
One of the Boys	One of the Boys
Sanmin District	Sanmin District
Nukry Levishvili	Nukri Revishvili
Michael Miu	Michael Miu
Shunkan Sentimental	Shunkan Sentimental
Frederick Low	Frederick Low
Amazuppai Haru ni Sakura Saku	Amazuppai Haru ni Sakura Saku
Ashkan Dejaga	Ashkan Dejagah
José Bosingwa	José Bosingwa
Drake	Drake
Katowice	Katowice
Gujō	Gujō
Angelino Alfano	Angelino Alfano
Renaldo Elias da Costa	Reinaldo Elias da Costa
Chris Brown	Chris Brown
Hins Cheung	Hins Cheung
Jose Luis Rodriguez Zapatero	José Luis Rodríguez Zapatero
Yoyo Chen	Yoyo Chen
Lee Jungshin	Lee Jungshin
Kansha Kangeki Ame Arashi	Kansha Kangeki Ame Arashi
Chiyoda Ward	Chiyoda Tokyo
Francesco Corsiga	Francesco Cossiga
Anton Ropp	Anton Rop
Seth Harris	Seth Harris
Egyptian Football League	Egyptian Premier League
Radoslav Kovacs	Radoslav Kováč
Thomas Bach	Thomas Bach
Microsoft Word	Microsoft Word
Province of Ciudad Real	Province of Ciudad Real
Marty Ahtisaari	Martti Ahtisaari
Ken Chu	Ken Chu
Czech National Football Team	Czech Republic national football team
First Minister of Scotland	First Minister of Scotland
Heze	Heze
Tokugawa Yoshiyori	Tokugawa Yoshiyori
Ashikaga Yoshimitsu	Ashikaga Yoshimitsu
Alan GarciaPerez	Alan García
Haarlem	Haarlem
Daur	Daur language
Flora Chan	Flora Chan
Fuchu City	Fuchū Tokyo
cat shit mom	Coffee Cat Mama
Gossip Candy	Gossip Candy
IOS	IOS
Universal Orlando Resort	Universal Orlando
Paul Hamilton	Paul Hamilton
Choi Kyuhah	Choi Kyuhah
Empress Renxiaowen	Empress Xu
Deng Yingchao	Deng Yingchao
Tim BernersLee	Tim BernersLee
Lai Shinyuan	Lai Shinyuan
Mamadou Shagao	Mamadou Sakho
California State University Sacramento	California State University Sacramento
Tongzhi Emperor	Tongzhi Emperor
Nazu Monlier	Nacho Monreal
Limbu	Limbu language
Queen Xiaoshurui	Empress Xiaoshurui
Wintonshire Government	Shire of Winton
Chavacano	Chavacano
Vasily Kolarov	Vasil Kolarov
Semeria	Sammir
Brandon Santalab	Brendon Šantalab
P W Botha	P W Botha
Aldous Huxley	Aldous Huxley
Austria	Austria
Emperor Saga	Emperor Saga
Hakan Yakin	Hakan Yakin
java	Java
County Kilkenny	County Kilkenny
Das Erste	Das Erste
Hausa	Hausa language
Kedah	Kedah
Yokosuka City	Yokosuka Kanagawa
Eddie Murphy	Eddie Murphy
Mazda Cosmo	Mazda Cosmo
Antonio Lopez	Antonio López
pravia	Pravia
Lhasa Gonggar Airport	Lhasa Gonggar Airport
Giorjos Chavelas	Georgios Tzavellas
Uffe Elbæk	Uffe Elbæk
derry	Delhi
Camellia japonica	Camellia japonica
Danny Vukovic	Danny Vukovic
October Revolution	October Revolution
Nyingchi	Nyingchi
Benjamin Disraeli	Benjamin Disraeli
belize	Belize
Takatsuki	Takatsuki Osaka
Clement Attlee	Clement Attlee
Alan Thompson	Alan Thompson
Atlantic Records	Atlantic Records
H	H
Lin Chenyi	Lin Chenyi
John Paul Stevens	John Paul Stevens
palencia	Palencia
North Sea	North Sea
Brazil womens national football team	Brazil womens national football team
Princess Louis	Louise Princess Royal
Blur	Blur
Nationalist Party	Nationalist Party
Santa Fe Springs	Santa Fe Springs California
Mary Todd	Mary Todd Lincoln
Shirley Yeung	Shirley Yeung
Ninja Gaiden Series	Ninja Gaiden
Republic of Genoa	Republic of Genoa
Senard Lulich	Senad Lulić
Swift	Swift
Yurico Gaspar Dutra	Eurico Gaspar Dutra
Paraná	Paraná
Bulgarian	Bulgarian language
German Chancellor	Chancellor of Germany
utah	Utah
Jurgen Klopp	Jürgen Klopp
Daniel Faraday	Daniel Faraday
Monaghanshire	County Monaghan
Southampton Football Club	Southampton FC
Finnish	Finnish language
Çandarlı Ibrahim Pasha the Younger	Çandarlı Ibrahim Pasha the Younger
Heerenveen Sports	SC Heerenveen
Mark Weber	Mark Webber
South America Libertadores Cup	Copa Libertadores
Hull City Football Club	Hull City AFC
Loveven Cabinet	Löfven Cabinet
The Fast And The Furious	The Fast and the Furious
MeeGo	MeeGo
Hu Jintao	Hu Jintao
Joachim Loew	Joachim Löw
Haji Ali Razmara	Haj Ali Razmara
Nintendo2DS	Nintendo 2DS
Criciúma Esporte Clube	Criciúma Esporte Clube
Alexander Boto	Alexandre Pato
Lao Peoples Revolutionary Party	Lao Peoples Revolutionary Party
Armintore Van Fanniere	Amintore Fanfani
none	Mikan
Carlos Santana	Carlos Santana
Kristján Eldjárn	Kristján Eldjárn
Supercell	Supercell
Fyodor Mikhailovich Dostoevsky	Fyodor Dostoyevsky
Fabio Aurelio	Fábio Aurélio
Pat Riley	Pat Riley
PAS Tehran FC	PAS Tehran FC
Russian Provisional Government	Russian Provisional Government
Someday	Someday
Shueisha	Shueisha
David Albelda	David Albelda
Malappuram	Malappuram
Mali National Football Team	Mali national football team
France Football Federation	French Football Federation
Paul Hauser	Paul Hausser
Montesquieu	Montesquieu
Left Party	Left Party
Lucrezia Borgia	Lucrezia Borgia
Swiss Premier League	Swiss Super League
Charlie and the Chocolate Factory	Charlie and the Chocolate Factory
Roberto Carlos	Roberto Carlos
Kabayama Sukenori	Kabayama Sukenori
Hitoshi Ashida	Hitoshi Ashida
Once Upon a Time	Once Upon a Time
Tochigi Prefecture	Tochigi Prefecture
Norodom Monile	Norodom Monineath
Paris SaintGermain Football Club	Paris SaintGermain FC
Pope Sergius IV	Pope Sergius IV
Saint Barthelemy	Saint Barthélemy
Like a virgin	Like a Virgin
Beastie Boys	Beastie Boys
Ramón Núñez	Ramón Núñez
AC Chievo Verona	AC Chievo Verona
Tai Nüa language	Tai Nüa language
Emirate of Abu Dhabi	Emirate of Abu Dhabi
The Knights of Malta	Sovereign Military Order of Malta
Shandong Airlines	Shandong Airlines
Riyad Farid Hijab	Riyad Farid Hijab
Angels Fall First	Angels Fall First
Sergei Shoigu	Sergey Shoygu
ICAC Investigators 2009	ICAC Investigators 2009
Kazuki Ganaha	Kazuki Ganaha
SocialDemocracy	Social Democratic Party
French invasion of Russia	French invasion of Russia
Pope Sylvester II	Pope Sylvester II
Zafarullah Khan Jamali	Zafarullah Khan Jamali
Henry Cornelius Burnett	Henry Cornelius Burnett
Xi County Henan	Xi County Henan
Bernard Mandeville	Bernard Mandeville
Paraguayan Primera División	Paraguayan Primera División
Nivkh	Nivkh language
Marcel Mauss	Marcel Mauss
Charles Evans Hughes	Charles Evans Hughes
Lamborghini Gallardo	Lamborghini Gallardo
Tocharian	Tocharian languages
Roma	Romani language
University of Zurich	University of Zurich
Medhi Lacen	Medhi Lacen
Uttarakhand	Uttarakhand
Du riechst so gut	Du riechst so gut
Flora Finch	Flora Finch
Massachusetts	Massachusetts
Gerald Ford	Gerald Ford
Pope Paul III	Pope Paul III
James Hetfield	James Hetfield
FrancoProvencal	FrancoProvençal language
Ernst Kummer	Ernst Kummer
Shijiazhuang Yongchang Football Club	Shijiazhuang Ever Bright FC
Diane Feinstein	Dianne Feinstein
Hughes West Airlines Flight 706 crash	Hughes Airwest Flight 706
Chinese Television System	Chinese Television System
Luigi Inodi	Luigi Einaudi
Yuto Sasaki	Hayato Sasaki
Mohammad Hatta	Mohammad Hatta
Abraham Baldwin	Abraham Baldwin
trabzonsport	Trabzonspor
Equatorial Guinea	Equatorial Guinea
Camellia	Camellia
Barnes Railway Bridge	Barnes Railway Bridge
Robbie Keane	Robbie Keane
Marcel Desailly	Marcel Desailly
Yeon Soo Jung	Andrew Yeom Soojung
Valdemar Pavlac	Waldemar Pawlak
Athabaskan languages	Athabaskan languages
Szeto Wah	Szeto Wah
Nayef Khazazi	Naif Hazazi
Communist Party of the Republic of Moldova	Party of Communists of the Republic of Moldova
Baby One More Time	Baby One More Time
Ninpuu Sentai Hurricaneger	Ninpuu Sentai Hurricaneger
Mario Gomez	Mario Gómez
Jay Chou	Jay
Zhang Yesui	Zhang Yesui
Maanshan	Maanshan
Pasadena	Pasadena California
Justus von Liebig	Justus von Liebig
1979  UEFA Champions League 80	197980 European Cup
Narwee New South Wales	Narwee New South Wales
Mutou Yuki	Yuki Muto
Ubisoft Paris	Ubisoft Paris
Republic of China Army	Republic of China Army
John B Weller	John B Weller
Xavier Chen	Xavier Chen
Viratko Glodanoski	Vlatko Grozdanoski
Hulk	Hulk
United States Treasury Secretary	United States Secretary of the Treasury
Gelderland	Gelderland
Chin Kalok	Chin Kalok
AH64 Apache Helicopter	Boeing AH64 Apache
Gran Telescopio Canarias	Gran Telescopio Canarias
NIFL Premiership	NIFL Premiership
Dalian Shide Football Club	Dalian Shide FC
ProBeijing camp	ProBeijing camp
Spanish Navy	Spanish Navy
General Secretary of the Central Committee of the Communist Party of Vietnam	General Secretary of the Communist Party of Vietnam
Ivan Sutherland	Ivan Sutherland
Cristiano Cordeiro	Cristiano Cordeiro
Prudente de Morais	Prudente de Morais
CSX Shipping	CSX Transportation
Queen Dowager Cian	Empress Dowager Cian
John Sherman	John Sherman
Elvis Presley	Elvis Presley
Maze	Maze
Assembly of the Union	Assembly of the Union
Gagauzia	Gagauzia
Malcolm Fraser	Malcolm Fraser
Chen Tao	Chen Tao
In the Zone	In the Zone
Airbus A330	Airbus A330
Gerald Gurani	Gerald Guralnik
Royal Espanyol Sports Club	RCD Espanyol
Gamla Ullevi	Gamla Ullevi
Cao Cao	Cao Cao
Paula Tsui	Paula Tsui
Suwa City	Suwa Nagano
List of Prime Ministers of Slovenia	Prime Minister of Slovenia
Mui Siuching	Mui Siuching
Democratic Party	Democratic Party
Semstin Gunartay	Şemsettin Günaltay
Herbert Blumer	Herbert Blumer
Lee Jaeryong	Lee Jaeryong
Tekoshi Yuya	Yuya Tegoshi
Gary Cahill	Gary Cahill
Fuzao	Fuzao
Iovanni Arechea	Yovanny Arrechea
CAROLS	Carols
President of the Legislative Council of Hong Kong	President of the Legislative Council of Hong Kong
Republic of Crimea	Republic of Crimea
Nightwish	Nightwish
Anytime	Anytime
Norihisa Tamura	Norihisa Tamura
Emma Goldman	Emma Goldman
Mario Fernandis	Mário Figueira Fernandes
I M Pei	I M Pei
Kim Changsoo	Kim Changsoo
Loukas Vyntra	Loukas Vyntra
U Win Na Maung Lun	Wunna Maung Lwin
South African Airways	South African Airways
Rudi Völler	Rudi Völler
Bastian Schweinsteiger	Bastian Schweinsteiger
Allied Military Occupation of Japan	Occupation of Japan
Parliament of the United Kingdom	Parliament of the United Kingdom
Niels Bohr	Niels Bohr
Nanzih District	Nanzih District
Yicong	Yicong
Tanzan Ishibashi	Tanzan Ishibashi
Georg Schwarzenbeck	HansGeorg Schwarzenbeck
Labour Party	Labour Party
Kurt Alder	Kurt Alder
Jose Rodriguez	José Rodríguez Martínez
Ricardo Quaresma	Ricardo Quaresma
Berlin	Berlin
Boeing Commercial Airplanes	Boeing Commercial Airplanes
Stephen	Stephen King of England
Qing Dynasty	Qing dynasty
Carloman of Bavaria	Carloman of Bavaria
bohemia	Bohemia
P3 Orion Maritime Patrol	Lockheed P3 Orion
Annapolis	Annapolis Maryland
Martin Brian Mulroney	Brian Mulroney
Shinkai	Shinkai
Ludvik Swoboda	Ludvík Svoboda
Changping District	Changping District
madrid	Madrid
Aymara	Aymara language
Leon Jessen	Leon Jessen
North Brabant	North Brabant
Agatha Barbara	Agatha Barbara
NVIDIA GeForce 700	GeForce 700 series
HTC First	HTC First
Kevin Feige	Kevin Feige
Chromecast	Chromecast
Technische Universität München	Technische Universität München
Robert Kunz	Robert Coontz
Kamakura Shogunate	Kamakura shogunate
Nordic Green Left	European United LeftNordic Green Left
Ntv7	NTV7
James Viscount Severn	James Viscount Severn
Chen Yeongkang	Chen Yeongkang
Labour	Labour Party
Helen Chang	Helen Chang
Pope Paschal II	Pope Paschal II
Saint Paul	Saint Paul Minnesota
University of Liverpool	University of Liverpool
Diego Forlán	Diego Forlán
Oregon	Oregon
Molde FK	Molde FK
Kim Jungwoo	Kim Jungwoo
Ricardo Ezzati Andrello	Ricardo Ezzati Andrello
Terminal	Terminal
Dara	Daraa Governorate
Taiwanese	Taiwanese people
Rivers Cuomo	Rivers Cuomo
Nancy Sports	AS Nancy
Blackburn	Blackburn
2014 AFC Champions League	2014 AFC Champions League
Roger Wick	Roger Wicker
Korea National Assembly	National Assembly
Auckland Airport	Auckland Airport
HEART	Heart
stalbans	St Albans
Princess Marina of Greece	Princess Marina of Greece and Denmark
Brooklyn	Brooklyn
Jap Stam	Jaap Stam
SaxonyWeimarEisenach	Grand Duchy of SaxeWeimarEisenach
Hi no Tori	Hi no Tori
city of gothenburg	Gothenburg Municipality
shropshire	Shropshire
HalfLife	HalfLife
ABBA	ABBA
Francis II Holy Roman Emperor	Francis II Holy Roman Emperor
Valencian	Valencian
East Kalimantan	East Kalimantan
John Major	John Major
Hong Kong Pegasus Football Club	Hong Kong Pegasus FC
Brown Eyed Girls	Brown Eyed Girls
Flemish Region	Flemish Region
Quartzsite	Quartzsite Arizona
Berber	Berbers
Rainie Yang	Rainie Yang
Yao	Yao people
Chris Foy	Chris Foy
Grand Dauphin	Louis Grand Dauphin
CTS Main Channel	CTS Main Channel
Duangu Mijan ZainerAbidin	Mizan Zainal Abidin of Terengganu
Scottish Gaelic	Scottish Gaelic
Luo Yingshay	Luo Yingshay
The Last Samurai	The Last Samurai
Veel Nader Khaliji	Wael Nader alHalqi
Baise	Baise
Singapore national football team	Singapore national football team
Shandong Sports Center Stadium	Shandong Provincial Stadium
Metz Football Club	FC Metz
Dordrecht	Dordrecht
Hans Geiger	Hans Geiger
Chairman of the Central Committee of the Communist Party of China	Chairman of the Communist Party of China
Soraya IvandialiBhaktiari	Soraya EsfandiaryBakhtiari
Rick Perry	Rick Perry
Christopher Metzelder	Christoph Metzelder
Charles II Duke of Parma	Charles II Duke of Parma
Swedish	Swedish language
Bannan Line	Taipei Metro Line 5
Wilber Pan	Wilber Pan
Tim Krell	Tim Krul
Ulla Schmidt	Ulla Schmidt
Wild Charlotte	Good Charlotte
University of Michigan Wolverines	Michigan Wolverines
Kawasaki Kanagawa	Kawasaki Kanagawa
Sunny Hill	Sunny Hill
Phraya Manopakorn Nititada	Phraya Manopakorn Nititada
Vandœuvres	Vandœuvres
Coptic alphabet	Coptic alphabet
Ichihara	Ichihara Chiba
Heurelho Gomes	Heurelho Gomes
Chandler Ibrahim Pasha the Elder	Çandarlı Ibrahim Pasha the Elder
Plaid Cymru	Plaid Cymru
Matsushima Nanako	Nanako Matsushima
Naha City	Naha
Madhya Pradesh	Madhya Pradesh
Clark University	Clark University
Say Chhum	Say Chhum
SaxonyMeiningen	Duchy of SaxeMeiningen
Çandarlı Ali Pasha	Çandarlı Ali Pasha
Just Lov	Just Love
northern california	Northern California
Seven Years War	Seven Years War
Maebashi City	Maebashi
Lee Jungsoo	Lee Jungsoo
AbdulAziz Bouteflika	Abdelaziz Bouteflika
KEIKO	Keiko
Samsung Galaxy Note 4	Samsung Galaxy Note 4
University of Turin	University of Turin
United States Secretary of Transportation	United States Secretary of Transportation
Melbourne City Football Club	Melbourne City FC
Minutes To Midnight	Minutes to Midnight
WIND	Wind
Atlas Football Club	Club Atlas
Saudi Professional Football League	Saudi Professional League
Vasily Vasilyevich Kuznetsov	Vasili Kuznetsov
Japan Air Lines Flight 351	Japan Airlines Flight 351
United States Secretary of Labor	United States Secretary of Labor
Mari	Mari language
Chiba Kazuhiko	Kazuhiko Chiba
Chen Jianbin	Chen Jianbin
Kitanagoya	Kitanagoya
Huang Hsinchieh	Huang Shinchieh
Empress Elisabeth of Austria	Empress Elisabeth of Austria
ECMAScript	ECMAScript
Ron Wyden	Ron Wyden
Gilan	Gilan Province
Sugiman Virjosanzoyo	Soekiman Wirjosandjojo
Philips Stadium	Philips Stadion
Phil Spector	Phil Spector
Ibaraki	Ibaraki Osaka
Su24 fighterbomber	Sukhoi Su24
NintendoDSi	Nintendo DSi
Depend on you	Depend on You
William Golding	William Golding
Robert W Floyd	Robert W Floyd
Balázs Dzsudzsák	Balázs Dzsudzsák
Dmitry Stepanovich Polyansky	Dmitry Polyansky
AV8 Falcon II attack aircraft	McDonnell Douglas AV8B Harrier II
Friendship Arena	Friends Arena
Dong Thap Province	Đồng Tháp Province
Timon Wellenreuth	Timon Wellenreuther
Vyacheslav Menzhinsky	Vyacheslav Menzhinsky
The Return of Sherlock Holmes	The Return of Sherlock Holmes
Rose Bowl	Rose Bowl Game
Jules de Polignac	Jules de Polignac
Empress Kōken	Empress Kōken
The Siren	The Siren
Nankai University	Nankai University
Wu Xinghan	Wu Xinghan
Kingdom of England	Kingdom of England
UNI Air	Uni Air
Show Me the Happy	Show Me the Happy
States and Territories of India	States and union territories of India
AntonovAn24	Antonov An24
Red Bull Racing	Red Bull Racing
IPhone 6	IPhone 6
Sports Club of Rome	AS Roma
Liu Yuzhang	Liu Yuzhang
Order of Australia	Order of Australia
SourceEngine	Source
Leo Tolstoy	Leo Tolstoy
Hungarian Peoples Republic	Hungarian Peoples Republic
Gary Peters	Gary Peters
Merrimack River	Merrimack River
Animax Asia	Animax Asia
Rgyalrong languages	Rgyalrong languages
split	Split Croatia
Sandra Day OConnor	Sandra Day OConnor
Angus Young	Angus Young
Esporte Clube Bahia	Esporte Clube Bahia
Elaine Yiu	Elaine Yiu
Korea Baseball Committee	Korea Baseball Organization
A Day at the Races	A Day at the Races
States General of the Netherlands	States General of the Netherlands
Zhang Wentian	Zhang Wentian
Sun Yatsen	Sun Yatsen
HD 108874 c	HD 108874 c
New York	New York City
Plutarch	Plutarch
Yokohama Station	Yokohama Station
Vegatech Sendai	Vegalta Sendai
Shinagawa	Shinagawa
Lakhdar Brahimi	Lakhdar Brahimi
DC Comics	DC Comics
Lady Abahai	Lady Abahai
Yellow	Yellow
Lu Xinshe	Lu Xinshe
Padmé Amidala	Padmé Amidala
Tama area	Tamaku Kawasaki
Atromitos Football Club	Atromitos FC
Federal President	President of Germany
University of Notre Dame	University of Notre Dame
Bernast Tarleton	Banastre Tarleton
Rolling Stones	The Rolling Stones
Infante Juan Count of Barcelona	Infante Juan Count of Barcelona
Samuel Alito	Samuel Alito
Family Guy	Family Guy
Staffordshire	Staffordshire
Pope Stephen I	Pope Stephen I
Ovid	Ovid
Kang Minsoo	Kang Minsoo
Albanian Armed Forces	Albanian Armed Forces
ULTIMATE DIAMOND	Ultimate Diamond
Lord William Bentinck	Lord William Bentinck
Socialist	Socialist Party
CE LHospitalet	CE LHospitalet
Francesco Toldo	Francesco Toldo
Philadelphia 76ers	Philadelphia 76ers
Mapuche	Mapuche
Jimmy Carter	Jimmy Carter
Thieu Tri	Thiệu Trị
Im Your Boy	Im Your Boy
Fool Again	Fool Again
Starry Lee	Starry Lee
Gosei Sentai Dairanger	Gosei Sentai Dairanger
Xiaomi Phone 2	Xiaomi Mi 2
Aomori Aomori	Aomori Aomori
Dutch East Indies	Dutch East Indies
Love or Spend	Love or Spend
Gimnàstic de Tarragona	Gimnàstic de Tarragona
Mark Kirk	Mark Kirk
Christian Wulff	Christian Wulff
Nampo Special City	Nampo
Sharon Dan Adel	Sharon den Adel
David Stern	David Stern
Manuel Valls	Manuel Valls
ITunes	ITunes
Salamanca Football Club	UD Salamanca
George Grenville	George Grenville
Amelia Fox	Emilia Fox
HOW CRAZY YOUR LOVE	How Crazy Your Love
Santander	Santander Spain
Charles E Winter	Charles E Winter
Michael Bay	Michael Bay
TibetanBurman	TibetoBurman languages
PanthéonAssas University Paris II	PanthéonAssas University
Gibson Les Paul	Gibson Les Paul
Karakoram	Karakoram
Aleksandar Živković	Aleksandar Živković
Ultimatum	The Bourne Ultimatum
Kamikawa Yoko	Yōko Kamikawa
Yamaguchi Prefecture	Yamaguchi Prefecture
colorado rapids	Colorado Rapids
Oroqen	Oroqen people
Octopuss Garden	Octopuss Garden
Yancheng	Yancheng
Lara Veronin	Lara Veronin
North Carolina	North Carolina
South Tang	Southern Tang
Republican	The Republicans
Mohun Bagan AC	Mohun Bagan AC
StubHub Center	StubHub Center
Angela Merkel	Angela Merkel
West Java	West Java
Tomáš Hubočan	Tomáš Hubočan
Sajid Javid	Sajid Javid
Iwabuchi Mana	Mana Iwabuchi
Piacenza	Piacenza
Casey Affleck	Casey Affleck
Me Against the Music	Me Against the Music
Wally West	Wally West
Wenzhounese	Wenzhounese
Battle of Guningtou	Battle of Guningtou
English	English language
Choe Yongrim	Choe Yongrim
Sano	Sano Tochigi
Manco Inka Yupanki	Manco Inca Yupanqui
State University of New York	State University of New York
Geoffrey Chew	Geoffrey Chew
SO female	So Girls
Madonna	Madonna
Auburn Alabama	Auburn Alabama
OUT WORKS  COLLABORATION BEST	Out Works  Collaboration Best
Dai Jiaoqian	Dai Jiaoqian
Isotani Rensuke	Rensuke Isogai
Hong Kong Group C	Hong Kong Third A Division League
South Park	South Park
KisMyFt2	KisMyFt2
Uyghur	Uyghur language
The War between Tang and Goguryeo	GoguryeoTang War
Kasımpaşa SK	Kasımpaşa SK
Mátyás Szűrös	Mátyás Szűrös
Yokohama City	Yokohama
Viktor Orbán	Viktor Orbán
Shield Portable	Shield Portable
Leo IX	Pope Leo IX
Monthly Comic Alive	Monthly Comic Alive
Pope John Paul I	Pope John Paul I
Bashkir	Bashkir language
Adobe Flash Player	Adobe Flash Player
Swedish Monarch	Monarchy of Sweden
Linda McMahon	Linda McMahon
Will Charn	Will Champion
William the Lion	William the Lion
French Polynesia	French Polynesia
Jo An	Jo An
STARCAMP EP	Starcamp EP
Kōhokuku Yokohama	Kōhokuku Yokohama
Gurney Kardashian	Kourtney Kardashian
George SBoutwell	George S Boutwell
Brazil	Brazil
Avex trax	Avex Trax
Buena Park	Buena Park California
Warwickshire	Warwickshire
Jerry Moran	Jerry Moran
Working Peoples Progressive Party	Progressive Party of Working People
Hirosaki Aomori	Hirosaki Aomori
Lin Fengjiao	Lin Fengjiao
Jack Lane	Jack Ryan
Lower Yangtze Mandarin	Lower Yangtze Mandarin
Victor Stepanovich Chernomyrdin	Viktor Chernomyrdin
Cemal Gürsel	Cemal Gürsel
Hartlepool United Football Club	Hartlepool United FC
Henry Brisson	Henri Brisson
Voyager 2	Voyager 2
Sam Hui	Samuel Hui
Armageddon	Armageddon
Hohenzollern Dynasty	House of Hohenzollern
Komono Mie	Komono Mie
bastia sports	SC Bastia
Roman Sharonoff	Roman Sharonov
Feng Guozhang	Feng Guozhang
Pierre Luigi Bersani	Pier Luigi Bersani
Backstreet Boys	Backstreet Boys
Leverkusen FC	Bayer 04 Leverkusen
Bartley SC Johnson	Bradley Johnson
Paul Tang	Paul Tang
Tokyo Disneyland	Tokyo Disneyland
Alien Huang	Alien Huang
ITV	ITV
Fujisawa City	Fujisawa Kanagawa
Cimballa	Cimballa
Sony Ericsson Xperia arc S	Sony Ericsson Xperia arc S
Mini DisplayPort	Mini DisplayPort
Keith Gumbs	Keith Gumbs
Charlene Princess of Monaco	Charlene Princess of Monaco
Bohuslän	Bohuslän
Wa people	Wa people
Dream Girl  The Misconceptions Of You	Dream Girl  The Misconceptions of You
The Magicians Nephew	The Magicians Nephew
norfolk	Norfolk
Nottinghamshire	Nottinghamshire
United Left	United Left
Philip Dimitrov	Philip Dimitrov
Thomas Hobbes	Thomas Hobbes
Constans II	Constans II
kaka	Kaká
Lu Xun	Lu Xun
Arsenal Football Club	Arsenal FC
Sidney Govu	Sidney Govou
FC Paços de Ferreira	FC Paços de Ferreira
Yang Xu	Yang Xu
Music	Music
France Womens National Football Team	France womens national football team
Ahmed Oyahia	Ahmed Ouyahia
Maria Alexandrovna	Maria Alexandrovna
Gorica Football Club	ND Gorica
TRAX	TRAX
Socrates	Socrates
Umberto II	Umberto II of Italy
Sergio Aguero	Sergio Agüero
Mitsumasa Yonai	Mitsumasa Yonai
Wayne Chua	Wayne Chua
Brandeis University	Brandeis University
David BenGurion	David BenGurion
Francesco Totti	Francesco Totti
SimCity Series	SimCity
Ordos	Ordos City
Bert T Combs	Bert T Combs
FC Aarau	FC Aarau
Hamid Karzai	Hamid Karzai
Khmer Empire	Khmer Empire
Ito Yuheng	Itō Sukeyuki
thuringia	Thuringia
Taylor Swift	Taylor Swift
Boku no Miteiru Fūkei	Boku no Miteiru Fūkei
Community Shield England 2014	2014 FA Community Shield
Hellas Verona FC	Hellas Verona FC
Qiu Yong	Qiu Yong
Nejc Pečnik	Nejc Pečnik
Duchy of Mantua	Duchy of Mantua
Even if	Even If
akhenaten	Akhenaten
Goa Football Club	FC Goa
Sirajuddin of Perlis	Sirajuddin of Perlis
Emperor Kinmei	Emperor Kinmei
Tibetan	Tibetic languages
Cathay Pacific	Cathay Pacific
Hampden Park	Hampden Park
Fukui Prefecture	Fukui Prefecture
yasuyuki Konno	Yasuyuki Konno
Kingdom of Tungning	Kingdom of Tungning
Hikari Sentai Maskman	Hikari Sentai Maskman
Qadsia SC	Qadsia SC
Steven Hawking	Stephen Hawking
Mac OS X Snow Leopard	Mac OS X Snow Leopard
Lu Wei	Lu Wei
Aarhus Gymnastikforening	Aarhus Gymnastikforening
The Rise of the Kingdom	Rise of Nations
John Wheeler	John Archibald Wheeler
illinois	Illinois
Muhammad Ould AbdulAziz	Mohamed Ould Abdel Aziz
Naughty Dog	Naughty Dog
AlAhli Saudi FC	AlAhli Saudi FC
Max Gradu	Max Gradel
Tajimi City	Tajimi Gifu
Kim Eana	Kim Eana
Music Church	Music
MikoyanGurevich MiG17	MikoyanGurevich MiG17
Sham Shui Po Sports Ground	Sham Shui Po Sports Ground
List of Portuguese monarchs	List of Portuguese monarchs
Tulane University	Tulane University
Hyakujuu Sentai Gaoranger	Hyakujuu Sentai Gaoranger
Pope Mark Valley	Pope Mark
Möngke Khan	Möngke Khan
Aymara people	Aymara people
Teppen Tottande	Teppen Tottande
Al Ain Football Club	Al Ain FC
Cape Verde National Football Team	Cape Verde national football team
Cosmin Contra	Cosmin Contra
Phoenician	Phoenician language
Hawaii	Hawaii
Kono Yo no Kagiri	Kono Yo no Kagiri
Will Arnett	Will Arnett
Seoul Football Club	FC Seoul
Chuck Schumer	Chuck Schumer
Athletic Bilbao	Athletic Bilbao
New Zealand Labour Party	New Zealand Labour Party
Chua Tee Yong	Chua Tee Yong
Chen Poliang	Chen Poliang
Ricardo Carvalho	Ricardo Carvalho
Dave Mustaine	Dave Mustaine
Trần Dụ Tông	Trần Dụ Tông
Lin Biao	Lin Biao
Avril Lavigne	Avril Lavigne
Montgomery Blair	Montgomery Blair
Run Run Shaw	Run Run Shaw
Liam Reddy	Liam Reddy
Editor Cresson	Édith Cresson
Cantonese	Cantonese
Community Shield England 2011	2011 FA Community Shield
Metallica	Metallica
Iannis Maniatis	Giannis Maniatis
UK General Election 2005	United Kingdom general election 2005
Manhattan Financial District	Financial District Manhattan
Kim Hyungil	Kim Hyungil
Geʽez language	Geez language
Fahri Kruturk	Fahri Korutürk
Celtic	Celtic languages
Savo Milosevic	Savo Milošević
Vitalies Astavyevs	Vitālijs Astafjevs
Michael Doyle	Michael Doyle
Sofia Levski Football Club	PFC Levski Sofia
Leizhou Min	Leizhou Min
Modern Standard Chinese	Standard Chinese
Ebisu Shibuya	Ebisu Shibuya
Wuhan Zall Professional Football Club	Wuhan Zall FC
University of Kent	University of Kent
Qinghai Senke Football Club	Qinghai Senke FC
Holden Chow	Holden Chow
Momo Love	Momo Love
Finland National Football Team	Finland national football team
Onew	Onew
Akita	Kazuno Akita
Tang Shaoyi	Tang Shaoyi
Shonentai	Shonentai
quito	Quito
NVIDIA GeForce 400	GeForce 400 series
DNAngel	DNAngel
Lloyd Austin III	Lloyd Austin
Genoa Cricket  Football Club	Genoa CFC
Shimane Prefecture	Shimane Prefecture
Jake Kerouac	Jack Kerouac
Oppa Oppa	Oppa Oppa
National Front	National Front
Princess Estelle Duchess of Östergötland	Princess Estelle Duchess of Östergötland
Thomas Pledel	Thomas Pledl
Guangzhou Evergrande Taobao Football Club	Guangzhou Evergrande Taobao FC
Dwight D Eisenhower	Dwight D Eisenhower
SC Braga	SC Braga
Pyongyang	Pyongyang
Albanians	Albanians
Pedro Passos Coelho	Pedro Passos Coelho
Kidderminster	Kidderminster
Victoria Louise	Princess Victoria Louise of Prussia
Chester W Nimitz	Chester W Nimitz
Yuko Obuchi	Yūko Obuchi
OneDrive	OneDrive
Raul Alfonsin	Raúl Alfonsín
Nassaf Football Club	FC Nasaf
2013 DFBPokal Final	2013 DFBPokal Final
jersey	Jersey
Hung Hsiuchu	Hung Hsiuchu
Kyoto Phoenix FC	Kyoto Sanga FC
Ranger 6	Ranger 6
Hungarian Forint	Hungarian forint
Confignon	Confignon
An Shi Rebellion	An Lushan Rebellion
This Is It	This Is It
Linux	Linux
C ♯	C Sharp
Hong Kong Football Association	Hong Kong Football Association
Together When	Together When
HansJurgen Stumpf	HansJürgen Stumpff
Sodnomu Damuddinbazar	Jalkhanz Khutagt Sodnomyn Damdinbazar
Sanji Bayar	Sanjaagiin Bayar
Iranian	Iranian languages
Free  Easy	Free  Easy
Yamagata Aritomo	Yamagata Aritomo
National Yilan Senior High School	National Yilan Senior High School
Las Palmas Athletic Union	UD Las Palmas
Popcorn	Popcorn
Brian Wilson	Brian Wilson
Zahia Elbegdorj	Tsakhiagiin Elbegdorj
When Lanes Merge	When Lanes Merge
Over Load	Over Load
Donald Rumsfeld	Donald Rumsfeld
Porto Football Club B Team	FC Porto B
Yanan	Yanan
Anton Pavlovich Chekhov	Anton Chekhov
Pius IX	Pope Pius IX
Blue	Blue
Akadian	Akkadian language
Fabolous	Fabolous
Sinhala	Sinhala alphabet
Gujarat	Gujarat
Ahmed Shah Bahadur	Ahmad Shah Bahadur
Xu Xiangqian	Xu Xiangqian
Setagaya Ward	Setagaya
Kareskakis Stadium	Karaiskakis Stadium
201314 English Premier League	201314 Premier League
Tigris	Tigris
Begji Keid Essebsi	Beji Caid Essebsi
Murphys Law of Love	Murphys Law of Love
Tamangic languages	Tamangic languages
Lansing	Lansing Michigan
Nintendo Information Development Headquarters	Nintendo Entertainment Analysis  Development
Aymen Abdennour	Aymen Abdennour
maes	Metz
Ledley King	Ledley King
Jetstar	Jetstar Airways
Leessang	Leessang
Nephthys	Nephthys
NMB48	NMB48
Stefan Lofven	Stefan Löfven
South Seas Mandate	South Pacific Mandate
Hapoel Tel Aviv FC	Hapoel Tel Aviv FC
Northrop Corporation	Northrop Corporation
Kashima Antlers	Kashima Antlers
Deputy Prime Minister of the United Kingdom	Deputy Prime Minister of the United Kingdom
Tony Tan	Tony Tan
Viktor Fischer	Viktor Fischer
Sunao na Mama	Sunao na Mama
LaurentDesiree Kabila	LaurentDésiré Kabila
Marek Heinz	Marek Heinz
Inuyasha	Inuyasha
Mandarin Airlines	Mandarin Airlines
Nicklaus Wirth	Niklaus Wirth
Haswell microarchitecture	Haswell
Fukaya	Fukaya Saitama
Chea Sim	Chea Sim
Blake Ross	Blake Ross
turin	Turin
Categoría Primera B	Categoría Primera B
Yang Chaosheng	Yang Chaosheng
Ho Chi Minh City	Ho Chi Minh City
Slobodan Rajkovic	Slobodan Rajković
Mabuya Institute of Technology	Mapúa Institute of Technology
Raymond Barr	Raymond Barre
Nem Onusia	Nedum Onuoha
Louis XIV	Louis XIV of France
Eagle Air	Eagle Airways
Klaus Augenthaler	Klaus Augenthaler
Jacques Demy	Jacques Demy
Otto Grotivor	Otto Grotewohl
Distinguished Service Medal	Distinguished Service Medal
James VanVleet	James Van Fleet
French Navy	French Navy
Ng Yen Yen	Ng Yen Yen
Kim Shinwook	Kim Shinwook
Armen Sarkisian	Armen Sargsyan
Corcier	Corsier
Jalal Talabani	Jalal Talabani
Milosh Zeman	Miloš Zeman
New Horizons	New Horizons
Georges Leygues	Georges Leygues
Kawaguchi City	Kawaguchi Saitama
Watanabe Chima	Kazuma Watanabe
Little Rock	Little Rock Arkansas
Alfredo Cristiani Burcard	Alfredo Cristiani
Guangxi Zhuang Autonomous Region	Guangxi
Carrie Underwood	Carrie Underwood
Catholic Diocese of Paris	Roman Catholic Archdiocese of Paris
Luzhniki Stadium	Luzhniki Stadium
Tumpa Stadium	Toumba Stadium
Moses Katsav	Moshe Katsav
Forensic Pioneer	Forensic Heroes
Hokuto	Hokuto Yamanashi
Yomiuri TV	Yomiuri Telecasting Corporation
Sven Bender	Sven Bender
Air Canada	Air Canada
William Adams Richardson	William Adams Richardson
196768 European Cup Winners Cup	196768 European Cup Winners Cup
rosebowl	Rose Bowl
Albuquerque New Mexico	Albuquerque New Mexico
Gustav Hertz	Gustav Ludwig Hertz
Bradford	Bradford
Igor Tudor	Igor Tudor
Crystal Palace Football Club	Crystal Palace FC
Swiss Football Association	Swiss Football Association
Reto Ziegler	Reto Ziegler
Zheng Kaimu	Zheng Kaimu
Janez Drnovšek	Janez Drnovšek
choke hot red pepper	Red Hot Chili Peppers
Jason Chan	Jason Chan
Party of Regions	Party of Regions
Juan Antonio Samaranch	Juan Antonio Samaranch
Chua Soi Lek	Chua Soi Lek
PlayStation	PlayStation
Fujikawaguchikomachi	Fujikawaguchiko Yamanashi
Charles S Fairchild	Charles S Fairchild
Ngari Prefecture	Ngari Prefecture
Du Wei	Du Wei
Ranger 2	Ranger 2
Quảng Ngãi Province	Quảng Ngãi Province
List of Ottoman Sultans	List of sultans of the Ottoman Empire
Scuderia Ferrari	Scuderia Ferrari
Connecticut River	Connecticut River
Claude Makelele	Claude Makélélé
William Chan	William Chan
Vince Cable	Vince Cable
World Championships in Athletics	IAAF World Championships in Athletics
esbjerg	Esbjerg
John Curtin	John Curtin
Rolling star	Rolling Star
Petro Bagdoglio	Pietro Badoglio
Far away	Far Away
Zhongshan	Zhongshan
The British Monarch	Monarchy of the United Kingdom
Khabarovsk Krai	Khabarovsk Krai
Ivy Bridge	Ivy Bridge
Altai Republic	Altai Republic
Sendai City	Sendai
Ali Abdullah Saleh	Ali Abdullah Saleh
Lost	Lost
Hung Up	Hung Up
Madam Cutie On Duty	Madam Cutie On Duty
Julie Bishop	Julie Bishop
197374 European Cup Winners Cup	197374 European Cup Winners Cup
Haixi Mongolian and Tibetan Autonomous Prefecture	Haixi Mongol and Tibetan Autonomous Prefecture
Sichuan University	Sichuan University
The Hague	The Hague
Wanli Emperor	Wanli Emperor
App Store	App Store
Jules Bianchi	Jules Bianchi
The OC	The OC
Nexus 7	Nexus 7
Apple A9	Apple A9
Vernal Utah	Vernal Utah
Ruth Bader Ginsberg	Ruth Bader Ginsburg
Sakhalin	Sakhalin
AuvergneRhôneAlpes	AuvergneRhôneAlpes
Peking University	Peking University
Iron Man	Iron Man
Emile Borrell	Émile Borel
Pohnpei	Pohnpeian language
Stéphane Mallarmé	Stéphane Mallarmé
Jungo Fujimoto	Jungo Fujimoto
Cristiano Zanetti	Cristiano Zanetti
Niki Minaj	Nicki Minaj
starwars	Star Wars
Suzhou City	Suzhou
Ranieri Maria Gaetano	Prince Ranieri Duke of Castro
Luoyang	Luoyang
Dischord Records	Dischord Records
George IV	George IV of the United Kingdom
New Caledonia	New Caledonia
Parc des Princes	Parc des Princes
Hammarby Fotboll	Hammarby Fotboll
Gaythorne	Gaythorne Queensland
Azerbaijani	Azerbaijanis
Sir Reginald Edward Stubbs GCMG	Reginald Edward Stubbs
Spitzer Space Telescope	Spitzer Space Telescope
Coquitlam	Coquitlam
Battle of Ngọc HồiĐống Đa	Battle of Ngọc HồiĐống Đa
Shin Hyungmin	Shin Hyungmin
Carlos Tevez	Carlos Tevez
Jules Verne	Jules Verne
Libyan National Transitional Council	National Transitional Council
Flea	Flea
Pope Victor III	Pope Victor III
Astana	Astana
Yunfu	Yunfu
Cabuyao	Cabuyao
Emerson College	Emerson College
Hashemites	Hashemites
munsterprovince	Munster
Lima United	Alianza Lima
Serik Akhmetov	Serik Akhmetov
Toyota City	Toyota Aichi
Ronald Coase	Ronald Coase
Love so sweet	Love So Sweet
Stoke City Football Club	Stoke City FC
Solar Dynamics Observatory	Solar Dynamics Observatory
Liu Shoucheng	Liu Shoucheng
Mohammad Anwar Sadat	Anwar Sadat
INTERPOL	Interpol
Pope Severinus	Pope Severinus
Ada Choi	Ada Choi
Elizabeth II	Elizabeth II
Bernhard Prince of SaxeMeiningen	Bernhard Prince of SaxeMeiningen
Tom Elliott	Tom Elliott
Top Gear	Top Gear
GeGeGe no Nyōbō	GeGeGe no Nyōbō
redwood city	Redwood City California
Real Mallorca Athletic	RCD Mallorca
Laibin	Laibin
SDN48	SDN48
AMD Radeon Rx 200	AMD Radeon Rx 200 series
Shyu Jongshyong	Shyu Jongshyong
UK House of Commons	House of Commons of the United Kingdom
Baba Rahman	Baba Rahman
Marco Divoyo	Marco Di Vaio
Romansh	Romansh language
Yemen	Yemen
Tim Howard	Tim Howard
Dejavu	Dejavu
Mexico	Mexico
Jacqueline Kennedy Onassis	Jacqueline Kennedy Onassis
Lyon	Lyon
Tong Liya	Tong Liya
salt lake city	Salt Lake City
Gordon Sprigg	Gordon Sprigg
2014 AFC Presidents Cup	2014 AFC Presidents Cup
Alcalá de Henares	Alcalá de Henares
Stanislaw Mikovajczyk	Stanisław Mikołajczyk
Katsura Tarō	Katsura Tarō
Hashire Bicycle	Hashire Bicycle
PuXian Min	PuXian Min
Newcastle Jets Football Club	Newcastle Jets FC
Koshima Haruna	Haruna Kojima
croatia	Croatia
Ding Aung Min U	Tin Aung Myint Oo
Vincent Wong	Vincent Wong
Jeremy Bentham	Jeremy Bentham
Ich will	Ich will
American Samoa	American Samoa
Anos Fogg Rasmussen	Anders Fogh Rasmussen
Kagayaku Tsuki no Yō ni	Kagayaku Tsuki no Yō ni
Mayor of New Taipei City	Mayor of New Taipei
Nong Duc Manh	Nông Đức Mạnh
Tự Đức	Tự Đức
Kevin Doyle	Kevin Doyle
Nereu Ramos	Nereu Ramos
Princess Iman Bint Hussein	Princess Iman bint Hussein
nevada	Nevada
2013 AFC Presidents Cup	2013 AFC Presidents Cup
Mohammad Natsir	Mohammad Natsir
hard rock	Hard rock
Campeonato Paulista	Campeonato Paulista
Nokia Lumia 800	Nokia Lumia 800
Akihiro Ienaga	Akihiro Ienaga
J7	Chengdu J7
Michael Spence	Michael Spence
Chrome OS	Chrome OS
Jeffrey Chaucer	Geoffrey Chaucer
Senjūrō Hayashi	Senjūrō Hayashi
CurtisWright Company	CurtissWright
Wang Feng	Wang Feng
Tigrinya	Tigrinya language
From the Bottom of My Broken Heart	From the Bottom of My Broken Heart
Tom Hiddleston	Tom Hiddleston
Indiana Pacers	Indiana Pacers
The Hippocratic Crush II	The Hippocratic Crush ll
Auburn University	Auburn University
Patrick Kisnowbo	Patrick Kisnorbo
University of Texas at Austin	University of Texas at Austin
Exeter City Football Club	Exeter City FC
US Virgin Islands	United States Virgin Islands
Nagano	Nagano Prefecture
WatchOS	WatchOS
Serbia National Football Team	Serbia national football team
Qingdao Zhongneng Football Club	Qingdao Jonoon FC
Paisley Wu	Paisley Wu
Children of Bodom	Children of Bodom
20142015 Europa League	201415 UEFA Europa League
Luis Guillermo Solis	Luis Guillermo Solís
Body Feels EXIT	Body Feels Exit
Roscoe H Hillenkoetter	Roscoe H Hillenkoetter
Leonid Ilyich Brezhnev	Leonid Brezhnev
Stanford University	Stanford University
Antiochus III the Great	Antiochus III the Great
2	2
David Sainsbury Baron Sainsbury of Turville	David Sainsbury Baron Sainsbury of Turville
Progressive metal	Progressive metal
Matisyahu	Matisyahu
Alexander Millerand	Alexandre Millerand
Continuum	Continuum
Flo Rida	Flo Rida
Jaysh alIslam	Jaysh alIslam
Shakira	Shakira
Keith Newton	Keith Newton
Michihiro Yasuda	Michihiro Yasuda
Mark Overmars	Marc Overmars
Lee Yingyuan	Lee Yingyuan
Zalman Shazar	Zalman Shazar
Fukushima Fukushima	Fukushima Fukushima
Tham alphabet	Tai Tham alphabet
New York Knicks	New York Knicks
Tajiri Tomomi	Satoshi Tajiri
The Third Crusade	Third Crusade
Adult Swim	Adult Swim
Kliment Yefremovich Voroshilov	Kliment Voroshilov
Slavoljub Muslin	Slavoljub Muslin
Nicolae Rădescu	Nicolae Rădescu
Brazilian Navy	Brazilian Navy
Yuan Quan	Yuan Quan
OHare International Airport	OHare International Airport
England Football Isthmian League	Isthmian League
Ali Khamenei	Ali Khamenei
Halo	Halo
Warringa Council	Warringah Council
Liev Schreiber	Liev Schreiber
SouthendonSea	SouthendonSea
Southern All Stars	Southern All Stars
Manchester United Football Club	Manchester United FC
Liza Wang	Liza Wang
Huizhou Chinese	Huizhou Chinese
Mahatma Gandhi	Mahatma Gandhi
EA Canada	EA Canada
brooklynnets	Brooklyn Nets
River of Wine	River of Wine
Japan Airlines	Japan Airlines
Yokkaichi City	Yokkaichi Mie
Eurostar	Eurostar
Reise Reise	Reise Reise
Giovanni Lanza	Giovanni Lanza
Darío Cvitanich	Darío Cvitanich
George Zweig	George Zweig
Hawaii Territory	Territory of Hawaii
Pisa	Pisa
RhaetoRomance languages	RhaetoRomance languages
Milan Susak	Milan Susak
Jules Henri Poincaré	Henri Poincaré
Dick Cheney	Dick Cheney
CROSS GENE	Cross Gene
Dalton McGuinty	Dalton McGuinty
Artaxerxes I of Persia	Artaxerxes I of Persia
Hussein Fatemi	Hossein Fatemi
Josh Singer	Josh Singer
Smenkhkare	Smenkhkare
Sikkim	Sikkimese language
Murad II	Murad II
Nexus Player	Nexus Player
Paul Sousa	Paulo Sousa
San Martin del Reorellio	San Martín del Rey Aurelio
Dashu District	Dashu District
Arizona	Arizona
Henry Addington 1st Viscount Sidmouth	Henry Addington 1st Viscount Sidmouth
Yiling Yangtze River Bridge	Yiling Yangtze River Bridge
Bettino Craxi	Bettino Craxi
Yuri Zhirkov	Yuri Zhirkov
Sofia	Queen Sofía of Spain
Lisco	Lisco Nebraska
Fabricio dos Santos Messias	Fabrício dos Santos Messias
Joseph Bonaparte	Joseph Bonaparte
Panathinaikos Football Club	Panathinaikos FC
Left Front	Left Front
Ōita Ōita	Ōita Ōita
Lo Chihen	Lo Chihen
Gennaro Gattuso	Gennaro Gattuso
Lon Nol	Lon Nol
Indiana	Indiana
Edward J McDermott	Edward J McDermott
Grand Duchy of MecklenburgSchwerin	Grand Duchy of MecklenburgSchwerin
Ali Lahayed	Ali Laarayedh
National Institute of Statistics	National Institute of Statistics
Cheltenham	Cheltenham
Scunthorpe United Football Club	Scunthorpe United FC
Henry Bergson	Henri Bergson
Swahili	Swahili language
Princeton University	Princeton University
Epic Games	Epic Games
Kenix Kwok	Kenix Kwok
Claudio Bravo	Claudio Bravo
bayinchaolu	Bayanqolu
London Underground	London Underground
Rockstar Toronto	Rockstar Toronto
Didier Zokora	Didier Zokora
Parlophone	Parlophone
Xiang language	Xiang Chinese
Azores	Azores
Emil Hácha	Emil Hácha
BBC America	BBC America
Southern Rhodesia	Southern Rhodesia
Yoo Hojeong	Yoo Hojeong
halmstad	Halmstad
Yellow River	Yellow River
Albanian Party of Labour	Party of Labour of Albania
Caleb Gusheng	Caleb Cushing
Takamura Masahiko	Masahiko Kōmura
Wonder Girls	Wonder Girls
Mongol Peoples Army	Mongolian Peoples Army
Sunderland Tyne and Wear	Sunderland Tyne and Wear
Princess Iman bint Abdullah	Princess Iman bint Abdullah
Chung Kingfai	Chung Kingfai
Edmund Burke	Edmund Burke
Pascal Zuberbühler	Pascal Zuberbühler
Kim Taeyeon	Kim Taeyeon
Kadmad	Kadima
Dreams Metro Gallery FC	Dreams Metro Gallery FC
Mesut Yilmaz	Mesut Yılmaz
Yu Tao	Yu Tao
Two and a Half Men	Two and a Half Men
Mein Herz brennt	Mein Herz brennt
James R Hindman	James R Hindman
Lee Hyun Woo	Lee Hyunwoo
Jack Shephard	Jack Shephard
BOLERO	Bolero
Doctor Who	Doctor Who
Allen Lee	Allen Lee
Russian Republic	Russian Republic
Jalan Besar Stadium	Jalan Besar Stadium
Justo Villar	Justo Villar
Gō	Gō
David Coulthard	David Coulthard
LOVE  TRUTH	Love  Truth
Koki Yonekura	Koki Yonekura
Whitney Houston	Whitney Houston
Tang Fei	Tang Fei
Louis Antoine Duke of Angoulême	Louis Antoine Duke of Angoulême
Jin Yangyang	Jin Yangyang
Olof Melberg	Olof Mellberg
Davide Santon	Davide Santon
University of Minnesota	University of Minnesota
JeanMarc Herrault	JeanMarc Ayrault
B language	B
Trust Territory of the Pacific Islands	Trust Territory of the Pacific Islands
Wilhelmina	Wilhelmina of the Netherlands
Sledgehammer Games	Sledgehammer Games
Mirza Nasrallah Khan	Mirza Nasrullah Khan
Li Lisan	Li Lisan
Nakaharaku	Nakaharaku Kawasaki
Victoria Song	Victoria Song
Chelsea Township	Chelsea Township Butler County Kansas
Du Wenhui	Du Wenhui
Lee Cheukyan	Lee Cheukyan
Wang Shouting	Wang Shouting
Terry Branstad	Terry Branstad
Henry Norris Russell	Henry Norris Russell
Satoshi Ohno	Satoshi Ohno
OH58 Kiowa reconnaissance helicopter	Bell OH58 Kiowa
Štark Arena	Kombank Arena
Vilnius	Vilnius
Gary Medel	Gary Medel
University of Strasbourg	University of Strasbourg
Hisakari Takashi	Takashi Hishikari
Queen Wei	Empress Wei
Rui Marques	Rui Marques
Argentine Primera División	Argentine Primera División
Need for Speed	Need for Speed
Jeju language	Jeju language
Haris Silajdžić	Haris Silajdžić
Cyprus National Football Team	Cyprus national football team
William Petty	William Petty
Starz	Starz
Suqian	Suqian
Cheung Po Chun	Cheung Po Chun
Shibuya Station	Shibuya Station
John Whittingdale	John Whittingdale
bruch	Bruges
Northern Sami	Northern Sami
Asche zu Asche	Asche zu Asche
Susanna Kwan	Susanna Kwan
Gille Deleuze	Gilles Deleuze
SpiderMonkey	SpiderMonkey
The Condor Heroes	The Return of the Condor Heroes
Virginia Military Academy	Virginia Military Institute
Heo Youngsaeng	Heo Youngsaeng
Mongols in China	Mongols in China
Queen Mary University of London	Queen Mary University of London
Yakut	Yakut language
Sangju Sangmu Football Club	Sangju Sangmu FC
Paul Cezanne	Paul Cézanne
Kiribati	Kiribati
County Kerry	County Kerry
Dark Epic	Epica
Kansai Johnny 8	Kanjani Eight
Wang Shangyuan	Wang Shangyuan
Fidesz	Fidesz
King Higashikueriya Minoruhiko	Prince Naruhiko Higashikuni
Stefano Fiore	Stefano Fiore
George MDallas	George M Dallas
Masaaki Toma	Masaaki Toma
Xiao Ke	Xiao Ke
Frank Drake	Frank Drake
Tokugawa Iesato	Tokugawa Iesato
Croatian Football League	Croatian First Football League
Empress Xiaodexian	Empress Xiaodexian
Jafar Panahi	Jafar Panahi
Uruguay	Uruguay
Harrow Shapley	Harlow Shapley
Lord Byron	Lord Byron
Shimon Peres	Shimon Peres
Dimitri Pladus	Dimitri Petratos
Emperor Ninkō	Emperor Ninkō
Xianfeng Emperor	Xianfeng Emperor
€	Euro
Zigong City	Zigong
Abdurrahim ElKeib	Abdurrahim ElKeib
karakalpak	Karakalpaks
Klaus Iohannis	Klaus Iohannis
Yisa Yu	Yisa Yu
Costinha	Costinha
Osama bin Laden death	Death of Osama bin Laden
Vulgar Latin	Vulgar Latin
Austria National Under21 Football Team	Austria national under21 football team
Malcolm IV	Malcolm IV of Scotland
The Simpsons	The Simpsons
New Mexico	New Mexico
Nagqu Region	Nagqu Prefecture
Rain	Rain
Hiratsuka	Hiratsuka Kanagawa
Felix Klein	Felix Klein
Azerbaijan	Azerbaijan
MenuetOS	MenuetOS
Super Junior Donghae  Eunhyuk	Donghae  Eunhyuk
French people	French people
198485 European Cup Winners Cup	198485 European Cup Winners Cup
Nicolas III	Pope Nicholas III
Eddie Feneke Adami	Eddie Fenech Adami
Venceslau Brás	Venceslau Brás
Chinese American	Chinese Americans
1989  UEFA Cup 90	198990 UEFA Cup
Rust	Rust
Klaus Waviret	Klaus Wowereit
Hugh Dawding  1st Baron Dawding	Hugh Dowding 1st Baron Dowding
EskimoAleutian	EskimoAleut languages
Office Girls	Office Girls
Moments	Moments
Harvard Law School	Harvard Law School
Mo Yan	Mo Yan
Zhao Ziyang	Zhao Ziyang
Kongo language	Kongo language
Tsugi no Ashiato	Tsugi no Ashiato
Fengtai County	Fengtai County
Kasper Gusk	Kasper Kusk
Giambatista Vico	Giambattista Vico
Vincent Siew	Vincent Siew
Santa Clara County	Santa Clara County California
Giuliano Amato	Giuliano Amato
Su Tsengchang	Su Tsengchang
University of Vilnius	Vilnius University
Naomi Fonner Gyllenhaal	Naomi Foner Gyllenhaal
Shanghai Stadium	Shanghai Stadium
After Forever	After Forever
Love Angel Music Baby	Love Angel Music Baby
Liang Sicheng	Liang Sicheng
shuttle	Space Shuttle
Return of the Jedi	Return of the Jedi
Tyne Castle Stadium	Tynecastle Stadium
E3 airborne early warning aircraft	Boeing E3 Sentry
Thomas CavrierSmith	Thomas CavalierSmith
Dennis Ritchie	Dennis Ritchie
RomanSeleucid War	RomanSeleucid War
Meizhou Meixian District Hakka Football Club	Meixian Hakka FC
The Hero Next Door	Neighborhood Hero
Huzhou	Huzhou
Lassana Diarra	Lassana Diarra
KV Oostende	KV Oostende
FriendFeed	FriendFeed
Shanghainese	Shanghainese
Nefertiti	Nefertiti
Besiktas Gymnastics Club	Beşiktaş JK
Grand Duchess Olga Nikolaevna of Russia	Grand Duchess Olga Nikolaevna of Russia
maryland	Maryland
Jilin City	Jilin City
Battle of Berlin	Battle of Berlin
Charlotte	Charlotte
XenophonZolotas	Xenophon Zolotas
Lee Yong	Lee Yong
Carl Jung	Carl Jung
Ben E King	Ben E King
Democratic	Democratic Party
Gary Chaw	Gary Chaw
Lazio	Lazio
Empress Xiaoci Gao	Empress Xiaocigao
Manchu alphabet	Manchu alphabet
Victor Borisovich Khristenko	Viktor Khristenko
Zhang Zhijun	Zhang Zhijun
VOICE	Voice
US 1st Cavalry Division	1st Cavalry Division
The Sweet Escape	The Sweet Escape
leicester	Leicester
Abdul Qada Qida	Abdul Kader Keïta
Perak	Perak
Eric Garcetti	Eric Garcetti
Carlos Adriano Sosa Cruz	Carlos Adriano de Sousa Cruz
Fabricio Coloccini	Fabricio Coloccini
Emperor Yang of Sui	Emperor Yang of Sui
Köbi Kuhn	Köbi Kuhn
Dilma Rousseff	Dilma Rousseff
Rodion Yakovlevich Malinovsky	Rodion Malinovsky
Pakistan TehreekeInsaf	Pakistan TehreekeInsaf
Columbia University	Columbia University
Rhythm zone	Rhythm Zone
Meuse	Meuse
Sundanese people	Sundanese people
Ostrava	Ostrava
Burmese alphabet	Burmese alphabet
Sams Town	Sams Town
Massimiliano Allegri	Massimiliano Allegri
Angela Chang	Angela Chang
Chen Gongbo	Chen Gongbo
Casino Royale	Casino Royale
Central Kalimantan	Central Kalimantan
Atayal	Atayal language
Toyoake Aichi	Toyoake Aichi
Elvis Tsui	Elvis Tsui
Eunhyuk	Eunhyuk
Malayalam	Malayalam
Kitasenju Station	KitaSenju Station
Urbano Latazzi	Urbano Rattazzi
John Hickenlooper	John Hickenlooper
Green River	Green River
Banja Luka Warriors Football Club	FK Borac Banja Luka
Prince Naruhito	Naruhito Crown Prince of Japan
Koja Muhammad Nizamiddin Pasha	Koca Mehmed Nizamüddin Pasha
Perfect Crime	Perfect Crime
Nozu Michitsura	Nozu Michitsura
West Himalayish	West Himalayish languages
William Hague	William Hague
The Voyage of the Dawn Treader	The Voyage of the Dawn Treader
Moderate Party	Moderate Party
East China Normal University	East China Normal University
Malik Mansour Mirza Shao Sartana	Malek Mansur Mirza Shoa OSaltaneh
20132014 Europa League	201314 UEFA Europa League
FC Bayern Munich	FC Bayern Munich
Lothar Rendulic	Lothar Rendulic
The Legend of Zelda Series	The Legend of Zelda
Christs Hospital	Christs Hospital
Latin Alphabet	Latin script
FA Cup	FA Cup
Dai Nana Shō Utsukushikutte Gomen ne	Dai Nana Shō Utsukushikutte Gomen ne
Moscow State University	Moscow State University
Taipei Metro Line 3	Taipei Metro Line 3
Chinese Canadian	Chinese Canadians
Leiden	Leiden
Ross McGormac	Ross McCormack
Chinese characters	Chinese characters
Emma Bonino	Emma Bonino
Time after time On the streets of falling flowers	Time After Time
Steven Ma	Steven Ma
Canary Islands	Canary Islands
Jeremain Lens	Jeremain Lens
Megumi Takamoto	Megumi Takamoto
Airbus A310	Airbus A310
Universities UK	Universities UK
Vichy France	Vichy France
Super Electronic Biochemical Man	Choudenshi Bioman
Ariège	Ariège
Wangchuck Dynasty	House of Wangchuck
KRC Genk	KRC Genk
FAMAS Assault Rifle	FAMAS
Cape Canaveral Air Force Station Space Launch Complex 41	Cape Canaveral Air Force Station Space Launch Complex 41
Latvian	Latvian language
Shenzhou II	Shenzhou 2
Richard Burton	Richard Burton
Ekstraklasa	Ekstraklasa
Aristotle	Aristotle
Maria Feodorovna	Maria Feodorovna
Virtual Console	Virtual Console
Boeing 36780	Boeing 36780
Stephen Ireland	Stephen Ireland
Jason Derulo	Jason Derulo
Angelababy	Angelababy
Sigmundur David Gunlaugsson	Sigmundur Davíð Gunnlaugsson
LINE	Line
Leslie Lamport	Leslie Lamport
Franklin County	Franklin County Washington
Sanchez Watt	Sanchez Watt
Wales	Wales
Park Geunhye	Park Geunhye
John McEwan	John McEwen
Jores Okore	Jores Okore
Cagliari Football Club	Cagliari Calcio
Huang Qifan	Huang Qifan
Nicholas Katzenbach	Nicholas Katzenbach
Bruno Alves	Bruno Alves
John de Robeck	John de Robeck
Negai ga Kanau Koro	Dareka no Negai ga Kanau Koro
Northern England Premier League	Northern Premier League
City of Canterbury	City of Canterbury
Manú	Manú
Harbin	Harbin
Colentis Paulista Sports Club	Sport Club Corinthians Paulista
Dean FCO	Dijon FCO
Toghon Temür	Toghon Temür
Ok Taecyeon	Ok Taecyeon
Malta	Malta
Faouzi Ghoulam	Faouzi Ghoulam
Belarus	Belarus
Kevin Cash	Kevin Cash
assam	Assam
Robert Gates	Robert Gates
Etolian War	Aetolian War
Lotus	Lotus
Cappadocia	Cappadocia
Islamic Republic of Iran Air Force	Islamic Republic of Iran Air Force
Echoes Silence Patience  Grace	Echoes Silence Patience  Grace
Wigan Athletic FC	Wigan Athletic FC
Israel national football team	Israel national football team
Republic of Macedonia	Republic of Macedonia
Carrie Lam	Carrie Lam
Tiny C Compiler	Tiny C Compiler
Ju Jihoon	Ju Jihoon
Mark Robson	Mark Robson
ALL MY BEST	All My Best
Thomas More	Thomas More
Kathy Chow	Kathy Chow
Hermann Emile Fischer	Hermann Emil Fischer
Ben Sass	Ben Sasse
Louisiana	Louisiana
Orange Marmalade	Orange Marmalade
Twilight	Twilight
The Iraq War	Iraq War
Shibuya	Shibuya
Ishak Pasha	Ishak Pasha
Jan Neruda	Jan Neruda
Wellington International Airport	Wellington International Airport
Neyagawa City	Neyagawa Osaka
Marilyn Manson	Marilyn Manson
Boleslav Football Club	FK Mladá Boleslav
Liberty Korea Party	Saenuri Party
Duke of Brittany	Arthur I Duke of Brittany
Fukuoka Prefecture	Fukuoka Prefecture
BBC Radio 2	BBC Two
Sheffield	Sheffield
red	Red
Biyani Straustrup	Bjarne Stroustrup
Sexy Free  Single	Sexy Free  Single
ava	Inwa
County Louth	County Louth
Broadwell Microarchitecture	Broadwell
Sima Zhao	Sima Zhao
US Army Rangers	United States Army Rangers
Kaohsiung International Airport	Kaohsiung International Airport
Cherie Blair	Cherie Blair
GNU Hurd	GNU Hurd
Henry Martin Robert	Henry Martyn Robert
Yeongjo of Joseon	Yeongjo of Joseon
University of Lausanne	University of Lausanne
Mehdi Goli Hidayat	Mehdi Qoli Hedayat
Limingshui Sports Team	Rimyongsu Sports Club
British Aerospace Systems	BAE Systems
Cao Xueqin	Cao Xueqin
List of counties in Missouri	List of counties in Missouri
Central African Republic	Central African Republic
Northern Formosan languages	Northern Formosan languages
Slash	Slash
Friedrich Schelling	Friedrich Wilhelm Joseph Schelling
Governor of Washington	List of Governors of Washington
Kayun Farmhouse Course	Craven Cottage
Armenia	Armenia
Henrik Ibsen	Henrik Ibsen
Sarpsborg 08 FF	Sarpsborg 08 FF
parachute	Parachutes
City TV	Talentvision
Roh Moohyun	Roh Moohyun
bangalore	Bangalore
Huang Shengyi	Huang Shengyi
Chinas Got Talent	Chinas Got Talent
Kuan Chungming	Kuan Chungming
Hu Chunhua	Hu Chunhua
The Empire Strikes Back	The Empire Strikes Back
Louis XVI	Louis XVI of France
Nawaz Sharif	Nawaz Sharif
James Beattie	James Beattie
Xichuan County	Xichuan County
Henry Clinton	Henry Clinton
Samsung Galaxy Note 101	Samsung Galaxy Note 101
Trần Đức Lương	Trần Đức Lương
F	F
Trickster	Trickster
Edward Shor	Edward Short Baron Glenamara
Bengali	Bengali alphabet
Zhou Xiaochuan	Zhou Xiaochuan
Zara Phillips	Zara Phillips
Foshan	Foshan
Edgar Davis	Edgar Davids
Dnipropetrovsk Football Club	FC Dnipro Dnipropetrovsk
Highs and Lows	Highs and Lows
Oshkosh	Oshkosh Nebraska
Marius Bilashko	Marius Bilașco
city of north vancouver	North Vancouver
University of Exeter	University of Exeter
Karel Popowski	Karel Poborský
Manuel Mejuto González	Manuel Mejuto González
JPN	JPN
Bruno Menegger	Bruno Meneghel
Joanjo Shelway	Jonjo Shelvey
Kevin Durant	Kevin Durant
Portimonense Athletic Club	Portimonense SC
Oxfordshire	Oxfordshire
Mao Anqing	Mao Anqing
DIE	DIE
Rene Viviani	René Viviani
John Tukey	John Tukey
Rong Hao	Rong Hao
Jack Black	Jack Black
Chatichai Choonhavan	Chatichai Choonhavan
Greenland	Greenland
If I Aint Got You	If I Aint Got You
Kim Joon	Kim Joon
Portugal under21 national football team	Portugal national under21 football team
Zhang Zuolin	Zhang Zuolin
Alexander Sergeyevich Pushkin	Alexander Pushkin
Sunjong of Korea	Sunjong of Korea
Chile National Football Team	Chile national football team
George Curzon 1st Marquis of Curzon of Kedleston	George Curzon 1st Marquess Curzon of Kedleston
Hispañola	Hispaniola
Yoran Persson	Göran Persson
John YBrown	John Y Brown
casper	Casper Wyoming
Saeima	Saeima
Royal Australian Navy	Royal Australian Navy
Yaya Touré	Yaya Touré
Nokia Lumia 520	Nokia Lumia 520
Thado Minsaw	Thado Minsaw
TVBSAsia	TVBSAsia
Yannis Varoufax	Yanis Varoufakis
bermuda	Bermuda
African Union	African Union
Oda Nobunaga	Oda Nobunaga
Hong Kong Federation of Trade Unions	Hong Kong Federation of Trade Unions
Ishikawa Naohiro	Naohiro Ishikawa
Toby Alderweireld	Toby Alderweireld
Brahmaputra River	Brahmaputra River
England Womens National Football Team	England womens national football team
Danny Brandt	Danny Blind
Thái Nguyên Province	Thái Nguyên Province
Hakka	Hakka Chinese
The Flash	The Flash
Bath	Bath Somerset
Sun Feifei	Sun Feifei
timorleste	East Timor
Lee Youngae	Lee Youngae
blackpool	Blackpool
Sherpa	Sherpa language
Amsterdam	Amsterdam
East Java	East Java
Simply Wonderful	Simply Wonderful
Scheme	Scheme
Regional Municipality of York	Regional Municipality of York
Nagasaki Success Pill	VVaren Nagasaki
Bangalore Football Club	Bengaluru FC
Xiangshan County Zhejiang	Xiangshan County Zhejiang
Windows Server 2003	Windows Server 2003
Girls  Peace	Girls  Peace
Beverly McLachlin	Beverley McLachlin
Marcus Aurelius	Marcus Aurelius
Wang Gengwu	Wang Gungwu
Nobel Prize in Physics	Nobel Prize in Physics
Chris Murphy	Chris Murphy
Tromso	Tromsø
Quebec French	Quebec French
Wang Yong	Wang Yong
SV Darmstadt 98	SV Darmstadt 98
Luang Phibun Songkham	Plaek Phibunsongkhram
North Sydney Council	North Sydney Council
Tahitian football team	Tahiti national football team
Zwolle	Zwolle
Diego Lugano	Diego Lugano
Kansas City Athletic Conference	Sporting Kansas City
Bangladesh President	President of Bangladesh
Fred Cheng	Fred Cheng
Alaungpaya	Alaungpaya
Andy Keoge	Andy Keogh
Prince Xavier of BourbonParma	Prince Xavier of BourbonParma
Penny Wong	Penny Wong
Tuvan	Tuvan language
CentaurusCentaur Launch Vehicle	AtlasCentaur
Tokyo	Tokyo
Passion	Passion
Fudan University	Fudan University
Serge Ignashevic	Sergei Ignashevich
Always and Ever	Always and Ever
Stuart Taylor	Stuart Taylor
Nguyễn Sinh Hùng	Nguyễn Sinh Hùng
Jan Antonescu	Ion Antonescu
Showtek	Showtek
Maid Sama	Maid Sama
Felipe Melo	Felipe Melo
Ignatius Loyola	Ignatius of Loyola
Abe Akie	Akie Abe
Paul Scorsese	Paul Scholes
Seo Taiji	Seo Taiji
PhotoRealistic RenderMan	RenderMan
CD Guadalajara	CD Guadalajara
Igbo	Igbo language
Timo Hildebrand	Timo Hildebrand
Howell Cobb	Howell Cobb
Farouq Legari	Farooq Leghari
Shanda Rhimes	Shonda Rhimes
Anthony Kennedy	Anthony Kennedy
Stanley Miller	Stanley Miller
Salford City FC	Salford City FC
Lubos Michael	Ľuboš Micheľ
Seemann	Seemann
Hajime Sugiyama	Hajime Sugiyama
NVIDIA GeForce 200	GeForce 200 series
SEASONS	Seasons
Yuki Kajiura	Yuki Kajiura
Ferdinand II of the Two Sicilies	Ferdinand II of the Two Sicilies
Oreille River	Pend Oreille River
Gustav Heinemann	Gustav Heinemann
Bengbu South Railway Station	Bengbu South Railway Station
Takahiro Matsumoto	Tak Matsumoto
Vladimir Mikhailovich Komarov	Vladimir Komarov
Shenzhou 8	Shenzhou 8
Samir Rifay	Samir Rifai
Mario Balotelli	Mario Balotelli
Balinese	Balinese language
Peter Phillips	Peter Phillips
zoetermeer	Zoetermeer
Frederick Prince of Hohenzollern	Frederick Prince of Hohenzollern
Loyola Marymount University	Loyola Marymount University
Penn Nouth	Penn Nouth
Jody WilsonRaybould	Jody WilsonRaybould
Transformers	Transformers
AEK Larnaca Football Club	AEK Larnaca FC
Prince Bernhard of LippeBiesterfeld	Prince Bernhard of LippeBiesterfeld
Envoy Aviation	Envoy Air
JAPONESQUE	Japonesque
Samsung Galaxy S4	Samsung Galaxy S4
Czechoslovak government in exile	Czechoslovak governmentinexile
Flash	Flash
Chris Watson	Chris Watson
Peter Crouch	Peter Crouch
Know nothing	Know Nothing
Edward Yang	Edward Yang
DreamWorks	DreamWorks
The Last Emperor	The Last Emperor
Trinity College Dublin	Trinity College Dublin
Hacı Pasha	Hacı Pasha
Pingdingshan	Pingdingshan
MASSIVE WONDERS	Massive Wonders
Austrian Empire	Austrian Empire
Straits Exchange Foundation	Straits Exchange Foundation
Navy Distinguished Service Medal	Distinguished Service Medal
Kalk Samen Kuri no Hana	Kalk Samen Kuri no Hana
Black Wind Grandma	Sky Witch
Gurung	Gurung language
Malaysian Islamic Party	PanMalaysian Islamic Party
Giovanni Giolitti	Giovanni Giolitti
Paul H ONeill	Paul H ONeill
Inner Mongolia Zhongyou FC	Nei Mongol Zhongyou FC
John JCrittenden	John J Crittenden
Superfly	Superfly
James Troisi	James Troisi
University at Buffalo	University at Buffalo
Beat It	Beat It
papua new guinea	Papua New Guinea
Revolver	Revolver
Royal Netherlands Army	Royal Netherlands Army
Xavier Bettel	Xavier Bettel
Arthur Fadden	Arthur Fadden
Ganges	Ganges
Winfield Scott Hancock	Winfield Scott Hancock
Android	Android
Wayne State University	Wayne State University
maine	Maine
Eric Shinseki	Eric Shinseki
Uli Hoeness	Uli Hoeneß
Arthur Conan Doyle	Arthur Conan Doyle
The Third Battle of Kharkiv	Third Battle of Kharkov
Malcolm III	Malcolm III of Scotland
United Kingdom Supreme Court	Supreme Court of the United Kingdom
Trần Thiếu Đế	Trần Thiếu Đế
Honolulu International Airport	Honolulu International Airport
Ken Hung	Ken Hung
Indian Grand Prix	Indian Grand Prix
Candy Chang	Candy Chang
Licinius	Licinius
Sakharov Prize	Sakharov Prize
Wish and Switch	Wish and Switch
Nurlan Balkimbayev	Nurlan Balgimbayev
Osasuna Athletic Club	CA Osasuna
Zhuang Jiajie	Zhuang Jiajie
He Yingqin	He Yingqin
Zhou Libo	Zhou Libo
Zhao Peng	Zhao Peng
Yokohama International Arena	International Stadium Yokohama
City of St Albans	City of St Albans
Confederation of Arab Football Associations	Union of Arab Football Associations
Shaoguan	Shaoguan
Stanko Todorov	Stanko Todorov
Worcester Massachusetts	Worcester Massachusetts
Wonderful Hands	Healing Hands
PSV Yan Haofen	PSV Eindhoven
A18 Wasp Fighter Attack	A18 Hornet
DebreziniVSC	Debreceni VSC
Thein Sein	Thein Sein
Chōfu Tokyo	Chōfu Tokyo
Oakland	Oakland California
Vincenzo Montella	Vincenzo Montella
Adolf Frederick	Adolf Frederick King of Sweden
springfield	Springfield Illinois
Prince Leopold	Prince Leopold Duke of Albany
CS Marítimo	CS Marítimo
Nancy Sit Ka Yin	Barn swallow
Tao Hong	Tao Hong
Kansas City Missouri	Kansas City Missouri
Zulfikar Ali Bhutto	Zulfikar Ali Bhutto
Zhang Zhen	Zhang Zhen
Hoshiarpur district	Hoshiarpur district
Koei Tecmo	Koei Tecmo
Ranger 5	Ranger 5
David I	David I of Scotland
Đắk Lắk	Đắk Lắk Province
Yihara Station	Maibara Station
Neil Collins	Neill Collins
French Ligue 1	Ligue 1
Colin Trevorrow	Colin Trevorrow
Jerry Brown	Jerry Brown
Donald Trump	Donald Trump
Emperor Bunmu	Emperor Monmu
Suki de Suki de Suki de Anata Dake ga	Anata Dake ga
NVIDIA GeForce 9	GeForce 9 series
Jake Peavy	Jake Peavy
List of vice premiers of the Republic of China	List of vice premiers of the Republic of China
BBC World News	BBC World News
Dudley Senanayake	Dudley Senanayake
Fahrenheit	Fahrenheit
University of Hull	University of Hull
Daryl Janmaat	Daryl Janmaat
FrenchPrussian War	FrancoPrussian War
Mark Furnet Monet	Marc Forné Molné
Alexander II of Russia	Alexander II of Russia
Vĩnh Long Province	Vĩnh Long Province
JeanAlain Boumsson	JeanAlain Boumsong
Pope Pius XII	Pope Pius XII
Alexander Ostrovsky	Alexander Ostrowski
Numancia Football Club	CD Numancia
Dutch Republic	Dutch Republic
Mustafa Abdul Jalil	Mustafa Abdul Jalil
Niccolò Machiavelli	Niccolò Machiavelli
AMD Athlon 64 X2	Athlon 64 X2
Tami Baldwin	Tammy Baldwin
One	One
Pierre Freyden	Pierre Frieden
Ezhou	Ezhou
Fabian Ernst	Fabian Ernst
Dr	Wild
NASA	NASA
Ali Habib Mahmood	Ali Habib Mahmud
George V of Hanover	George V of Hanover
Silvio Berlusconi	Silvio Berlusconi
IO Interactive	IO Interactive
Malaysian Chinese	Malaysian Chinese
Ministry of Foreign Affairs	Ministry of Foreign Affairs
Jordi Tarrés	Jordi Tarrés
Hokkaido Nippon Ham Fighter	Hokkaido NipponHam Fighters
Chewa language	Chewa language
James K Polk	James K Polk
Fly to the Sky	Fly to the Sky
Daniel Klapner	Daniel Kleppner
University of Detroit Mercy	University of Detroit Mercy
Lauda Airlines	Lauda Air
hernanes	Hernanes
United States dollar	United States dollar
Emperor Kogen	Emperor Kōgon
Kunnao Nayar	Kunal Nayyar
List of US Supreme Court justices	List of Justices of the Supreme Court of the United States
Nintendo Network	Nintendo Network
Rainer Maria Rilke	Rainer Maria Rilke
Joseph Visarionovich Stalin	Joseph Stalin
Bii	Bii
Lisa BrennanJobs	Lisa BrennanJobs
Timothy Dalton	Timothy Dalton
Tolai language	Tolai language
Northern Mariana Islands	Northern Mariana Islands
Burwood Council	Municipality of Burwood
Ronny Carlos da Silva	Ronny Carlos da Silva
Emirate of Jebel Shamar	Emirate of Jabal Shammar
Babe Ruth	Babe Ruth
ChienShiung Wu	ChienShiung Wu
Tabula Rasa	Tabula Rasa
P V Narasimha Rao	P V Narasimha Rao
Inabe	Inabe Mie
Kingdom of Castile	Kingdom of Castile
The Bourne Supremacy	The Bourne Supremacy
Real Brugge	Club Brugge KV
Minobu	Minobu Yamanashi
Nagano City	Nagano Nagano
SURREAL	Surreal
Jacques ChabonDelma	Jacques ChabanDelmas
AlArabi SC	AlArabi SC
Malaysia	Malaysia
Min	Min
Slavia Sports Club Prague	SK Slavia Prague
Wu Bangguo	Wu Bangguo
The Big Bang Theory	The Big Bang Theory
Maldives	Maldives
malibu	Malibu California
The Emperor of India	Emperor of India
Holler	Holler
Pat Toomey	Pat Toomey
Sass	Sass
Zbigniew Messner	Zbigniew Messner
Luo Senwen	Luo Senwen
Tian Gang	Gang Tian
Sheezus	Sheezus
Wojciech Szczesny	Wojciech Szczęsny
Peter II	Peter II of Yugoslavia
Black Sea	Black Sea
Zhaoqing	Zhaoqing
Socialist	Socialist Party
Free Democratic Party	Free Democratic Party
Henri Grand Duke of Luxembourg	Henri Grand Duke of Luxembourg
Fire Ambition 3	Burning Flame III
Zoran Milanovic	Zoran Milanović
Mahmud Pasha Angelović	Mahmud Pasha Angelović
All for You	All for You
Harold Holt	Harold Holt
Richard Nilay	Richard Naylor
Hong Kong	Hong Kong
Tang Zhongzong	Emperor Zhongzong of Tang
Robert Aikent	Robert Grant Aitken
ALL FOR YOU	All for You
DiVA	Diva
Charles Darwin	Charles Darwin
Bordeaux FC	FC Girondins de Bordeaux
Flavor Of Life	Flavor of Life
Yang Jiechi	Yang Jiechi
Leopold III	Leopold III of Belgium
BaalMamatyili	Bari Mamatil
Ryuhei Maruyama	Ryuhei Maruyama
Avila Province	Province of Ávila
Merry Streep	Meryl Streep
GE Aviation	GE Aviation
Infanta Cristina of Spain	Infanta Cristina of Spain
Nagai Kensuke	Kensuke Nagai
hawkesbury	City of Hawkesbury
CBS	CBS
Guatemala	Guatemala
University of Florida	University of Florida
Lee Jung Hyun	Lee Junghyun
Frederik Willem de Klerk	F W de Klerk
Miracles	Miracles
Prince Emmanuel	Prince Emmanuel of Belgium
Averroes	Averroes
North Sumatra	North Sumatra
UKISS	UKISS
Argentina National Football Team	Argentina national football team
Hongik University	Hongik University
Swipe Tap Love	Swipe Tap Love
SaxonyCoburgGotha	House of SaxeCoburg and Gotha
Hike Kamerlin Onnes	Heike Kamerlingh Onnes
Windows 10Mobile	Windows 10 Mobile
Xincai County	Xincai County
Xiao Yang	Xiao Yang
Key	Key
Boys Meet U	Boys Meet U
Michelle Obama	Michelle Obama
Gerard Ambassa Guy	Gerard Ambassa Guy
Tang Xuanzong	Emperor Xuanzong of Tang
Douglas MacArthur	Douglas MacArthur
Valais	Valais
Albert with Prince	Albert Prince Consort
City of Rockdale	City of Rockdale
2014 Chinese Football Association Cup	2014 Chinese FA Cup
HNK Hajduk Split	HNK Hajduk Split
Pope Eugene IV	Pope Eugene IV
The Borgia Family	House of Borgia
Osaka Flying Foot	Gamba Osaka
He Guoqiang	He Guoqiang
Holy See	Holy See
University of Utah	University of Utah
Luhansk Peoples Republic	Luhansk Peoples Republic
IW engine	IW engine
Zhuang Jing Huang Concubine	Imperial Noble Consort Zhuangjing
Mihai I	Michael I of Romania
Marcus Greiner	Markus Greiner
Kim Hyun Joong	Kim Hyunjoong
Lee Pace	Lee Pace
Oliver Kahn	Oliver Kahn
Ben Bernanke	Ben Bernanke
Funcinpec Party	FUNCINPEC
Alex Bogomolov	Alex Bogomolov Jr
He Yang	He Yang
Japanese Imperial Family	Imperial House of Japan
Disney Channel	Disney Channel
FM Towns	FM Towns
Mitsubishi Heavy Industries	Mitsubishi Heavy Industries
Natalie Bennett	Natalie Bennett
Jacques Rogge	Jacques Rogge
30 Rock	30 Rock
Ella Chen	Ella Chen
Paraguay War	Paraguayan War
Taliban	Taliban
Sony Xperia Z1	Sony Xperia Z1
Prime Minister of Algeria	Prime Minister of Algeria
University of Geneva	University of Geneva
Chu	Chu
Kym	Kym
Roman Road Lukagu	Romelu Lukaku
Mark Pryor	Mark Pryor
Gene Macun	Jean Makoun
Chiayi County	Chiayi County
Dai 2 Seichōki	Dai 2 Seichōki
Mari El	Mari El
Empress Jitō	Empress Jitō
Taiwan Railway Administration	Taiwan Railways Administration
Colombia	Colombia
West Ham United Football Club	West Ham United FC
south dakota	South Dakota
Oh Beomseok	Oh Beomseok
Princess Helena of Waldeck and Pyrmont	Princess Helena of Waldeck and Pyrmont
Queens of Diamonds and Hearts	Queens of Diamonds and Hearts
Evanston	Evanston Illinois
Victor Andreevich Yushchenko	Viktor Yushchenko
Chiang Weiling	Chiang Weiling
No3b	No3b
Nicola Rizzoli	Nicola Rizzoli
Thomas AHendricks	Thomas A Hendricks
Salmon P Chase	Salmon P Chase
Prince Caspian	Prince Caspian
2010 Winter Olympics	2010 Winter Olympics
Tatar	Tatar language
The Hound of the Baskervilles	The Hound of the Baskervilles
Infante Carlos Count of Montemolin	Infante Carlos Count of Montemolin
bahamas	The Bahamas
Mac OS X Leopard	Mac OS X Leopard
Swiss German	Swiss German
Rice University	Rice University
Tianjin Jingtie Locomotive Football Club	Jingtie Locomotive FC
Supreme Court of Canada	Supreme Court of Canada
Alex OxladeChamberlain	Alex OxladeChamberlain
Sydney CBD	Sydney central business district
Xperia	Sony Xperia
Marek Jankulovsky	Marek Jankulovski
Auguste Viktoria	Augusta Victoria of SchleswigHolstein
Zamslang Sambu	Jamsrangiin Sambuu
Abby Road	Abbey Road
Matthew Bellamy	Matt Bellamy
Ministry of Economic Affairs of Taiwan	Ministry of Economic Affairs
Vladimir Antonovich Ivashko	Vladimir Ivashko
Major League Soccer	Major League Soccer
Han Xue	Han Xue
SM Entertainment	SM Entertainment
Panama	Panama
Etienne Capoe	Étienne Capoue
Ju JinMo	Joo Jinmo
Mongolia	Mongolia
Chelyabinsk Region	Chelyabinsk Oblast
Christian Wilhelmsson	Christian Wilhelmsson
Saint Christopher and Nevis	Saint Kitts and Nevis
Peng Dehuai	Peng Dehuai
Resident Evil 2	Resident Evil 2
Edmond Husserl	Edmund Husserl
Iowa State University	Iowa State University
Bedtime Stories	Bedtime Stories
Prime Minister of Malaysia	Prime Minister of Malaysia
Osgir Osgirson	Ásgeir Ásgeirsson
Jin Yong	Jin Yong
Ai no Uta	Ai no Uta
Miami FC	Miami FC
Li Fang	Li Fang
KAELA Kimura	Kaela Kimura
Sawada Kenji	Kenji Sawada
Rogers Centre	Rogers Centre
Chile	Chile
Workable Football Club	Workable FC
Astro Hua Hee Dai	Astro Hua Hee Dai
mostar	Mostar
Edison Perea	Edixon Perea
Dinamo Moscow Football Club	FC Dynamo Moscow
1st SS Panzer Division Leibstandarte SS Adolf Hitler	1st SS Panzer Division Leibstandarte SS Adolf Hitler
Stangrim Hermansson	Steingrímur Hermannsson
Ebbsfleet United FC	Ebbsfleet United FC
North Korea National Football Team	North Korea national football team
Later Han	Later Han
Francis Gerard Brennan	Gerard Brennan
DFB Cup 20152016	201516 DFBPokal
Ulanara the Step Empress	Ulanara the Step Empress
Vorbis	Vorbis
DreamWorks Animation	DreamWorks Animation
George Bull	George Boole
Nhà Lý	Lý dynasty
Xinzhuang District	Xinzhuang District
Multan	Multan
Félix Gaillard	Félix Gaillard
Embolo	Breel Embolo
Michael Carrick	Michael Carrick
Alec Su	Alec Su
Toyota Dyna	Toyota Dyna
Cecile Rhodes	Cecil Rhodes
Orestis Karnezis	Orestis Karnezis
Virgin Records	Virgin Records
MUSIC STATION	Music Station
Cardiff City Stadium	Cardiff City Stadium
Lucien Goian	Lucian Goian
President of Tunisia	President of Tunisia
Vietnam	Vietnam
Feel my mind	Feel My Mind
Prince Octavian	Prince Octavius of Great Britain
Jim Nicholson	Jim Nicholson
Leonardo Bonucci	Leonardo Bonucci
John L Helm	John L Helm
UKIP	UK Independence Party
Greys Anatomy	Greys Anatomy
David Julius	David Julius
Shah Alam II	Shah Alam II
Paul Chan Mopo	Paul Chan Mopo
Hasin Yebada	Hassan Yebda
Bo Gu	Bo Gu
Shanghai	Shanghai
Basque Country	Basque Country
Uya Morvisen	Yura Movsisyan
Weldon Santos de Andrade	Weldon
Old Persian	Old Persian
Taejo of Joseon	Taejo of Joseon
Ongaku Gatas	Ongaku Gatas
Romania Kingdom	Kingdom of Romania
St Pauls College Hong Kong	St Pauls College Hong Kong
ItalianCanadian	Italian Canadians
J D Salinger	J D Salinger
Thai Chinese	Thai Chinese
Rene Coty	René Coty
suffolk	Suffolk
Cen Chunxuan	Cen Chunxuan
Luis Botha	Louis Botha
Coptic	Coptic language
Meizhou Hakka FC	Meizhou Hakka FC
Bob Riley	Bob Riley
David Lange	David Lange
Plastic Ono Band	Plastic Ono Band
North Macedonia national football team	Macedonia national football team
Hestia	Hestia
Muse Band	Muse
Supreme Peoples Assembly	Supreme Peoples Assembly
Christian Democrats	Christian Democrats
Chen Haowei	Chen Haowei
Max von Laue	Max von Laue
Halina Tam	Halina Tam
Kimaki Kawamura	Kawamura Kageaki
Atchison  Topeka and Santa Fe Railroad	Atchison Topeka and Santa Fe Railway
RocknRoll Circus	Rock n Roll Circus
Oscar Klein	Oskar Klein
Slow Boat Home	Slow Boat Home
Real Sociedad	Real Sociedad
Irish War of Independence	Irish War of Independence
Northrop Grumman E2 Hawkeye	Northrop Grumman E2 Hawkeye
Arizona Administrative Divisions	List of counties in Arizona
Awk	AWK
Kaykhusraw II	Kaykhusraw II
Yoshimasa Hayashi	Yoshimasa Hayashi
Fang Jingqi	Fang Jingqi
Linyi	Linyi
folk metal	Folk metal
jaws	Great white shark
rince Felix of BourbonParma	Prince Felix of BourbonParma
England Football Southern League	Southern Football League
Kangxi Emperor	Kangxi Emperor
Kering Group	Kering
Katsushikaku	Katsushika
COME WITH ME	Come with Me
Irtysh	Irtysh River
HolsteinGortop dynasty	House of HolsteinGottorp
Frederick Lugard 1st Baron Lugard	Frederick Lugard 1st Baron Lugard
Governor of Canada	Governor General of Canada
Charles the Bald	Charles the Bald
Laurent Koscielny	Laurent Koscielny
Zhu Mimi	Mimi Chu
China Eastern Airlines	China Eastern Airlines
Henry II	Henry II of France
Michael Attia	Michael Atiyah
Sanskrit	Sanskrit
GNU Compiler Collection	GNU Compiler Collection
Yiddish	Yiddish
Charleston South Carolina	Charleston South Carolina
Susan Tse	Susan Tse
Sorbian	Sorbian languages
Seokho Hwang	Hwang Seokho
Order of the Garter	Order of the Garter
AlGharafa SC	AlGharafa Sports Club
GDragon	GDragon
Gegeen Khan	Gegeen Khan
John XVIII	Pope John XVIII
ONE LIFE	One Life
campinas	Campinas
Nelson Rockefeller	Nelson Rockefeller
DIAMOND WAVE	Diamond Wave
MuhammadReza Rahimi	Mohammad Reza Rahimi
Nenê	Nenê
Veronica	Veronica TV
Paulinho	Paulinho
Cynthia Ramis	Cynthia Lummis
Saitama 2002 Stadium	Saitama Stadium 2002
BTOB	BtoB
Andre Bikay	André Bikey
The Big Bang Theory	The Big Bang Theory
Lleida	Lleida
Russian Civil War	Russian Civil War
Citroen Senna	Citroën Xsara
Gloria MacapagalArroyo	Gloria Macapagal Arroyo
Annie Chen	Annie Chen
Li Ruihuan	Li Ruihuan
CharlotteWasp	Charlotte Hornets
Kandai Sipandon	Khamtai Siphandon
Ubuntu	Ubuntu
Homeland Union	Homeland Union
Keda Seiji	Seiji Kameda
Mark Udall	Mark Udall
Democritus	Democritus
Michael Fallon	Michael Fallon
JudaeoSpanish	JudaeoSpanish
Meng Jianzhu	Meng Jianzhu
Alberto Yeras Camargo	Alberto Lleras Camargo
2012 Summer Olympics	2012 Summer Olympics
Yi Bangja	Yi Bangja
Richard Z Kruspe	Richard Z Kruspe
British Chinese	British Chinese
Romualdo Pacheco	Romualdo Pacheco
Dutch East Indies Japanese Occupation Period	Japanese occupation of the Dutch East Indies
Málaga FC	Málaga CF
Stéphane Henchoz	Stéphane Henchoz
PortableAppscom	PortableAppscom
Timothy Pickering	Timothy Pickering
Internet Archive	Internet Archive
Game Center	Game Center
Lý Huệ Tông	Lý Huệ Tông
Thomas PelhamHollis 1st Duke of Newcastle	Thomas PelhamHolles 1st Duke of Newcastle
Hilda Solis	Hilda Solis
Secret of my heart	Secret of My Heart
Tatung FC	Tatung FC
Ray Wilkins	Ray Wilkins
Huaibin County	Huaibin County
Prime Minister of Yemen	Prime Minister of Yemen
Ananda Mahidol	Ananda Mahidol
Elder Postiga	Hélder Postiga
Lega Pro Prima Divisione	Lega Pro Prima Divisione
Otto	Otto of Bavaria
Alexander Kwasniewski	Aleksander Kwaśniewski
LionHearts	LionHearts
Frazer Richardson	Frazer Richardson
Ivan Krasnich	Ivan Klasnić
Incheon United Football Club	Incheon United FC
Skrillex	Skrillex
Xinxiang City	Xinxiang
Windows 10	Windows 10
Kharosthi	Kharosthi
Hakonemachi	Hakone
Breem Dzemaeli	Blerim Džemaili
Enrico Letta	Enrico Letta
Pashtun	Pashtuns
Bodan Paczynski	Bohdan Paczyński
Zaozhuang	Zaozhuang
George Martin	George Martin
Euphrates	Euphrates
Macao National Football Team	Macau national football team
War of the Reunions	War of the Reunions
Luo Zhijun	Luo Zhijun
Aidan Wedge	Aidan White
Gupta Dynasty	Gupta Empire
Chiayi	Chiayi
Obina	Obina
Dinamo Bucharest FC	FC Dinamo București
Anton Yugoff	Anton Yugov
George II	George II of Great Britain
Fuad II	Fuad II of Egypt
Kim Chiwoo	Kim Chiwoo
Alex Fong	Alex Fong
Suizhou	Suizhou
Epeli Nailatikau	Epeli Nailatikau
Ostrava Barnik Football Club	FC Baník Ostrava
Pat Hingle	Pat Hingle
Utsunomiya City	Utsunomiya
Kim Jongil	Kim Jongil
Sidney Coleman	Sidney Coleman
Princess Alexandra The Honourable Lady Ogilvy	Princess Alexandra The Honourable Lady Ogilvy
Song Wenjie	Song Wenjie
reunion	Réunion
Donetsk Miners Football Club	FC Shakhtar Donetsk
Emanuele Giaccherini	Emanuele Giaccherini
Taiwan video main frequency	TTV Main Channel
Andrei Andreevich Gromyko	Andrei Gromyko
symphonic metal	Symphonic metal
Lauri Christian Ryland	Lauri Kristian Relander
Nokia Lumia 735	Nokia Lumia 735
Portugal National Football Team	Portugal national football team
True Blood	True Blood
Dengeki Sentai Changeman	Dengeki Sentai Changeman
Pierluigi Colina	Pierluigi Collina
C919	Comac C919
Samuel Etoo	Samuel Etoo
Byzantine Empire	Byzantine Empire
Andy Hui	Andy Hui
Lincoln	Lincoln England
Daniel Forlander	Daniel Vorländer
United Workers Party of Poland	Polish United Workers Party
Chinas Got Talent	Chinas Got Talent
Taiji	Taiji
Georgetown University	Georgetown University
Grand Duchess Maria Nikolaevna of Russia	Grand Duchess Maria Nikolaevna of Russia
Joey Meng	Joey Meng
Shenzhen Football Club	Shenzhen FC
Kosovo	Kosovo
Billy Pait	Billy Paynter
Pierre van Hoydonck	Pierre van Hooijdonk
Kalakahua	Kalākaua
belize city	Belize City
Li Yuanchao	Li Yuanchao
Alvin Gentry	Alvin Gentry
ASEC Mimosa	ASEC Mimosas
Vassiliki Sanu	Vassiliki ThanouChristophilou
Urawa Red Diamonds	Urawa Red Diamonds
Ian Rush	Ian Rush
Arsinois IV	Arsinoe IV of Egypt
Marcel Proust	Marcel Proust
Leopold Carl Eduard Georg Albert	Charles Edward Duke of SaxeCoburg and Gotha
Carlo Emmanuel IV	Charles Emmanuel IV of Sardinia
zambia	Zambia
Jin Dongjin	Kim Dongjin
Hillary RodhamClinton	Hillary Clinton
Eugène de Beauharnais	Eugène de Beauharnais
Gil Vicente FC	Gil Vicente FC
Kwon Sang Woo	Kwon Sangwoo
shiraz	Shiraz
Plattville	Prattville Alabama
Oklahoma	Oklahoma
Thomas Callenberg	Thomas Kahlenberg
Tatsuya Tanaka	Tatsuya Tanaka
Xiaogang Distric	Siaogang District
GReeeeN	Greeeen
Israel Defense Forces	Israel Defense Forces
Democratic Rally	Democratic Rally
Rock and Roll	Rock and roll
Cheng Jeicheng	Cheng Jeicheng
Peoples Party for Freedom and Democracy	Peoples Party for Freedom and Democracy
The Secret Code	The Secret Code
Rotherham Football Club	Rotherham United FC
Oviedo	Oviedo
Kome Kome Club	Kome Kome Club
Luton	Luton
Udinese Football Club	Udinese Calcio
CSKA Moscow	PFC CSKA Moscow
Bobby	Bobby
Tracy Conan	Tracy Does Conan
Brian Schatz	Brian Schatz
Canada River	Canadian River
Yining Incident	Ili Rebellion
Odia language	Odia language
Sardinian	Sardinian language
Washington State	Washington
Puskas Ferenc	Ferenc Puskás
MY LONELY TOWN	My Lonely Town
BeijingKowloon Railway	BeijingKowloon Railway
Cixi	Cixi City
Louis the Pious	Louis the Pious
Morocco	Morocco
Claudio Caniggia	Claudio Caniggia
Adam Cheng	Adam Cheng
Ariel Lin	Ariel Lin
Alexis of Russia	Alexis of Russia
Kingdom of Sicily	Kingdom of Sicily
University of Birmingham	University of Birmingham
Valencia CF Mestalla	Valencia CF Mestalla
Stuttgart Football Club	VfB Stuttgart
Baron Chen	Baron Chen
Gulfstream G550	Gulfstream G550
Qashqai	Qashqai language
Kurage Nagareboshi	Kurage Nagareboshi
Red Storm Entertainment	Red Storm Entertainment
Maria Goeppert Meyer	Maria GoeppertMayer
Yanji	Yanji
PlayStation Vita	PlayStation Vita
Bảo Đại	Bảo Đại
Tony Brown	Tony Brown
Wars of InLaws II	Wars of InLaws II
Sony Xperia T	Sony Xperia T
Taichang Emperor	Taichang Emperor
Chuck Lorre	Chuck Lorre
krakow	Kraków
Yes	Yes
Jorge Andrade	Jorge Andrade
Jason Davidson	Jason Davidson
INFINITE	Infinite
Mischievous Kiss	Playful Kiss
Radical Entertainment	Radical Entertainment
Helle ThorningSchmidt	Helle ThorningSchmidt
Kayserispor	Kayserispor
Peachy Clover Z	Momoiro Clover Z
William Gladstone	William Ewart Gladstone
Amstelveen	Amstelveen
Lake Biwa	Lake Biwa
Virtues of Harmony	Virtues of Harmony
Maizuru	Maizuru
Miki Takeo	Takeo Miki
Shenzhou4	Shenzhou 4
John Maynard Keynes	John Maynard Keynes
CNN	CNN
CRY NO MORE	Cry No More
Pierre Louis Maupertuis	Pierre Louis Maupertuis
The 3rd Abdullah Cabinet	Third Abdullah cabinet
Vratislav Lokvenc	Vratislav Lokvenc
a Coruña	A Coruña
2014 Chinese Super League	2014 Chinese Super League
CFR Cluj Football Club	CFR Cluj
Seimas	Seimas
Lega Pro	Lega Pro
Kelly Ayotte	Kelly Ayotte
jeddah	Jeddah
Transcaucasian Socialist Federal Soviet Republic	Transcaucasian Socialist Federative Soviet Republic
Red Bull Salzburg	FC Red Bull Salzburg
Richard Ashcroft	Richard Ashcroft
Andrew Hughes	Andrew Hughes
Parti Socialiste	Parti Socialiste
Stabæk Fotball	Stabæk Fotball
Bae Yongjoon	Bae Yongjoon
Leopoldo Galtieri	Leopoldo Galtieri
Ho Kwok Chuen	Ho Kwok Chuen
Vasa Dynasty	House of Vasa
Girls Talk	Girls Talk
Jaime	Jaime Duke of Madrid
Nelson Mandela	Nelson Mandela
rwanda	Rwanda
Netherlands	Holland
Bowdoin College	Bowdoin College
Figaro Tseng	Figaro Tseng
Ageo Saitama	Ageo Saitama
Vandenberg Air Force Base	Vandenberg Air Force Base
William Astbury	William Astbury
Kitakyushu Airport	Kitakyushu Airport
Richard Graves MacDonnell	Richard Graves MacDonnell
Abdul Razak	Abdul Razak Hussein
Michael Malone	Michael Malone
Evergreen Mak Cheungching	Evergreen Mak Cheungching
Jack meets Dennis	Jack Meets Dennis
George Papadopoulos	Georgios Papadopoulos
Tobias Levels	Tobias Levels
Jiang Yihua	Jiang Yihuah
Northern Ireland Parliament	Northern Ireland Assembly
F22 Raptor	Lockheed Martin F22 Raptor
Daniel Van Buiten	Daniel Van Buyten
National Autonomous University Club	Club Universidad Nacional
Albacete Football Club	Albacete Balompié
Empress Xiaoherui	Empress Xiaoherui
Nicholas Cage	Nicolas Cage
Charles University Prague	Charles University in Prague
Queer III Arena	Quake III Arena
Hong Kong Island	Hong Kong Island
Jiuquan Satellite Launch Center	Jiuquan Satellite Launch Center
Jinsha River	Jinsha River
Ministry of Finance	Ministry of Finance
ShanghaiKunming Passenger Line	ShanghaiKunming HighSpeed Railway
Maggie Cheung	Maggie Cheung
Vlad Ferrat	Vlad Filat
Roque Santa Cruz	Roque Santa Cruz
Kate Beckinsale	Kate Beckinsale
Pope Sergius I	Pope Sergius I
Girls Generation	Girls Generation
rap metal	Rap metal
Wang Huning	Wang Huning
Bhumibol Adulyadej	Bhumibol Adulyadej
Komae City	Komae Tokyo
Manuel Neuer	Manuel Neuer
Microsoft Edge	Microsoft Edge
George Cartwright Marshall	George Marshall
Shaoyom Laszlo	László Sólyom
Empoli Football Club	Empoli FC
Chang Sancheng	Chang Sancheng
Matsumoto Masaki	Takeaki Matsumoto
Yunlin County	Yunlin County
Timmy Hung	Timmy Hung
Wang Jingwei	Wang Jingwei
Liberal Party	Liberal Party
John McDougall	John McDougall
Arthur Li	Arthur Li
Komi	Komi language
CR Vasco da Gama	CR Vasco da Gama
William IV of the United Kingdom	William IV of the United Kingdom
Falisk	Faliscan language
Krasnodar Football Club	FC Krasnodar
knuth	Donald Knuth
Edgar Rice Burroughs	Edgar Rice Burroughs
nigeria	Nigeria
Olav V	Olav V of Norway
Chang Wanquan	Chang Wanquan
Nagareboshi	Nagareboshi
Sebastian Kehl	Sebastian Kehl
Guo Jing	Guo Jing
Sammi Cheng	Sammi Cheng
North Vietnam	North Vietnam
Zurich Football Club	FC Zürich
Hokuzan	Hokuzan
David Tao	David Tao
Ibrahim Hakimi	Ebrahim Hakimi
Arsena Wenger	Arsène Wenger
Bob Hawke	Bob Hawke
Toy Story 3	Toy Story 3
The First Battle of Mohaci	Battle of Mohács
Windows 7	Windows 7
Adolphe Niel	Adolphe Niel
Georgian	Georgian language
wubai	Wu Bai
Jordan Henderson	Jordan Henderson
Ethan Ruan	Ethan Juan
Yongdeungpogu	Yeongdeungpo District
Richard Carpenter	Richard Carpenter
Google Web Toolkit	Google Web Toolkit
Danilo Soares	Danilo Soares
Groningen Football Club	FC Groningen
James McHenry	James McHenry
Mega Drive	Sega Genesis
Tabo Mbeki	Thabo Mbeki
Gordon Strachan	Gordon Strachan
Bình Định Province	Bình Định Province
Lily Allen	Lily Allen
Oscar Wilde	Oscar Wilde
Guo Guangchang	Guo Guangchang
Luo Wenjia	Luo Wenjia
Lang Son Province	Lạng Sơn Province
Toni Polster	Toni Polster
Red Star Awards 2000	Star Awards 2000
Greater Sudbury	Greater Sudbury
Devanagari	Devanagari
Edwin Keith Thomson	Edwin Keith Thomson
Wu Jing	Wu Jing
Baruch Spinoza	Baruch Spinoza
K2	K2
Silent Hill 3	Silent Hill 3
ARM architecture	ARM architecture
Imagali Nulgalievich Tasmagambetov	Imangali Tasmagambetov
Michael Mukasey	Michael Mukasey
Omar Bradley	Omar Bradley
Gita Wirjawan	Gita Wirjawan
Zineida Greciani	Zinaida Greceanîi
Lian Zhan	Lien Chan
Mike Oldfield	Mike Oldfield
Lukas Hinterseer	Lukas Hinterseer
Axis Powers	Axis powers
The Duke of Edinburgh	Duke of Edinburgh
Jagiellonian University	Jagiellonian University
Minatoku	Minato Tokyo
Chocolove from AKB48	Chocolove from AKB48
McFly	McFly
South Sudan	South Sudan
Okazaki City	Okazaki Aichi
Dearest	Dearest
Sami	Sami languages
SaintDenis Basilica	Basilica of St Denis
Francis I Holy Roman Emperor	Francis I Holy Roman Emperor
Bonamana	Bonamana
Fernando II of Aragon	Ferdinand II of Aragon
197273 European Cup Winners Cup	197273 European Cup Winners Cup
Valen Hsu	Valen Hsu
barbados	Barbados
Christine Ng	Christine Ng
Dalian Shide Team 4 and 5	Dalian Shide Siwu FC
Carlo Buonaparte	Carlo Buonaparte
Người Sán Chay	San Chay people
Alvaro Uribe Velez	Álvaro Uribe
Allianz Arena	Allianz Arena
County Antrim	County Antrim
Memphis Debby	Memphis Depay
World Health Organization	World Health Organization
Tauer Matan Ruak	Taur Matan Ruak
Tom Daschler	Tom Daschle
Atomic Heart	Atomic Heart
Charles Cornwallis 1st Marquess of Cornwallis	Charles Cornwallis 1st Marquess Cornwallis
Liaoning Hongyun Football Club	Liaoning Whowin FC
Sergey Aksyonov	Sergey Aksyonov
Virginia	Virginia
karnataka	Karnataka
Louis XV	Louis XV of France
Armenians	Armenians
SchleswigHolstein	SchleswigHolstein
Los Angeles Galaxy	LA Galaxy
Taiwan Austronesian Language	Formosan languages
RussoGeorgian War	RussoGeorgian War
Mass Effect 2	Mass Effect 2
Sayad Salihovic	Sejad Salihović
Altaic	Altaic languages
Bunun	Bunun language
Aligali Alphabet	Galik alphabet
Kyrgyzstan	Kyrgyzstan
John Canfield Spencer	John C Spencer
Soong Ailing	Soong Ailing
Syriza	Syriza
Joe Lieberman	Joe Lieberman
Dennis Rodman	Dennis Rodman
Ministry of Justice	Ministry of Justice
Justice League Dark	Justice League Dark
Lukacs Gyorgy	György Lukács
Marie Francois Sadie Cano	Marie François Sadi Carnot
Toshihiro Hattori	Toshihiro Hattori
Giancarlo Fisichella	Giancarlo Fisichella
Frank Murkowski	Frank Murkowski
Tianjin West Railway Station	Tianjin West Railway Station
James M Buchanan	James M Buchanan
Jonathan Morse	Jonathan Moss
Junkie XL	Junkie XL
Taboo	Taboo
Brazil National Football Team	Brazil national football team
Tom Hanks	Tom Hanks
French	French language
South Holland	South Holland
Sergey Arbuzov	Serhiy Arbuzov
Chrome Engine	Chrome Engine
Frederick Prince of Wales	Frederick Prince of Wales
Malay group	Malayic languages
Urayasu	Urayasu
Angel Beats	Angel Beats
Just Dance	Just Dance
Ellen Johnson Sirleaf	Ellen Johnson Sirleaf
Ivan Stepanovich Silaev	Ivan Silayev
Nogi Nogi	Nogi Maresuke
Bounty Lady	Bounty Lady
Wan Li	Wan Li
George Canning	George Canning
Hisham Gandil	Hesham Qandil
Pennsylvania	Pennsylvania
Belgium National Football Team	Belgium national football team
Peter Eisenman	Peter Eisenman
Togushi Timur	Uskhal Khan Tögüs Temür
Accra	Accra
Asturian	Asturian language
Tracy Ip	Tracy Ip
Xanthi FC	Skoda Xanthi FC
Ambassador of the United States to the Peoples Republic of China	United States Ambassador to China
Princess Teishi	Princess Teishi
IPod shuffle	IPod Shuffle
Shōso Strip	Shōso Strip
Odds BK	Odds BK
Ukrainian Soviet Socialist Republic	Ukrainian Soviet Socialist Republic
capetown	Cape Town
Dont cry anymore	Dont Cry Anymore
United Airlines	United Airlines
	
Kitty Perry	Katy Perry
JoJos Bizarre Adventure	JoJos Bizarre Adventure
Wu Zetian	Wu Zetian
Jiangsu Longkendia Basketball Club	Jiangsu Dragons
NEWS	News
Boertie	Börte
FC Barcelona	FC Barcelona
Valéry Giscard dEstaing	Valéry Giscard dEstaing
Chawari Yongchaiyu	Chavalit Yongchaiyudh
Roadshow Movies	Village Roadshow Pictures
Russian National Football Team	Russia national football team
David Villa	David Villa
Michael Jacksons This Is It	Michael Jacksons This Is It
Kawanehon	Kawanehon
Ernest Lawrence	Ernest Lawrence
Hairsekhli Ahmed Pasha	Hersekzade Ahmed Pasha
Simone Pepe	Simone Pepe
Kyra Sedgwick	Kyra Sedgwick
John VIII	Pope John VIII
J6 Fighter	Shenyang J6
Banhan Siba Acha	Banharn Silpaarcha
Luis Felipe Scolari	Luiz Felipe Scolari
Sofia Rotaru	Sofia Rotaru
George Bowen	George Bowen
Jersey City	Jersey City New Jersey
Qantas flight 32 accident	Qantas Flight 32
Tay people	Tay people
Mohammad Morsi	Mohamed Morsi
Goh Kun	Goh Kun
Robert Lewandowski	Robert Lewandowski
Marcelo Carrusca	Marcelo Carrusca
Central Commission for Discipline Inspection	Central Commission for Discipline Inspection
Heart Mind and Soul	Heart Mind and Soul
Surface Book	Surface Book
Tsu	Tsu Mie
Jingzhou	Jingzhou
Microsoft Lumia	Microsoft Lumia
Life Made Simple	Life Made Simple
AMD 10h	AMD 10h
Chen Shuibian	Chen Shuibian
Lothair I	Lothair I
1984 Summer Olympics	1984 Summer Olympics
Austronesian	Austronesian languages
Jiaxing	Jiaxing
funk	Funk
Alfred Domet	Alfred Domett
Midori Matsushima	Midori Matsushima
Best	Best
Hermann Staudinger	Hermann Staudinger
Philip Rahm	Philipp Lahm
Skylake	Skylake
Mudanjiang	Mudanjiang
Def Jam Records	Def Jam Recordings
Du Jia	Du Jia
Reginald Maudling	Reginald Maudling
Logrono	Logroño
Li Hongzhang	Li Hongzhang
Fat Charlie	Charles the Fat
Shiding District	Shiding District
John Milton	John Milton
TeX Live	TeX Live
Andreas Kubilius	Andrius Kubilius
David Trench	David Trench
UH1N Twin Huey Helicopter	Bell UH1N Twin Huey
Hu Zhijun	Hu Zhijun
Queens University at Kingston	Queens University
Portland Timber	Portland Timbers
grey magpie	Azurewinged magpie
PlayStation Studios	SCE Worldwide Studios
Fourth French Republic	French Fourth Republic
skane	Scania
Alistair Darling	Alistair Darling
Samsung Galaxy S III	Samsung Galaxy S III
Finntroll	Finntroll
Goth Metal	Gothic metal
Victor Li Tzarkuoi	Victor Li Tzarkuoi
Amman International Stadium	Amman International Stadium
Secret Garden	Secret Garden
Hara Takashi	Hara Takashi
Sora Uta	Sora Uta
I Will Survive	I Will Survive
Moscow	Moscow
Joleon Lescott	Joleon Lescott
University of Sussex	University of Sussex
England Football League 20112012	201112 Football League One
Okinawan	Okinawan language
Ali Ben Flis	Ali Benflis
Chinese Taipei Futsal Team	Chinese Taipei national futsal team
Yixuan Prince Chun	Yixuan Prince Chun
Rebecca Mader	Rebecca Mader
Apache Flex	Apache Flex
Queen	Queen
Cishan District	Cishan District
Judith Butler	Judith Butler
Kazan	Kazan
International Rugby Federation	World Rugby
Samsung Galaxy Note II	Samsung Galaxy Note II
Elano	Elano
Case Western Reserve University	Case Western Reserve University
LincolnAlexander	Lincoln Alexander
Isabel Princess Imperial of Brazil	Isabel Princess Imperial of Brazil
Jafar alSadiq	Jafar alSadiq
Arabic	Arabic
Jigoku Sensei Nūbē	Hell Teacher Nūbē
Novak Djokovic	Novak Djokovic
Otto Wallach	Otto Wallach
Carloman II	Carloman II
Hippolyto II Este	Ippolito II dEste
Saionji Kinmochi	Saionji Kinmochi
Philip Sharp	Phillip Allen Sharp
Kevin Nolan	Kevin Nolan
Calvin Chen	Calvin Chen
Rui Costa	Rui Costa
Ancient Greek	Ancient Greek
Black Entertainment Television	BET
Queensland	Enoggera Queensland
Incheon International Airport	Incheon International Airport
Pope Gregory VII	Pope Gregory VII
Geoffrey Rush	Geoffrey Rush
Greece	Greece
Po	Po
Do whatever you want	Do What U Want
Red Star Belgrade	Red Star Belgrade
Medical Top Team	Medical Top Team
Lidu Yangtze River Bridge	Lidu Yangtze River Bridge
Yamagata Prefecture	Yamagata Prefecture
Communist Party of Vietnam	Communist Party of Vietnam
Valdis Zartlers	Valdis Zatlers
Scotland Under21 Football Team	Scotland national under21 football team
Bahrain National Football Team	Bahrain national football team
Louis III	Louis III of France
Choulex	Choulex
William Wirt	William Wirt
Order of St Michael and St George	Order of St Michael and St George
Valenciennes	Valenciennes
Ernesto Geisel	Ernesto Geisel
Sacred Heart University	Sacred Heart University
Luís Fabiano	Luís Fabiano
Android Wear	Android Wear
200405 UEFA Cup	200405 UEFA Cup
National Assembly	National Assembly
Prince Claus	Prince Claus of the Netherlands
Ana Hidalgo	Anne Hidalgo
Limburg	Limburg
Johnny Marr	Johnny Marr
Führer	Führer
Georgian Soviet Socialist Republic	Georgian Soviet Socialist Republic
togo	Togo
Hau Lungpin	Hau Lungpin
Carl Linnaeus	Carl Linnaeus
Hirakawa	Hirakawa Aomori
Final Fantasy X	Final Fantasy X
Leigh Bromby	Leigh Bromby
They Dont Care About Us	They Dont Care About Us
Nerium	Nerium
Jon Kwangik	Jon Kwangik
Tie the Knot	Tie the Knot
Russell T Davies	Russell T Davies
University of Calcutta	University of Calcutta
Kenneth Kaunda	Kenneth Kaunda
Kingdom of Lithuania	Kingdom of Lithuania
Tony Hoare	Tony Hoare
Phil Dowd	Phil Dowd
Ruby	Ruby
Steam	Steam
General Dynamics F111 Aardvark	General Dynamics F111 Aardvark
Wladyslaw IV	Władysław IV Vasa
Chuck Yiu Kwok	Chuck Yiu Kwok
Liang Qichao	Liang Qichao
Oscar Luigi Scalfaro	Oscar Luigi Scalfaro
Palestinian National Authority	Palestinian National Authority
Lukas Podolski	Lukas Podolski
China Railway Corporation	China Railway
Sukhbaatar Butbold	Sükhbaataryn Batbold
Brian Tyler	Brian Tyler
United Arab Emirates National Football Team	United Arab Emirates national football team
MySecret	My Secret
Dan Sullivan	Dan Sullivan
Clifford Township	Clifford Township Butler County Kansas
Lisa Marie Presley	Lisa Marie Presley
Windows 95	Windows 95
The Headless Horseman Leaks DuRaRaRa	Durarara
Mexican First Empire	First Mexican Empire
French Third Republic	French Third Republic
Gokan Inle	Gökhan Inler
Egyptian hieroglyphs	Egyptian hieroglyphs
Youth Power	Youth Power
Tsubasa	Tsubasa
Allentown	Allentown Pennsylvania
Infante Jaime Duke of Segovia	Infante Jaime Duke of Segovia
Isa City Government	City of Mount Isa
Mario Monti	Mario Monti
Kwok Kin Pong	Kwok Kin Pong
reggae music	Reggae
Muhammad Yunas	Muhammad Yunus
girls playing with fire	The Girl Who Played with Fire
Manchester	Manchester Ohio
Nancy Reagan	Nancy Reagan
Jeffrey Wilkinson	Geoffrey Wilkinson
Botany Bay	City of Botany Bay
Nine Inch Nails	Nine Inch Nails
Vivian Hsu	Vivian Hsu
morioka city	Morioka
Scott Skiles	Scott Skiles
Khroskyabs	Khroskyabs language
Fukuoka City	Fukuoka
Punjabi	Punjabis
Han Gain	Han Gain
Miyazaki Tomohiko	Tomohiko Miyazaki
Sports Santander	Racing de Santander
County Offaly	County Offaly
Stinio Vincent	Sténio Vincent
Taki and Tsubasa	Tackey  Tsubasa
Charlotte Grand Duchess of Luxembourg	Charlotte Grand Duchess of Luxembourg
Punjabi	Punjabi language
Isido Rabbi	Isidor Isaac Rabi
Country Alexandra 2nd Duchess of Fife	Princess Alexandra 2nd Duchess of Fife
Mak Chaikwong	Mak Chaikwong
Hongkou Football Stadium	Hongkou Football Stadium
Surayud Chulanon	Surayud Chulanont
Dangerous	Dangerous
Assassins Creed Series	Assassins Creed
Crown Princess Masako	Masako Crown Princess of Japan
Mohammed VI	Mohammed VI of Morocco
Oliver Walcott Jr	Oliver Wolcott Jr
Watarirouka Hashiritai 7	Watarirouka Hashiritai 7
Nikkō	Nikkō Tochigi
LIFE	Life
Hawaii Five0	Hawaii Five0
Lee Hyori	Lee Hyori
Jim Risch	Jim Risch
The Great Eunuch	The Confidant
Cardiff City FC	Cardiff City FC
Friedrich Hayek	Friedrich Hayek
Modula3	Modula3
Eugene Shoemaker	Eugene Merle Shoemaker
Ptolemy IX Lathyros	Ptolemy IX Lathyros
Kumamoto City	Kumamoto
Catalan	Catalan language
alcoy	Alcoy Spain
Shkodran Mustafi	Shkodran Mustafi
Kingdom Hearts	Kingdom Hearts
Elena Kong	Elena Kong
Khutughtu Khan Kusala	Khutughtu Khan Kusala
Democratic Republic of Afghanistan	Democratic Republic of Afghanistan
Nobusuke Kishi	Nobusuke Kishi
Jung Ryeowon	Jung Ryeowon
HTC One S	HTC One S
Anthony van den Bore	Anthony Vanden Borre
Liu Chih	Liu Chih
Shannon Cole	Shannon Cole
Microsoft Mobile	Microsoft Mobile
Jiajing Emperor	Jiajing Emperor
Elton John	Elton John
Henan Province	Henan
Almaty Central Stadium	Almaty Central Stadium
Karma Rider	Karma Rider
Rob Mugabe	Robert Mugabe
Ryan McGovern	Ryan McGowan
Tomi Juric	Tomi Juric
CCTY4	CCTV4
Lies	Lies
Dnieper	Dnieper
Lee Woonjae	Lee Woonjae
avizi	Avusy
guildford	Guildford
Sylvia Lim	Sylvia Lim
Hubei Province	Hubei
Martine Aubry	Martine Aubry
Michael Owen	Michael Owen
Ferdinand I of the Two Sicilies	Ferdinand I of the Two Sicilies
Vincent Carter	Vincent Carter
Canal Macau	Canal Macau
Daniel Zitka	Daniel Zítka
TDM Ou Mun	TDM Ou Mun
Dương Văn Minh	Dương Văn Minh
Macau	Macau
Hebe Tien	Hebe Tien
Tokyo Station	Tokyo Station
Scottish National Football Team	Scotland national football team
Kang Min Hyuk	Kang Minhyuk
Third International	Communist International
Kenya	Kenya
Windows Movie Maker	Windows Movie Maker
Super JuniorHappy	Super JuniorH
Pope Pius X	Pope Pius X
Kenneth O Hall	Kenneth O Hall
Andias Isachen	Andreas Isaksson
Wishing On The Same Star	Wishing on the Same Star
Terry Frankner	Terry Francona
LatinoFaliscan languages	LatinoFaliscan languages
Gulf of Mexico	Gulf of Mexico
Order of StJohn	Order of Saint John
Li Xiaolu	Li Xiaolu
Epitasio da Silva Pessoa	Epitácio Pessoa
Boris Nemtsov	Boris Nemtsov
Akihabara Station	Akihabara Station
Mary I	Mary I of England
Christiano Ronaldo	Cristiano Ronaldo
Emperor Ichijō	Emperor Ichijō
Geoffrey Ma	Geoffrey Ma
Star Alliance	Star Alliance
Shenzhou 5	Shenzhou 5
Mongol invasions and conquests	Mongol invasions and conquests
HEAVEN	Heaven
Nabil Zhar	Nabil El Zhar
JeanPierre Serre	JeanPierre Serre
KLM	KLM
British East India Company	East India Company
EntertainmentWeekly	Entertainment Weekly
Silverstone	Silverstone Circuit
Adalvito dos Santos	Adalberto Pereira dos Santos
Lau Gar Ho	Lau Karho
Silesian language	Silesian language
Ryukyuan people	Ryukyuan people
Gabon National Football Team	Gabon national football team
1st Division	1st Division
KelantanPattani Malay	KelantanPattani Malay
Marilyn Manson	Marilyn Manson
Lau Wongfat	Lau Wongfat
Luther Van Nistelrooy	Ruud van Nistelrooy
Palmer United Party	Palmer United Party
Republic of China Foreign Trade Development Association	Taiwan External Trade Development Council
Malaysia Japanese Occupation Period	Japanese occupation of Malaya
Eleonora	Princess Eléonore of Belgium
John Tuzzo Wilson	John Tuzo Wilson
Juan Arango	Juan Arango
Ernest Augustus Duke of Brunswick	Ernest Augustus Duke of Brunswick
Sean WrightPhillips	Shaun WrightPhillips
AFC Bournemouth	AFC Bournemouth
Bengbu	Bengbu
Abdullah bin Khalifa Stadium	Abdullah bin Khalifa Stadium
Besart Berisha	Besart Berisha
Jeff Sessions	Jeff Sessions
My Prerogative	My Prerogative
Diwei Bridge	Diwei Bridge
Queen Sylvia	Queen Silvia of Sweden
Zhao Yuhao	Zhao Yuhao
HibernoEnglish	HibernoEnglish
Lee Seungyeoul	Lee Seungyeoul
Moksha	Moksha language
Never say die	Never Say Die
Ben Parker	Ben Parker
Sebastian Coates	Sebastián Coates
Mickaël Landreau	Mickaël Landreau
Troll	Teror
The Jackson Five	The Jackson 5
Arup	Arup Group
University of Munich	Ludwig Maximilian University of Munich
Team Goggles V	Dai Sentai GoggleV
Miwa	Miwa
Jung SoMin	Jung Somin
Æthelred the Unready	Æthelred the Unready
Communist Party of Romania	Romanian Communist Party
Savoie	Savoie
Qin Hailu	Qin Hailu
Kamel Janzuri	Kamal Ganzouri
Golden Eagle	Golden eagle
Sergei Semenovich Subyanin	Sergey Sobyanin
Visual Prolog	Visual Prolog
Caitlyn Jenner	Caitlyn Jenner
Isaac Newton	Isaac Newton
199192 UEFA Cup	199192 UEFA Cup
Tshangla language	Tshangla language
Chōjin Sentai Jetman	Chōjin Sentai Jetman
Isam Sharaf	Essam Sharaf
David Martin	David Martin
Presinge	Presinge
Flavius Valerius Severus	Flavius Valerius Severus
Bonaventure	Bonaventure
Bukit Jalil National Stadium	Bukit Jalil National Stadium
Philippines	Philippines
Gloucester	Gloucester
Okinawa Prefecture	Okinawa Prefecture
AMC	AMC
Weezer	Weezer
News of the World	News of the World
Zhao Liying	Zhao Liying
Martin Luther King	Martin Luther King Jr
Nouri alMaliki	Nouri alMaliki
Hassan II	Hassan II of Morocco
University of Chicago	University of Chicago
Shibukawa Gunma	Shibukawa Gunma
Alexander Fyodorovich Kerensky	Alexander Kerensky
Estadio de La Cartuja	Estadio de La Cartuja
Japan Womens National Soccer Team	Japan womens national football team
Old French	Old French
Olympique Lyonnais	Olympique Lyonnais
Tian Liang	Tian Liang
Liverpool	Liverpool
Han Han	Han Han
Hatoyama Ichiro	Ichirō Hatoyama
Team Honda	Honda in Formula One
Ha Yu	Ha Yu
Kelly Johnson	Kelly Johnson
William O Douglas	William O Douglas
Ko Wenje	Ko Wenje
Polish Prime Minister	Prime Minister of Poland
Republic of Ireland	Republic of Ireland
National Coalition Party	National Coalition Party
Richard Stallman	Richard Stallman
Sports Club Freiburg	SC Freiburg
Mitaka City	Mitaka Tokyo
Maggie Shiu	Maggie Shiu
County Galway	County Galway
Jero	Jero
Lithuania	Lithuania
Southland Football Club	Southern District FC
Kim Yongjun	Kim Yongjun
Manchester City Stadium	City of Manchester Stadium
Amdi Faye	Amdy Faye
Daniel Georgievski	Daniel Georgievski
Tempest	Tempest
Elland Road	Elland Road
Central African Franc	Central African CFA franc
Patna	Patna
Fujian Province	Fujian
Hong Kong First Division Football League	Hong Kong First Division League
201213 Hong Kong FA Cup	201213 Hong Kong FA Cup
Tuvan	Tuvans
Grace Wong	Grace Wong
PyrénéesOrientales	PyrénéesOrientales
Charles Grey 2nd Earl Grey	Charles Grey 2nd Earl Grey
San Marino	San Marino
Dominic Oduro	Dominic Oduro
Toomas Hendrik Ilves	Toomas Hendrik Ilves
Kuwait	Kuwait
Massachusetts State Capitol	Massachusetts State House
Tokugawa Yoshinobu	Tokugawa Yoshinobu
Kam Naiwai	Kam Naiwai
DzungarQing Wars	DzungarQing War
David Ospina	David Ospina
ChuHan War	ChuHan Contention
JAR	JAR
Nagaland	Nagaland
K R Narayanan	K R Narayanan
Qian Zhongshu	Qian Zhongshu
LArcenCiel	LArcenCiel
Edward Grey 1st Viscount Grey of Faroton	Edward Grey 1st Viscount Grey of Fallodon
Double Bay	Double Bay New South Wales
Hong Qigong	Hong Qigong
Rebecca Zhu	Rebecca Zhu
Pyrrhus War	Pyrrhic War
Maurice BourgetMonouli	Maurice BourgèsMaunoury
Olympiacos Football Club	Olympiacos FC
George S Patton	George S Patton
Giravanz Kitakyushu	Giravanz Kitakyushu
Britney	Britney
Lv Liping	Lü Liping
Just You	Just You
England Football Champions League	Football League Championship
Janet Yellen	Janet Yellen
Frederick Hopkins	Frederick Gowland Hopkins
Richard Holbrook	Richard Holbrooke
Governor of India	GovernorGeneral of India
Empress Xiao	Empress Xiao
Kazan	Kazan
John Glover Roberts	John Roberts
Hungary	Hungary
China Central Television	China Central Television
Thomas Corwin	Thomas Corwin
Louis McLean	Louis McLane
Michaëlle Jean	Michaëlle Jean
Gençlerbirliği SK	Gençlerbirliği SK
Belgium national under21 football team	Belgium national under21 football team
Franklin Charles Gimson	Franklin Charles Gimson
Bad	Bad
Edwin van der Sar	Edwin van der Sar
Pol Pot	Pol Pot
Genta Omotehara	Genta Omotehara
Charles Ethanji	Charles Itandje
Akita Akita	Akita Akita
Orhan Ghazi	Orhan of the Ottoman Empire
Madura	Madurese language
Murad I	Murad I
Jason Chan Chisan	Jason Chan Chisan
Manazuru Station	Manazuru Station
Geoffrey Howe	Geoffrey Howe
Kingdom of Prussia	Kingdom of Prussia
Ibrahim Pasha	Ibrahim Pasha of Egypt
Ditmar Harman	Dietmar Hamann
Ghazi ibn Faisal	Ghazi of Iraq
Bruno Powell	Bruno Bauer
Alia E Hussein	Alia alHussein
Philip Francis Thomas	Philip Francis Thomas
Minoru Yamasaki	Minoru Yamasaki
Frances Grey Duchess of Suffolk	Frances Grey Duchess of Suffolk
Royal Navy	Royal Navy
Pyongyang Sports Corps	Pyongyang City Sports Club
Brazilian Empire	Empire of Brazil
Nicole Keeman	Nicole Kidman
Qiao Shi	Qiao Shi
Invisible Woman	Invisible Woman
Cyndi Wang	Cyndi Wang
Theodor W Hänsch	Theodor W Hänsch
Minh Mạng	Minh Mạng
Natural	Natural
quark	Quark
Dipangkorn Rasmijoti	Dipangkorn Rasmijoti
Audi RSQ	Audi RSQ
Solomon Islands	Solomon Islands
Syria	Roman Syria
North Korea Football League	DPR Korea League
Jiro Wang	Jiro Wang
Leo Strauss	Leo Strauss
Girls Generation	Girls Generation
Socialist Peoples Republic of Albania	Peoples Socialist Republic of Albania
Ningbo	Ningbo
Maccabi Tel Aviv FC	Maccabi Tel Aviv FC
Prince Kusakabe	Prince Kusakabe
arnhem	Arnhem
Mariah Carey	Mariah Carey
Rochdale AFC	Rochdale AFC
Hiroki Yamada	Hiroki Yamada
Nissan March	Nissan Micra
Khitan	Khitan language
Océane Zhu	Océane Zhu
Ferhat Abbas	Ferhat Abbas
Boeing 777	Boeing 777
Mami Eisenhower	Mamie Eisenhower
SHINee	Shinee
Robin van Persie	Robin van Persie
Nanjing South Railway Station	Nanjing South Railway Station
Chaha MahalBakhtiari	Chaharmahal and Bakhtiari Province
Navarre	Navarre
Koori Fukushima	Koori Fukushima
Lincolnshire	Lincolnshire
borough of Strathfield	Municipality of Strathfield
Ange Postkoglu	Ange Postecoglou
Italian Serie B	Serie B
Sebastian Wood	Sebastian Wood
RussianJapanese War	RussoJapanese War
D language	D
clevelandindians	Cleveland Indians
PortauPrince	PortauPrince
Nguyen Van Nhan	Pierre Nguyễn Văn Nhơn
Li Changchun	Li Changchun
Larry Brown	Larry Brown
Modern English	Early Modern English
Joseph Heller	Joseph Heller
Boeing 720	Boeing 720
Estonian	Estonian language
Gojong of Korea	Gojong of Korea
Josefina Vazquez Mota	Josefina Vázquez Mota
Shin	Shin
Gala Television	Gala Television
Nicolas Ceausescu	Nicolae Ceaușescu
Jimmy Page	Jimmy Page
curitiba	Curitiba
Leighton Bynes	Leighton Baines
Chris Griffin	Chris Griffin
Hey Bulldog	Hey Bulldog
Clyde Tolson	Clyde Tolson
Qt	Qt
Somali	Somali language
Invasion of Ryukyu	Invasion of Ryukyu
Helen Yao	Helen Yao
Akita Shinkansen	Akita Shinkansen
Chase	Chase
Prince Alfonso	Infante Alfonso of Spain
Yang Guo	Yang Guo
Louisa So	Louisa So
Microsoft Lumia 535	Microsoft Lumia 535
Sistus IV	Pope Sixtus IV
Charles IX	Charles IX of France
Meizhou	Meizhou
Motherwell Football Club	Motherwell FC
Adil Chalcani	Adil Çarçani
Lawrence Summers	Lawrence Summers
Pedro	Pedro
Andreas Weimann	Andreas Weimann
Williams College	Williams College
Gaohucheng	Gao Hucheng
20102011 England League Cup	201011 Football League Cup
List of Cambodian monarchs	List of monarchs of Cambodia
Toni Kroos	Toni Kroos
Cevdet Sunay	Cevdet Sunay
Theodore Roosevelt	Theodore Roosevelt
Sony Xperia sola	Sony Xperia sola
Hachioji	Hachiōji Tokyo
Tom Henning Øvrebø	Tom Henning Øvrebø
Reading Football Club	Reading FC
Alexander McKenzie	Alexander Mackenzie
DePaul University	DePaul University
Beijing West Railway Station	Beijing West Railway Station
Shinjukuku	Shinjuku
Grand Duchy of Finland	Grand Duchy of Finland
iris	Iris
Friends	Friends
LISP	Lisp
Jimmy Hendrix	Jimi Hendrix
Andre Iguodala	Andre Iguodala
Federic Bessone	Federico Bessone
Theofanis Yekas	Theofanis Gekas
Victoria	Queen Victoria
German	German language
Heron Tower	Heron Tower
Finnish Orthodox Church	Finnish Orthodox Church
Rishi Kapoor	Rishi Kapoor
Sycamore Township	Sycamore Township Butler County Kansas
South China Football Team	South China AA
Waina Kapac	Huayna Capac
Ma Su	Ma Su
Jacob Zuma	Jacob Zuma
Columbus Crews Football Club	Columbus Crew SC
Pearl Harbor	Pearl Harbor
Mario Gavlanovic	Mario Gavranović
Stadium Arcadium	Stadium Arcadium
Khitan large script	Khitan large script
Finland	Finland
GLAMOROUS SKY	Glamorous Sky
Dwyane Wade	Dwyane Wade
Borisov BATE Football Club	FC BATE Borisov
gold coast	Gold Coast Queensland
National Stadium	National Stadium
Beijing Workers Stadium	Workers Stadium
Changchun Yatai Football Club	Changchun Yatai FC
Alonzo Church	Alonzo Church
Second French Republic	French Second Republic
Federal Assembly	Federal Assembly
Jiang Mianheng	Jiang Mianheng
Embraer	Embraer
Assamese	Assamese language
US Army Aviation	United States Army Aviation Branch
Meguro District	Meguro
PAOK Football Club	PAOK FC
Ernest Rutherford	Ernest Rutherford
Raja Pervez Ashraf	Raja Pervaiz Ashraf
Nana Lee	Nana Lee
White Wagtail	White wagtail
Lee Jong Hyun	Lee Jonghyun
AIR	Air
Reality Check	Reality Check
Jalandhar County	Jalandhar district
Scipio the Great	Scipio Africanus
British Association of Universities	Association of Commonwealth Universities
198586 European Cup Winners Cup	198586 European Cup Winners Cup
Polish Government in Exile	Polish governmentinexile
Jet Li	Jet Li
monaco	Monaco
Milton Latham	Milton Latham
Bernhard III Duke of SaxeMeiningen	Bernhard III Duke of SaxeMeiningen
Plumgrove Township	Plum Grove Township Butler County Kansas
Dressage Love Fighting	Dressage To Win
M1911 pistol	M1911 pistol
Kim Jaejoong	Kim Jaejoong
Nika Girauri	Nika Gilauri
Togo Heihachiro	Tōgō Heihachirō
Shanxi Fenjiu Raptors Basketball Club	Shanxi Brave Dragons
Han Kookyoung	Han Kookyoung
Political Bureau of the Central Committee of the Communist Party of China	Politburo of the Communist Party of China
Wu Boxiong	Wu Pohsiung
Georgy Briznashki	Georgi Bliznashki
Hells Kitchen	Hells Kitchen
Mark Warner	Mark Warner
Orlando Magic	Orlando Magic
Hajime Hosogai	Hajime Hosogai
TSG 1899 Hoffenheim	TSG 1899 Hoffenheim
US Open	US Open
Afrikaners	Afrikaners
Moscow Region	Moscow Oblast
Yuwentai	Yuwen Tai
Japan	Japan
Jeremiah P Ostriker	Jeremiah P Ostriker
Sony Xperia Z3	Sony Xperia Z3
Yunnan Province	Yunnan
Chyi Chin	Chyi Chin
fiji	Fiji
AFC Champions League	AFC Champions League
Gothenburg	Gothenburg
Lakeview	Lakeview Oregon
William OConnell Bradley	William OConnell Bradley
Liao Dynasty	Liao dynasty
Stephanie	Stephanie
Patricia Arquette	Patricia Arquette
Jordan Rhodes	Jordan Rhodes
Lai Chingte	William Lai
Chen Mingwen	Chen Mingwen
Warren Christopher	Warren Christopher
199293 UEFA Cup	199293 UEFA Cup
skoda cars	Škoda Auto
guido van Rossum	Guido van Rossum
Kevin Kuranyi	Kevin Kurányi
Battle of Osaka	Siege of Osaka
Esteban Gutierrez	Esteban Gutiérrez
Anyang	Anyang
Petko Karavilov	Petko Karavelov
Princess Inge	Princess Ingeborg of Denmark
West Low German	West Low German
Oide Shampoo	Oide Shampoo
Boys Meet U	Boys Meet U
Shizuoka Prefecture	Shizuoka Prefecture
Leicester City Football Club	Leicester City FC
Mohammad Walihan Tonekaboni	Mohammad Vali Khan Tonekaboni
Thuận Thiên	Thuận Thiên
Rich Humphreys	Ritchie Humphreys
Archibald Leitch	Archibald Leitch
Yang Weilinghua	Yangwei Linghua
Enschede	Enschede
CharlesMathias Simons	CharlesMathias Simons
Guruguru Curtain	Guruguru Curtain
A Study in Pink	A Study in Pink
Stephen Warnock	Stephen Warnock
Gold Coast United Football Club	Gold Coast United FC
Croatia National Football Team	Croatia national football team
Ashanti Kotoko Football Club	Asante Kotoko SC
Super Mario series	Super Mario
Shonan Bima	Shonan Bellmare
NFlying	NFlying
Fernando Enrique Cardoso	Fernando Henrique Cardoso
I Want You	I Want You
Vaclav Havel	Václav Havel
Catholic PortoSanta Rufina Roman Suburbs	Suburbicarian Diocese of Porto e Santa Rufina
Turkey	Turkey
Leila Tong	Leila Tong
Gerado Martino	Gerardo Martino
Peoples Republic of Bulgaria	Peoples Republic of Bulgaria
Texas	Texas
Sumerian Records	Sumerian Records
Netherlands Antilles	Netherlands Antilles
Takahashi Ai	Ai Takahashi
Belgium	Belgium
Zhang Jin	Zhang Jin
Janice Vidal	Janice Vidal
Wroclaw	Wrocław
Conservative	Conservative Party
Mike Rogers	Mike Rogers
Charles Lyell	Charles Lyell
Kiki Sheung	Kiki Sheung
Karen Okubo	Yoshito Ōkubo
Shanghai International Studies University	Shanghai International Studies University
Christian Zapata	Cristián Zapata
Denis Diderot	Denis Diderot
IPad mini 4	IPad Mini 4
Zoran Jankovic	Zoran Janković
Konstantinos Tsatsos	Konstantinos Tsatsos
Dimitar Berbatov	Dimitar Berbatov
Iwata Shizuoka	Iwata Shizuoka
Helen Ma	Helen Ma
President of Mauritania	List of heads of state of Mauritania
Hakata Station	Hakata Station
Banri Kaieda	Banri Kaieda
Doug Rivers	Doc Rivers
Thor	Thor
Gerado Torado	Gerardo Torrado
Yesterday and Today	Yesterday and Today
Chaoyang District	Chaoyang District Beijing
Danijel Pranjić	Danijel Pranjić
Alfonso  Prince of Asturias	Alfonso Prince of Asturias
Italian under21 national football team	Italy national under21 football team
Hitori	Hitori
Second Abdullah Cabinet	Second Abdullah cabinet
Two and a Half Heroes	Two and a Half Men
Esther Kwan	Esther Kwan
Love  Peace	Love  Peace
Chinese Football Association League One	China League One
Alfonso Lopez Mitchellson	Alfonso López Michelsen
Kim Jungeun	Kim Jungeun
Theodore Dumitru Stolojan	Theodor Stolojan
Jill Biden	Jill Biden
Queen Christina	Christina Queen of Sweden
Lancy Pelosi	Nancy Pelosi
Brad Friedel	Brad Friedel
Infante Alfonso Duke of Calabria	Infante Alfonso Duke of Calabria
Stadion am Laubenweg	Stadion am Laubenweg
Philippines National Football Team	Philippines national football team
Lee Ejun	Lee Ejun
National Science and Technology Council	Ministry of Science and Technology
Zheng Jing	Zheng Jing
National Collegiate Athletic Association	National Collegiate Athletic Association
Miyako	Miyako Iwate
Fyodor III	Feodor III of Russia
Jacques Louis Randon	Jacques Louis Randon
Sigur Rós	Sigur Rós
Mugur Izarescu	Mugur Isărescu
Raymond Poincaré	Raymond Poincaré
Perfection	Perfection
Ong Ka Ting	Ong Ka Ting
Kingdom of Greece	Kingdom of Greece
Fringe	Fringe
Americas Next Top Model	Americas Next Top Model
Raqqa	AlRaqqah Governorate
Norwegian Second Division	2 Divisjon
Victoria	Victoria
Zibo City	Zibo
Sergey Lukyanenko	Sergei Lukyanenko
BLEACH	Bleach
County Wicklow	County Wicklow
Sayonara Kizu Darake no Hibi yo	Sayonara Kizu Darake no Hibi yo
Ismet Inonu	İsmet İnönü
Falkland Islands	Falkland Islands
Carlos Vela	Carlos Vela
Simon Poulsen	Simon Poulsen
Willem IV Prins of Oranje	William IV Prince of Orange
IKON	IKON
SCANDAL	Scandal
timeline	Axis
Guangdong Province	Guangdong
Council for Economic Planning and Development	Council for Economic Planning and Development
Lionel Jospin	Lionel Jospin
John M Berrian	John M Berrien
Megawati Sukarnoputri	Megawati Sukarnoputri
Benedict IV	Pope Benedict IV
University of Western Ontario	University of Western Ontario
Shinkansen E6 series electric train	E6 Series Shinkansen
Milton Friedman	Milton Friedman
Bohuslav Sobotka	Bohuslav Sobotka
Japan Airlines Flight 123 crash	Japan Airlines Flight 123
Martin Bormann	Martin Bormann
J Robert Oppenheimer	J Robert Oppenheimer
Argildas Brazoskas	Algirdas Brazauskas
Taizhou Jiangsu	Taizhou Jiangsu
IndoEuropean	IndoEuropean languages
Yangzhou	Yangzhou
Rimsky Yuen Kwokkeung	Rimsky Yuen
Stadium of Light	Stadium of Light
Indianapolis	Indianapolis
Music Box	Music Box
Catholic Diocese of Fresno	Roman Catholic Diocese of Fresno
heraclius	Heraclius
Ossetian	Ossetian language
HEART STATION	Heart Station
Daniele De Rossi	Daniele De Rossi
London School of Economics	London School of Economics
Duchy of SaxeAltenburg	Duchy of SaxeAltenburg
Sony Xperia ZL	Sony Xperia ZL
Nokia Lumia 1320	Nokia Lumia 1320
RealOviedo	Real Oviedo
Battle of Sekihara	Battle of Sekigahara
Cerro Porteño	Cerro Porteño
Yeh Kuangshih	Yeh Kuangshih
Nicholas Alexandrovich Tsesarevich of Russia	Nicholas Alexandrovich Tsesarevich of Russia
Mon	Mon people
Ali Mamluk	Ali Mamlouk
Sebastian Larsson	Sebastian Larsson
Park Dong Hyuk	Park Donghyuk
Queen Astrid	Astrid of Sweden
Trey Cool	Tré Cool
Yale University	Yale University
Getafe	Getafe
Ōta Gunma	Ōta Gunma
Spanish Armed Forces	Spanish Armed Forces
Prince Bertil Duke of Halland	Prince Bertil Duke of Halland
Samsung Group	Samsung
Kimi no Tame ni Boku ga Iru	Kimi no Tame ni Boku ga Iru
Blender	Blender
Volkswagen Tiguan	Volkswagen Tiguan
Franz von Papen	Franz von Papen
Rhode Island	Rhode Island
John Lennon	John Lennon
Hungarian Socialist Workers Party	Hungarian Socialist Workers Party
Left Party	Left Party
Nguyen Van Linh	Nguyễn Văn Linh
Cham	Chams
Direction  Social Democracy	Direction  Social Democracy
Uhm Junghwa	Uhm Junghwa
Humble Rat	Modest Mouse
TONE	Tone
Kim Soeun	Kim Soeun
Louis Enrique	Luis Enrique
Rama II	Rama II of Siam
FC Barcelona B Team	FC Barcelona B
Lorient Football Club	FC Lorient
Cornell University	Cornell University
LDU Quito	LDU Quito
audi	Audi
AMD 700 Chipset Family	AMD 700 chipset series
Tswana	Tswana language
Saitama Prefecture	Saitama Prefecture
Workers Party	The Workers Party
Tajik	Tajik language
Mind Travel	Mind Travel
Salomon Kalu	Salomon Kalou
Hong Kong Economic and Peoples Livelihood Alliance	Business and Professionals Alliance for Hong Kong
Su30MKK Fighter	Sukhoi Su30MKK
Organization for Economic Cooperation and Development	Organisation for Economic Cooperation and Development
Benjamin Netanyahu	Benjamin Netanyahu
South Korean won	South Korean won
Demi Lovat	Demi Lovato
Manitoba	Manitoba
Indiana University	Indiana University
Fred Thompson	Fred Thompson
Samsung Galaxy S6	Samsung Galaxy S6
Jesse Dylan	Jesse Dylan
Prince George Duke of Kent	Prince George Duke of Kent
angola	Angola
Samoan	Samoan language
Free Syrian Army	Free Syrian Army
Hami City	Hami City
Zhengzhou	Zhengzhou
Cherrie Ying	Cherrie Ying
Henrique	Henrique
Cao Yu	Cao Yu
Russian Premier League	Russian Football Premier League
California	California
ranger7	Ranger 7
Dannyson Cordoba	Danilson Córdoba
Kay Tse	Kay Tse
Tsai Duei	Tsai Duei
Lee Wai Lim	Lee Wai Lim
BEAST	Beast
Australian National Football Team	Australia national soccer team
Shinhwa	Shinhwa
Vicente del Bosque	Vicente del Bosque
Tim Curry	Tim Curry
President of Germany	President of Germany
Yuancheng District	Yuancheng District
Naoto Kan	Naoto Kan
Thurgood Marshall	Thurgood Marshall
James Chamangar	James Chamanga
John Resig	John Resig
Emperor Meiji	Emperor Meiji
Olga Nikolaevna	Olga Nikolaevna of Russia
Sony Xperia S	Sony Xperia S
Prince Carl Oscar Duke of Southmanland	Prince Carl Oscar Duke of Södermanland
Ashita e Kakeru Hashi	Ashita e Kakeru Hashi
Ted Kennedy	Ted Kennedy
Archibald Primrose  5th Earl of Rothbury	Archibald Primrose 5th Earl of Rosebery
Abdülaziz	Abdülaziz of the Ottoman Empire
Beijing Renhe Football Club	Beijing Renhe FC
Walt Disney Studios	Walt Disney Studios
Denver Nuggets	Denver Nuggets
Dickinson College	Dickinson College
Shenyang Dongjin Football Club	Shenyang Dongjin FC
GFRIEND	GFriend
Helen Clark	Helen Clark
Heo Jeong	Heo Jeong
Flower	Flower
Samsung Galaxy Note 5	Samsung Galaxy Note 5
Basque	Basque language
Henry Clay	Henry Clay
Northwest Airlines	Northwest Airlines
Simon Fraser University	Simon Fraser University
Fish Leong	Fish Leong
Nani	Nani
Branko Crvenkovski	Branko Crvenkovski
Ernest Moniz	Ernest Moniz
Numazu	Numazu Shizuoka
Ottawa	Ottawa
I Wanna Dance	I Wanna Dance
High Moon Studios	High Moon Studios
Johnny Isaacson	Johnny Isakson
Danny DaCosta	Danny da Costa
Indonesia	Indonesia
Nippon Professional Baseball	Nippon Professional Baseball
Lothar Matthaus	Lothar Matthäus
Paul Langevin	Paul Langevin
Josephine Siao	Josephine Siao
William John Duane	William J Duane
Ukrainian	Ukrainians
Fort Meade	Fort Meade Florida
Second Lady of America	Second Lady of the United States
Manuel Esquivel	Manuel Esquivel
Cochinchina	Cochinchina
Alex Bruce	Alex Bruce
Kutaro Suzuki	Kantarō Suzuki
Pope Nicholas II	Pope Nicholas II
Urdu	Urdu
Secret	Secret
Salvatore Bocchetti	Salvatore Bocchetti
Naji Imre	Imre Nagy
French Kiss	French Kiss
Hong Kong Disneyland	Hong Kong Disneyland
Chiang Pinkung	Chiang Pinkung
Beijing	Beijing
Koh Tsu Koon	Koh Tsu Koon
Ri Myongguk	Ri Myongguk
Jiezhi Sports Association	Kitchee SC
Jarvis Cocker	Jarvis Cocker
J Records	J Records
IOS 8	IOS 8
OS X Yosemite	OS X Yosemite
Fabian Delph	Fabian Delph
Mark Anthony	Mark Antony
Manuel Ferraz de Campos Sales	Manuel Ferraz de Campos Sales
John Jay	John Jay
Lady Gaga	Lady Gaga
Rubber Soul	Rubber Soul
Laurent Fabius	Laurent Fabius
Santa Cruz de Tenerife	Santa Cruz de Tenerife
Jiang Ning	Jiang Ning
North Central American and Caribbean League Champions Cup	CONCACAF Champions League
Blaise Pascal	Blaise Pascal
Charles I	Charles I of England
Pohang Steelers Football Club	Pohang Steelers
Xiao Xun	Xiao Xun
Gentle Words	Gentle Words
Sony Xperia Z2	Sony Xperia Z2
Huadu District	Huadu District
Emperor Entertainment	Emperor Entertainment Group
Princess Muna alHussein	Princess Muna alHussein
ONE DROP	One Drop
Romanian Socialist Republic	Socialist Republic of Romania
CounterStrike	CounterStrike
Zhejiang Province	Zhejiang
Grand Duchess Maria Theresa	Maria Teresa Grand Duchess of Luxembourg
Jussy Switzerland	Jussy Switzerland
Shangqiu	Shangqiu
Phil Jones	Phil Jones
China Post	China Post
Tianqi Emperor	Tianqi Emperor
MercedesAMG Team	MercedesBenz in Formula One
Somaliland	Italian Somaliland
Benito Mussolini	Benito Mussolini
Cao Huan	Cao Huan
Andres Iniesta	Andrés Iniesta
Tsutomu Hata	Tsutomu Hata
Tony Capodie	Tony Capaldi
Iran	Iran
Erina Mano	Erina Mano
Toulouse Football Club	Toulouse FC
Northern Wei Dynasty	Northern Wei
Victor Weiskopf	Victor Weisskopf
Jason Crowe	Jason Crowe
Pope Victor I	Pope Victor I
Paul Lane	Paul Ryan
New York State	New York
Swedish Empire	Swedish Empire
Itami Hyōgo	Itami Hyōgo
Batman Forever	Batman Forever
Napoleonic Wars	Napoleonic Wars
City of London	City of London
Hubert Humphrey	Hubert Humphrey
Jin Soo Kim	Kim Jinsu
GNU Core Toolset	GNU Core Utilities
Huaiyuan County	Huaiyuan County
Faisal II	Faisal II of Iraq
Real voice	Real Voice
Alphonse Bilam de Condol	Alphonse Pyramus de Candolle
Ann Daniel	Ahn Daniel
Aisai	Aisai
Ikebukuro Station	Ikebukuro Station
French Indochina	French Indochina
Leung Chunying	Leung Chunying
Andrew Fisher	Andrew Fisher
Taiwan Public Radio and Television Group	Taiwan Broadcasting System
Reims	Reims
Battle of Huaihai	Huaihai Campaign
Nicholas Sturgeon	Nicola Sturgeon
Penang Football Association	Penang FA
201112 English Premier League	201112 Premier League
Amenhotep III	Amenhotep III
Teddy Lucy	Teddy Lučić
ChêneBougeries	ChêneBougeries
David Walter Foster	David Foster
Oromo	Oromo people
Ricardo Alvarez	Ricky Álvarez
Faroe Islands National Football Team	Faroe Islands national football team
Princess Victoria of Hesse and by Rhine	Princess Victoria of Hesse and by Rhine
Linda Chung	Linda Chung
Utah Administrative Divisions	List of counties in Utah
Big Sean	Big Sean
Kajkavian	Kajkavian
Artur Schopenhauer	Arthur Schopenhauer
Comenius University Bratislava	Comenius University
Longfordshire	County Longford
No Byungjun	No Byungjun
Warner Music Group	Warner Music Group
SC Farense	SC Farense
Trinity College Cambridge	Trinity College Cambridge
Younis Muhammad	Younis Mahmoud
Australian House of Representatives	Australian House of Representatives
Richard Rush	Richard Rush
JPEG XR	JPEG XR
ALGOL W	ALGOL W
Cao Mao	Cao Mao
Verier	Veyrier
Matsue	Matsue
Hau Peitsun	Hau Peitsun
Sem Fosalico	Šime Vrsaljko
Humbaritu Baruchis Tessina	Humberlito Borges
Niedun Burns	Nathan Burns
1982 Lebanon War	1982 Lebanon War
Baek Sungdong	Baek Sungdong
Juliao Baptista	Júlio Baptista
Michele Debre	Michel Debré
Leinster	Leinster
Belarus Premier League	Belarusian Premier League
University of Tennessee	University of Tennessee
FedEx	FedEx
LanguedocRoussillonSouthPyrenees	LanguedocRoussillonMidiPyrénées
Arthur Kornberg	Arthur Kornberg
Bali Alphabet	Balinese alphabet
Princess Alice	Princess Alice of the United Kingdom
Dwayne Johnson	Dwayne Johnson
Italian Unity	Italian unification
Tomatsu Haruka	Haruka Tomatsu
Ashraf Ghani Ahmedzai	Ashraf Ghani
Raymond Wong Ho Yin	Raymond Wong Hoyin
HBO	HBO
IndoAryan	IndoAryan languages
Yun Posun	Yun Posun
Magnus VII	Magnus IV of Sweden
Empress Genshō	Empress Genshō
Emperor Movies	Emperor Motion Pictures
Siberian Turkic languages	Siberian Turkic languages
WW	WW
Jeffrey Bruma	Jeffrey Bruma
Hamza bin Hussein	Hamzah bin Hussein
Harry Reid	Harry Reid
Hermes Rodriguez da Fonseca	Hermes da Fonseca
Arkansas River	Arkansas River
Angela Tong	Angela Tong
Manhattan Project	Manhattan Project
Joachim Murat	Joachim Murat
AustroHungary	AustriaHungary
Carlos Yeras Restrepo	Carlos Lleras Restrepo
Guarani	Guarani language
Tokio	Tokio
Manchester City Football Club	Manchester City FC
Chrissy Hayter	Chrissie Hynde
Norwich City Football Club	Norwich City FC
Sports Club Hertha Berlin	Hertha BSC
Shō Nei	Shō Nei
Wilfried Bony	Wilfried Bony
Cao Bằng Province	Cao Bằng Province
Emre Belotsoglu	Emre Belözoğlu
Underworld	Underworld
Rene Descartes	René Descartes
National Government	Nationalist government
ACMilan	AC Milan
Dai Hakken	Dai Hakken
Safavid	Safavid dynasty
Ren Hang	Ren Hang
Fontainebleau	Fontainebleau
West Kalimantan	West Kalimantan
Turkish Airlines	Turkish Airlines
Walter Meissner	Walther Meissner
2011 Supercopa de España	2011 Supercopa de España
Gyeongnam Football Club	Gyeongnam FC
The Fourth Republic	Fourth Republic of South Korea
PlanlesOuates	PlanlesOuates
IOS 5	IOS 5
Richard Shelby	Richard Shelby
Kenny Wong	Kenny Wong
Korkrade	Kerkrade
George Walker Bush	George W Bush
Peter Pacallik	Peter Pekarík
Frank Hsieh	Frank Hsieh
duwop	Doowop
University of Bristol	University of Bristol
Rgyalrongic languages	Rgyalrongic languages
David Neuberger Baron Neuberger of Abbotsbury	David Neuberger Baron Neuberger of Abbotsbury
Mozilla Corporation	Mozilla Corporation
Bay Lake	Bay Lake Florida
Astro Joy HD	Astro Xi Yue HD
WebKit	WebKit
Mao Anying	Mao Anying
Palestine Mandate	Mandatory Palestine
Masayoshi Ōhira	Masayoshi Ōhira
Jesse Alexander Helms	Jesse Helms
Frederick II	Frederick the Great
Charles River	Charles River
Springfield	Springfield Missouri
Labour	Labour Party
Fabien Bartz	Fabien Barthez
National Peoples Congress	National Peoples Congress
John Harsanyi	John Harsanyi
Jinan	Jinan
Alcorcon Sports Association	AD Alcorcón
Categoría Primera A	Categoría Primera A
Cheryl Crow	Sheryl Crow
Heijōkyō	Heijōkyō
Start in my life	Start in My Life
Shulin District	Shulin District
Rancho Mirage	Rancho Mirage California
AlsaceChampagneArdennesLorraine	AlsaceChampagneArdenneLorraine
William Redington Hewlett	William Redington Hewlett
Ken Kersey	Ken Kesey
Bahrain	Bahrain
Deodoro da Fonseca	Deodoro da Fonseca
Haeju	Haeju
Wang Zhen	Wang Zhen
Selim I	Selim I
farsprovince	Fars Province
John Dewey	John Dewey
NintendoDS	Nintendo DS
Galaxy Nexus	Galaxy Nexus
CologneBellerive	CollongeBellerive
Nadir Zahabi	Nader alDahabi
Congress Poland	Congress Poland
Philip Degen	Philipp Degen
Ludovic Magnin	Ludovic Magnin
Eric Mun	Eric Mun
Alan Stephenson Boyd	Alan Stephenson Boyd
Matsukata Masayoshi	Matsukata Masayoshi
PLEASE SMILE AGAIN	Please Smile Again
Identify	Identify
Phillips Exeter College	Phillips Exeter Academy
The Feeling	The Feeling
New Orleans Pelicans	New Orleans Pelicans
Gyrgios Karagounis	Giorgos Karagounis
Nintendo eShop	Nintendo eShop
LouisElisabeth	Louise Élisabeth of France
So Into You	So into You
Yoshinori Kitase	Yoshinori Kitase
Togo National Football Team	Togo national football team
DigiCube	DigiCube
Andreas Hinkle	Andreas Hinkel
Kamikyokutachi	Kamikyokutachi
Fuji Shizuoka	Fuji Shizuoka
Josip Simmunic	Josip Šimunić
Jan Peter Balkenende	Jan Peter Balkenende
South Africa	South Africa
Grigor Mgaloblishvili	Grigol Mgaloblishvili
Harri Holkeri	Harri Holkeri
Park Si Yeon	Park Siyeon
Touch Me	Touch Me
RenPy	RenPy
Park Hyo Shin	Park Hyoshin
Robert L Eichelberger	Robert L Eichelberger
New Era Party	New Era Party
AMD 690G Chipset	AMD 690 chipset series
RKB Daily broadcast	RKB Mainichi Broadcasting
Vicente Rodríguez	Vicente Rodríguez
Sony Pictures Entertainment	Sony Pictures Entertainment
Eddie Redmayne	Eddie Redmayne
Tamba	Tamba Hyōgo
Haris Seferović	Haris Seferović
Gustav VI Adolf	Gustaf VI Adolf of Sweden
Sima Yi	Sima Yi
ARTPOP	Artpop
Ivan Stepanovich Konev	Ivan Konev
Surface Pro 4	Surface Pro 4
Carolyn S Shoemaker	Carolyn S Shoemaker
Lo Chihan	Lo Chihan
Jules Grevi	Jules Grévy
Exile	Exile
Edwin Macmillan	Edwin McMillan
Louis IX	Louis IX of France
Emperor Murakami	Emperor Murakami
Concorde	Concorde
Ubay Luzardo	Ubay Luzardo
math rock	Math rock
ChubuNippon Broadcasting	ChubuNippon Broadcasting
Edwin Siu	Edwin Siu
HesseDarmstadt	Grand Duchy of Hesse
Fort Pierce	Fort Pierce Florida
Queen Jeonghui	Queen Jeonghui
JPY	Japanese yen
Patrick Vieira	Patrick Vieira
Stars Shine International	Stars Shine International
Zhou Xuan	Zhou Xuan
Empress Xiaoxianchun	Empress Xiaoxianchun
Marrickville Council	Marrickville Council
Ali Zaidan	Ali Zeidan
YiWan Railway Yichang Yangtze River Bridge	Yichang Yangtze River Railway Bridge
Blanche Lincoln	Blanche Lincoln
Newport Wales	Newport Wales
The Government of Li Keqiang	Li Keqiang Government
Claudius I	Claudius
WILD EYES	Wild Eyes
Christian Vieri	Christian Vieri
Alternative Rock	Alternative rock
Rostin Griffith	Rostyn Griffiths
Radcliffe College	Radcliffe College
Ukash Fabianski	Łukasz Fabiański
Aki Takajo	Aki Takajo
Odawara City	Odawara
Thai alphabet	Thai alphabet
National Geographic Channel	National Geographic Channel
Edmund Ho	Edmund Ho
Mesich Pasha	Mesih Pasha
Opposition Leader	Leader of the Opposition
Duns Scott	Duns Scotus
Battle of Bạch Đằng	Battle of Bạch Đằng
Thrash metal	Thrash metal
UK House of Lords	House of Lords
Wang Chienshien	Wang Chienshien
Urbana	Urbana Illinois
berkeley	Berkeley California
Cilla Kung	Cilla Kung
Jordan National Football Team	Jordan national football team
Hemet	Hemet California
Royal Victorian Medal	Royal Victorian Order
Chen Yun	Chen Yun
Pierre Werner	Pierre Werner
Midnight Clb	Midnight Club
Nikolai Alexandrovich Tikhonov	Nikolai Tikhonov
Max Planck	Max Planck
Big Julia	Julia the Elder
Washington  DC	Washington DC
Irish Free State	Irish Free State
Sanford B Dole	Sanford B Dole
Boeing767	Boeing 767
Modula2	Modula2
Juan Pablo Montoya	Juan Pablo Montoya
Kim Yongnam	Kim Yongnam
South Ossetia	South Ossetia
Joe Hart	Joe Hart
Ministry of Industry and Information Technology	Ministry of Industry and Information Technology
Kara DioGuardi	Kara DioGuardi
Kuwana Mie	Kuwana Mie
Augusto Radmark	Augusto Hamann Rademaker Grünewald
Germany	Germany
Fearless Records	Fearless Records
EXODUS	Exodus
Han Geng	Han Geng
Let Go	Let Go
Generali Arena	Generali Arena
Fernando VI	Ferdinand VI of Spain
Yong Junhyung	Yong Junhyung
Marvel Comics	Marvel Comics
Coldplay	Coldplay
Voyage	Voyage
Liu Tao	Liu Tao
Joel Griffith	Joel Griffiths
Phoenix Suns	Phoenix Suns
Mukhri Mahathir	Mukhriz Mahathir
Morgan Sunidalian	Morgan Schneiderlin
University of Miami	University of Miami
Cheng Nanjung	Cheng Nanjung
Ayurbarwada Buyantu Khan	Ayurbarwada Buyantu Khan
Nathan	Matthew Nathan
Storm Roux	Storm Roux
Mauricio Pinilla	Mauricio Pinilla
Giorginio Wijnaldum	Georginio Wijnaldum
Adyghe	Adyghe language
Boeing	Boeing
YOU	You
Alawite Dynasty	Alaouite dynasty
Borut Pahor	Borut Pahor
Adisha Gresson	Adisak Kraisorn
Ehud Olmert	Ehud Olmert
Lee Sangchul	Ri Sangchol
Irish	Irish language
Khalifa International Stadium	Khalifa International Stadium
Kunming	Kunming
Iwamasa Taiki	Daiki Iwamasa
Lawrence Ng	Lawrence Ng
Dish Network	Dish Network
Millwall FC	Millwall FC
Sean Lennon	Sean Lennon
Miyazawa Sae	Sae Miyazawa
European Peoples Party	European Peoples Party
