Allianz Riviera	Allianz Riviera
Jose Mario Vaz	José Mário Vaz
Free Software Foundation	Free Software Foundation
Malmo FF	Malmö FF
Rajendra Bikram Shaha	Rajendra of Nepal
Dream Evil	Dream Evil
Felix Grandi	Felix Grundy
How Do I Survive3F	How Do I Survive3F
Victoria Stadium	Victoria Stadium
Knox County	Knox County Tennessee
Wayne County	Wayne County North Carolina
The Firm	The Firm
Shanghai International Expo	Expo 2010
Bordeaux	Bordeaux
Karim Matmur	Karim Matmour
Hirosaki City	Hirosaki Aomori
Dan Gurney	Dan Gurney
Ahmad Naseef	Ahmed Nazif
Coverdale Page	Coverdale•Page
Henry Petty  Fitzmaurice	Henry PettyFitzmaurice 3rd Marquess of Lansdowne
Street Cry	Street Cry
Outlook Express	Outlook Express
Harrison Schmidt	Harrison Schmitt
Soyuz22	Soyuz 22
LOVE  HONEY	Love  Honey
Like a Virgin	Like a Virgin
Weifang City	Weifang
Gilbert Elliott  MurrayKinnymound	Gilbert ElliotMurrayKynynmound 1st Earl of Minto
Overijssel	Overijssel
Udmurt	Udmurt language
Crispy Park	Crispy Park
Rockingham County	Rockingham County Virginia
Hellas Verona FC	Hellas Verona FC
Taman	Tamang language
Battikaloa District	Batticaloa District
Perry County	Perry County Tennessee
Kanagawa Prefecture 11th Ward	Kanagawa 11th district
Natalia Annenko	Natalia Annenko
Patti Smith	Patti Smith
Champagne Supernova	Champagne Supernova
Omiya Station	Ōmiya Station
Urho Kekkonen	Urho Kekkonen
Morelia	Morelia
George McGovern	George McGovern
Mari Kibiniemi	Mari Kiviniemi
Deathlike Silence Productions	Deathlike Silence Productions
The Orb	The Orb
Desperate Housewives	Desperate Housewives
Siskiyou County	Siskiyou County California
Infinity M	Infiniti M
Ilocano	Ilocano language
Fontana Records	Fontana Records
Bernard FitzAlan  Howard	Bernard FitzalanHoward 16th Duke of Norfolk
Microsoft Windows Millennium Edition	Windows ME
DRAGON GATE	Dragon Gate
United Launch Alliance	United Launch Alliance
Inferno	Inferno
Alex Skolnick	Alex Skolnick
Mitch McConnell	Mitch McConnell
Gagarin Launch Pad	Gagarins Start
prescription	Precipitation
Sky News	Sky News
Forever	FaughaBallagh
SDN48	SDN48
Morning Musume	Morning Musume
Monfero	Monfero
Hiroshima Prefecture	Hiroshima Prefecture
Calhoun County	Calhoun County West Virginia
Caldwell County	Caldwell County Missouri
San Germano dei Berici	San Germano dei Berici
Peoples Commissariat for Internal Affairs	NKVD
Soyuz 36	Soyuz 36
In the Zone	In the Zone
Northern Ryukyu dialect	Northern Ryukyuan languages
Chicago	Chicago
MAX	MAX
Galor National Stadium	National Football Stadium
Phoenician script	Phoenician alphabet
Nadir Belhaj	Nadir Belhadj
Galit Chait	Galit Chait
Edogawa Ward	Edogawa Tokyo
AIR	Air
Nazli Nasir	Nazri Nasir
Fiorello LaGuardia	Fiorello H La Guardia
Celestine IV	Pope Celestine IV
Ryan Playfair	Lyon Playfair 1st Baron Playfair
United States Secretary of Defense	United States Secretary of Defense
Allegheny County	Allegany County Maryland
University of Toronto	University of Toronto
Dan Palmer	Dan Palmer
Mexico City	Mexico City
Malaysia National Football Team	Malaysia national football team
Tatsuro Yamashita	Tatsuro Yamashita
President of the European Commission	President of the European Commission
Overkill	Overkill
Milwaukee	Milwaukee
Fulton County	Fulton County Illinois
UFC 30	UFC 30
Electropop	Electropop
Oliver Wolcott	Oliver Wolcott Jr
Snow drop	Snow Drop
Worcester County	Worcester County Massachusetts
Arcaneus	Tucana
PlayStation Mobile	PlayStation Mobile
Nathan Clifford	Nathan Clifford
1FSV Mainz05	1 FSV Mainz 05
Cecil County	Cecil County Maryland
Isle	Isle
DRINK IT DOWN	Drink It Down
Monroe County	Monroe County Pennsylvania
Duane Allman	Duane Allman
Mansi	Mansi language
Michelle	Michelle
R designation	Rated R
Vice President of the Republic of China	Vice President of the Republic of China
House of SaxeCoburgGotha	House of SaxeCoburg and Gotha
Bastro	Bastro
Microsoft Windows 95	Windows 95
HEART	Heart
Next footsteps	Tsugi no Ashiato
Christina Aguilera	Christina Aguilera
Apple Incorporated	Apple Inc
Oh Love	Oh Love
Minami Alps City	MinamiAlps Yamanashi
EXILE	Exile
Old Uyghur	Old Uyghur language
EskimoAleut language family	EskimoAleut languages
ENDLESS RAIN	Endless Rain
Hugh Padgham	Hugh Padgham
Arthur Mas	Artur Mas i Gavarró
Sonera Stadium	Sonera Stadium
Dancing Queen	Dancing Queen
Blaine County	Blaine County Montana
Western Province	Western Province Sri Lanka
Impossible Princess	Impossible Princess
Lets Stay Together	Lets Stay Together
United Football League	United Football League
Black Metal	Black metal
Keiichi Aichi	Kiichi Aichi
MIYAVI	Miyavi
Ghazi	Ghazi of Iraq
Luis Crages	Louis Krages
Genichiro Tenryu	Genichiro Tenryu
Sporting Braga	SC Braga
Gyuha Choi	Choi Kyuhah
Jonas Kjellgren	Jonas Kjellgren
Georges Bataille	Georges Bataille
Roberto	Roberto
Steve Clifford	Steve Clifford
Liberal Party	Liberal Party
Peter Cosgrove	Peter Cosgrove
Iwamizawa City	Iwamizawa Hokkaido
Power to the People	Power to the People
Stephen Wilson	Steven Wilson
Kinokawa City	Kinokawa Wakayama
Emanuel Swedenborg	Emanuel Swedenborg
Norio Suzuki	Norio Suzuki
The Siege of Corinth	Siege of Corinth
Gladwin County	Gladwin County Michigan
⊿	Triangle
Preston County	Preston County West Virginia
Lithuanian Social Democratic Party	Social Democratic Party of Lithuania
Jethro Tull	Jethro Tull
Avoiles County	Avoyelles Parish Louisiana
Satoshi Katayama	Tetsu Katayama
Shaanxi	Shaanxi
Falling Into Infinity	Falling into Infinity
Mississippi	Mississippi
STAND BY ME Doraemon	Stand by Me Doraemon
Middlesex County	Middlesex County Connecticut
STS75	STS75
Darth Vader	Darth Vader
Country Pop	Country pop
Is the Order a Rabbit3F	Is the Order a Rabbit3F
Lower Austria	Lower Austria
Prince Edward County	Prince Edward County Virginia
1SNL	Slovenian PrvaLiga
French	French people
Indie Recordings	Indie Recordings
Draco	Draco
Sergey Stepashin	Sergei Stepashin
Mizo Language	Mizo language
Sauber C21	Sauber C21
Hélio Castroneves	Hélio Castroneves
Scioto County	Scioto County Ohio
Southern Rhodesian Pound	Southern Rhodesian pound
Spotlight	Spotlight
Lehigh County	Lehigh County Pennsylvania
Guy Aslin	Gai Assulin
Rutgers University	Rutgers University
Mozambique Liberation Front	FRELIMO
The Great Alliance War	Nine Years War
Richard Thompson	Richard W Thompson
United Airlines	United Airlines
Region of Matera	Province of Matera
Roberto Bolaño	Roberto Bolaño
Catalan Democracy	Democratic Convergence of Catalonia
Cameron Jerome	Cameron Jerome
Jacob Lu	Jack Lew
Battle of Five Forks	Battle of Five Forks
Isahaya City	Isahaya Nagasaki
Pratra Sella	Pratola Serra
Mercer County	Mercer County Missouri
Franz Fanon	Frantz Fanon
Gilles Deleuze	Gilles Deleuze
Apple TV	Apple TV
Battlefield	Battlefield
Grand Duchy of Halych  Volhynia	Kingdom of GaliciaVolhynia
Katale Toyama	Kataller Toyama
Ebisu Private Junior High School	Shiritsu Ebisu Chugaku
Jermaine Jackson	Jermaine Jackson
John Muth	John Muth
Stjepan Mesic	Stjepan Mesić
Imperial Prince Kaninnomiya Sahihito	Prince Kanin Kotohito
Gaining through losing	Gaining Through Losing
Freza Grandinaria	Fresagrandinaria
William Mercy	William L Marcy
Yuta Minami	Yuta Minami
Yuki Ozawa	Yuki Ozawa
Madagascar	Madagascar
Jiro Kawasaki	Jirō Kawasaki
Irving Fisher	Irving Fisher
Akita Prefecture	Akita Prefecture
Daniel Erlandson	Daniel Erlandsson
Bjorn Yellotte	Björn Gelotte
Phnom Penh Olympic Stadium	Olympic Stadium
Tsukihime	Tsukihime
Saint John the Baptist County	St John the Baptist Parish Louisiana
King Tom	King Tom
Rage Against the Machine	Rage Against the Machine
FC Lorient	FC Lorient
Patrick Leahy	Patrick Leahy
Creed	Creed
Dikab County	DeKalb County Georgia
Mountains and Vipers	The Mountain and the Viper
Oswego County	Oswego County New York
Elizabeth I	Elizabeth I of England
Maine	Maine
Shiribeshi General Promotion Bureau	Shiribeshi Subprefecture
Preble County	Preble County Ohio
william	William
UFC 158	UFC 158
Koga City	Koga Ibaraki
Sacramento Rivercats	Sacramento River Cats
Lee Siyoung	Yi Siyeong
Wasgen Sarkisyan Anvan Hanrapetakan Marzadasi	Vazgen Sargsyan Republican Stadium
Army of the Potomac	Army of the Potomac
Lund	Lund
Obituary	Obituary
Shinzo Oya	Shinzō Ōya
AS Rome	AS Roma
Taro Katsura	Katsura Tarō
Liberal Union Party	Liberal Unionist Party
By the Wind	Kaze o Ukete
Tibetan script	Tibetan alphabet
Monthly Comic Dengeki Daioh	Dengeki Daioh
Buchanan County	Buchanan County Virginia
Hotel California	Hotel California
Antrim County	Antrim County Michigan
Efeline Widmar  Schlumpf	Eveline WidmerSchlumpf
Monroe County	Monroe County Michigan
Daniel Miller	Daniel Miller
Rock the Kasbah	Rock the Casbah
Left Brain	Left Brain
QBasic	QBasic
Red	Red
UFC on FOX 10	UFC on Fox
National Assembly	National Assembly of Cambodia
Fumio Goto	Fumio Gotō
Ayumu Goromaru	Ayumu Goromaru
Edward Spencer	John Spencer 8th Earl Spencer
Hermann Hesse	Hermann Hesse
Henri Pescarolo	Henri Pescarolo
Marcelo Gallardo	Marcelo Gallardo
Washington County	Washington County Pennsylvania
Sideone dummy record	SideOneDummy Records
Oita Trinita	Oita Trinita
Brian Molko	Brian Molko
Mission	Mission
India	India
Oneida County	Oneida County Idaho
Kurume City	Kurume Fukuoka
Octibecha County	Oktibbeha County Mississippi
Mason County	Mason County Illinois
David Ellefson	David Ellefson
Federation of European Football Associations	UEFA
BraganzaCoburgo Family	House of BraganzaSaxeCoburg and Gotha
Lita Ford	Lita Ford
Hugo Grotius	Hugo Grotius
Fina Gale	Fine Gael
Steuben County	Steuben County Indiana
Battle of Chancellorsville	Battle of Chancellorsville
Vigo	Vigo
Ivan Krall	Ivan Kral
Jackson Brown	Jackson Browne
Cowley County	Cowley County Kansas
Operation Barbarossa	Operation Barbarossa
THE FACE	The Face
Shigenori Togo	Shigenori Tōgō
National Diet	National Diet
Shekira Soundtrack	Shake It Up
Umar Willahadikusma	Umar Wirahadikusumah
Theodore Schultz	Theodore Schultz
Dunn County	Dunn County Wisconsin
Wilhelmina	Wilhelmina of the Netherlands
Ruben González Rocha	Rubén González Rocha
Michael Schenker Group	Michael Schenker Group
Soyuz25	Soyuz 25
Baruch de Spinoza	Baruch Spinoza
Hardy County	Hardy County West Virginia
Viggianello	Viggianello
Prime Minister of Romania	Prime Minister of Romania
Three Days Grace	Three Days Grace
Paul Patton	Paul E Patton
American Airlines Arena	American Airlines Arena
Ulster County	Ulster County New York
My Back Pages	My Back Pages
Just Good Friends	Just Good Friends
Alisa Agafonova	Alisa Agafonova
Independiente Medellín	Independiente Medellín
My Generation Understand	My Generation Understand
Low German	Low German
Kenzumi Suematsu	Suematsu Kenchō
Jacob Marschak	Jacob Marschak
Jessie Brown	Jesse Brown
PlayStation 3	PlayStation 3
Yoko Ono	Yoko Ono
Tropicana Field	Tropicana Field
EA Guingan	En Avant de Guingamp
Taylor County	Taylor County Texas
Spain under Franco	Francoist Spain
Reiichi Nakaido	Reichi Nakaido
Gaiska Mendieta	Gaizka Mendieta
Pierce County	Pierce County North Dakota
Airi Suzuki	Airi Suzuki
Path of Punishment	Walk of Punishment
Club African	Club Africain
I HAVE NEVER SEEN	I Have Never Seen
Jonathan Belcher	Jonathan Belcher
Norwich	Norwich
Yanagawa City	Yanagawa Fukuoka
Bengali	Bengali language
John Kerry	John Kerry
George Clinton	George Clinton
Emerson Fittipaldi	Emerson Fittipaldi
Henry Stimson	Henry L Stimson
Emperor Kanmu	Emperor Kanmu
Alister	Allister
Dreaming Now	Dreaming Now
Thomas Robinson	Thomas Robinson 2nd Baron Grantham
Scream 4	Scream 4
Okhotsk General Promotion Bureau	Okhotsk Subprefecture
Province of Reggio Calabria	Province of Reggio Calabria
Nikolay Rukavishnikov	Nikolay Rukavishnikov
Brythonic Languages	Brittonic languages
Yvonne Elliman	Yvonne Elliman
Cacak	Čačak
Seattle Thru	Seattle Slew
Vittorio Emanuele III	Victor Emmanuel III of Italy
Lee County	Lee County Illinois
Michael Jackson THIS IS IT	Michael Jacksons This Is It
Soyuz TMA02M	Soyuz TMA02M
Prime Minister of Lesotho	List of heads of government of Lesotho
Draco Rosa	Draco Rosa
John Feldman	John Feldmann
California	California
Kasum Pasha SK	Kasımpaşa SK
Kingdom of Iraq	Kingdom of Iraq
Sadorian	Sadri language
Visions	Visions
Killer Kowalski	Killer Kowalski
Japan Restoration Party	Japan Restoration Party
Takayuki Kiyama	Takashi Kiyama
Feel fine	Feel Fine
Google Chrome	Google Chrome
Mobutu Sese Seko	Mobutu Sese Seko
Utah Jazz	Utah Jazz
In the Closet	In the Closet
Wilhelm Cuno	Wilhelm Cuno
Neil DeGrasse Tyson	Neil deGrasse Tyson
Its all Love	Its All Love
Thomas Wharton	Thomas Wharton 1st Marquess of Wharton
Sakura Petals	Sakura no Hanabiratachi
Dun County	Dunn County North Dakota
Sunshine	You Are the Sunshine of My Life
Amagasaki City	Amagasaki
Markus Antonius	Mark Antony
Beady Eye	Beady Eye
Messages of loneliness	Message in a Bottle
STAY AWAY	Stay Away
William Cavendish  Bentinck	Lord William Bentinck
Sotho	Sotho language
French Indochina	French Indochina
Speaker of the United States House of Representatives	Speaker of the United States House of Representatives
Mahinda Rajapaksa	Mahinda Rajapaksa
Minato Ward	Minato Tokyo
Bernie Worrell	Bernie Worrell
Coast to Coast	Coast to Coast
Lincoln County	Lincoln Parish Louisiana
Key to the Mint	Key to the Mint
Libertarian Party	Libertarian Party
Kouki Hirota	Kōki Hirota
Pierre Frimlan	Pierre Pflimlin
Bradford County	Bradford County Florida
FK Partizani Tirana	FK Partizani Tirana
Windows Phone	Windows Phone
Patricia Roberts Harris	Patricia Roberts Harris
Mottola	Mottola
Grancona	Grancona
The 39th longterm stay	Expedition 39
Hard Rock	Hard rock
Don Carlos Buell	Don Carlos Buell
Nîmes Olympiad	Nîmes Olympique
Mayumi Moriyama	Mayumi Moriyama
Isabel do Brasil	Isabel Princess Imperial of Brazil
Fushimi Ward	Fushimiku Kyoto
Arctic Monkeys	Arctic Monkeys
UFC	Ultimate Fighting Championship
NMB48	NMB48
Highlands County	Highlands County Florida
John Adams Dix	John Adams Dix
Sinister Gates	Synyster Gates
JosephineCharlotte de Belgic	Princess Joséphine Charlotte of Belgium
Essiliga	Esiliiga
The Corrs	The Corrs
Hull City AFC	Hull City AFC
Toyota Belta	Toyota Belta
Falkner County	Faulkner County Arkansas
Perkins County	Perkins County South Dakota
Guy Carlton	Guy Carleton 1st Baron Dorchester
Himya	Himyar
DEEP RIVER	Deep River
Delta County	Delta County Michigan
Ragusa Province	Province of Ragusa
Stockholm county	Stockholm County
Myanmar National Football Team	Myanmar national football team
Apocalyptica	Apocalyptica
World Athletics Championships	IAAF World Championships in Athletics
Suharto	Suharto
Steve Hackett	Steve Hackett
Soyuz 14	Soyuz 14
Clive Barr	Clive Burr
Star Trek Beyond	Star Trek Beyond
Wolfmother	Wolfmother
Henry Paulson	Henry Paulson
Al Cohn	Al Cohn
Emery County	Emery County Utah
Aries	Aries
Rutherford County	Rutherford County Tennessee
Esprit Arena	Esprit Arena
Denki Groove	Denki Groove
Got to Get You into My Life	Got to Get You into My Life
Brian Wilson	Brian Wilson
Karl XI	Charles XI of Sweden
Papiermark	German Papiermark
Anna Lee Fisher	Anna Lee Fisher
Elizabeth Anscombe	Elizabeth Anscombe
American Bison	American bison
Orochi	Oroch people
M・a・z・e	Maze
Ueno Station	Ueno Station
Elk County	Elk County Kansas
Happiness	Happiness
Dennis Ritchie	Dennis Ritchie
STYLE	Style
Joinville EC	Joinville Esporte Clube
Higashikuninomiya Prince Naruhiko	Prince Naruhiko Higashikuni
Andrew Bonner Law	Bonar Law
Kumagaya Sports Culture Park Athletics Stadium	Kumagaya Athletic Stadium
4th Division	4th Division
Elena del Montenegro	Elena of Montenegro
Boris III	Boris III of Bulgaria
The Winery Dogs	The Winery Dogs
Queen Rocks	Queen Rocks
Monroe County	Monroe County New York
Nevada County	Nevada County California
Emperor Junna	Emperor Junna
James Tobin	James Tobin
Sabinianus	Pope Sabinian
BoB	BoB
No Doubt	No Doubt
ClermontFerrand	ClermontFerrand
Cant Stand Losing You	Cant Stand Losing You
Karl Barth	Karl Barth
Henri II	Henry II of France
Robert Anderson	Robert Anderson
Hercules Armello	Heracles Almelo
United National Party	United National Party
Nottingham Forest FC	Nottingham Forest FC
Mannar District	Mannar District
VAMPS	Vamps
UFC on FOX 11	UFC on Fox
Billy Sheehan	Billy Sheehan
19th longterm stay	Expedition 19
Millennium Stadium	Millennium Stadium
Maria Elisabeth von Bavaria	Princess Maria Elisabeth of Bavaria
Kings Best	Kings Best
Steve Kahn	Steve Keirn
Leave Me Alone	Leave Me Alone
President of Romania	President of Romania
Syngman Rhee	Syngman Rhee
John F Kennedy International Airport	John F Kennedy International Airport
Andrew Ridgely	Andrew Ridgeley
Tiffany Vice	Tiffany Vise
Brahmi script	Brahmi script
Ascoli Picchio FC 1898	Ascoli Picchio FC 1898
Martin Atkinson	Martin Atkinson
UFC on FOX 16	UFC on Fox
Shahrastani	Shahrastani
Nicola Rizzoli	Nicola Rizzoli
Bedizzole	Bedizzole
North East England	North East England
BORIS	Boris
Harry Markowitz	Harry Markowitz
SerboCroatian	SerboCroatian
Portuguese	Portuguese people
Copa America 2001	2001 Copa América
Tama City	Tama Tokyo
Cheongryangri Station	Cheongnyangni Station
Prince George County	Prince George County Virginia
DeSoto County	DeSoto County Mississippi
Johnston County	Johnston County North Carolina
Gwangju Songjeong Station	Gwangju Songjeong Station
William Dennison	William Dennison Jr
John Stewart	John Stuart 3rd Earl of Bute
Province of Livorno	Province of Livorno
Paul Krugman	Paul Krugman
Vasily Leontief	Wassily Leontief
Duchane County	Duchesne County Utah
Vancouver Olympics	2010 Winter Olympics
Lovebox	Lovebox
Doesburg	Doesburg
Kawasaki Frontale	Kawasaki Frontale
Young Ace	Young Ace
Stevie Ray Vaughan	Stevie Ray Vaughan
FC Actobe	FC Aktobe
Shelby County	Shelby County Illinois
Usue Barcos	Uxue Barkos
Panic at the Disco	Panic at the Disco
DAYS	Days
Walt Disney Studios Motion Pictures	Walt Disney Studios Motion Pictures
Alright	Alright
Cho Yeongcheol	Cho Youngcheol
John Gregg	John Gregg
UFC 43	UFC 43
New York University	New York University
Nuvolera	Nuvolera
Bronckhorst	Bronckhorst
ParisOrly Airport	Orly Airport
Crips	Crips
Osamu Fujimura	Osamu Fujimura
Syrian Premier League	Syrian Premier League
Clarence  22Gatemouth  22 Brown	Clarence 22Gatemouth22 Brown
Augustus Stanley	Augustus Owsley Stanley
Miri Ben Ali	Miri BenAri
UFC 38	UFC 38
Threelegged	Ninin Sankyaku
American Samoa	American Samoa
Japanese	Japonic languages
John Paul II	Pope John Paul II
Birendra Bir Bikram Shaha	Birendra of Nepal
Nearco	Nearco
AngeFelix Patase	AngeFélix Patassé
Barbara Fusal  Poli	Barbara FusarPoli
FAIRY TAIL	Fairy Tail
The Wolf Constellation	Lupus
Gamba Osaka	Gamba Osaka
Edwards Pierpont	Edwards Pierrepont
Columbia	Columbia South Carolina
Paul Wolfowitz	Paul Wolfowitz
Ministry of Defense	Ministry of Defense
Steve Marriott	Steve Marriott
Himeji City	Himeji Hyōgo
French Third Republic	French Third Republic
Republic of England	Commonwealth of England
Kayaji	Kahyasi
Brunei DPMM FC	Brunei DPMM FC
Nicholas II	Nicholas II of Russia
Doors	The Doors
Tanzania	Tanzania
William Russell Grace	William Russell Grace
Somme	Somme
Kosuke Nakamachi	Kosuke Nakamachi
Jazmine Sullivan	Jazmine Sullivan
Caramanico Terme	Caramanico Terme
Over Load	Over Load
Weekly Young Magazine	Weekly Young Magazine
Mexican Football Federation	Mexican Football Federation
Prayers	Negaigoto
The 38th longterm stay	Expedition 38
Ibrahim Rugova	Ibrahim Rugova
Chiba City	Chiba Chiba
AS Cittadella	AS Cittadella
Columbus	Columbus Georgia
The Charlatans	The Charlatans
Odawara City	Odawara
George Spencer	George Spencer 4th Duke of Marlborough
Spearmint	Spearmint
Soyuz FG	SoyuzFG
Kazunari Ugaki	Kazushige Ugaki
Carmine Appice	Carmine Appice
Primorye	Primorsky Krai
Carrie Underwood	Carrie Underwood
Douglas County	Douglas County Wisconsin
EC Vitoria	Esporte Clube Vitória
Tessa Virtue	Tessa Virtue
Columbus	Columbus Ohio
Marche	Marche
Daisuke Sakata	Daisuke Sakata
Bank of America Stadium	Bank of America Stadium
Stade Francais Paris	Stade Français
Ali Daei	Ali Daei
Belmont County	Belmont County Ohio
Garicchio	Gallicchio
Stillwater County	Stillwater County Montana
Will Smith	Will Smith
George Edward Moore	G E Moore
LOTUS	Lotus
Cyrus Vance	Cyrus Vance
Choi Yeonglim	Choe Yongrim
Erie County	Erie County New York
Antonio Gramsci	Antonio Gramsci
Randall County	Randall County Texas
Nobuhiro Ishizaki	Nobuhiro Ishizaki
Shelby County	Shelby County Iowa
Gainare Tottori	Gainare Tottori
John H Clifford	John H Clifford
Fredrik Tordendal	Fredrik Thordendal
Christian Wulff	Christian Wulff
Barcelona SC	Barcelona Sporting Club
Avery County	Avery County North Carolina
Merseyside	Merseyside
Jefferson County	Jefferson County New York
Friedrich von Wieser	Friedrich von Wieser
Power of Love	The Power of Love
Montgomery County	Montgomery County Missouri
Cutie Honey	Cutie Honey
Richie James Edwards	Richey Edwards
Ede	Ede Netherlands
Air France	Air France
Gouta Yashiki	Gota Yashiki
Bulgarian Socialist Party	Bulgarian Socialist Party
Delicious season Decisive three minutes	Oishii Kisetsu
Nagasaki City	Nagasaki
Xbox One	Xbox One
Hamburger SV	Hamburger SV
Kingdom of Great Britain	Kingdom of Great Britain
San Juan County	San Juan County Washington
Corriel County	Coryell County Texas
Lester B Pearson	Lester B Pearson
Occitan	Occitan language
solutions45	Solution45
Doni Sasnugueso	Denis Sassou Nguesso
Kirishima City	Kirishima Kagoshima
Sonic the Hedgehog CD	Sonic the Hedgehog CD
François Hollande	François Hollande
Italian Front	Italian Campaign
Small experience	The Love You Save
Uyghur	Old Uyghur alphabet
Gee	Gee
Bay County	Bay County Michigan
Giovanni Silva the Oliveira	Giovanni Silva de Oliveira
Swansea City AFC	Swansea City AFC
Wilkinson County	Wilkinson County Mississippi
Ohm	Orme
Cebuano	Cebuano language
Santos FC	Santos FC
Orban Victor	Viktor Orbán
Roosevelt County	Roosevelt County Montana
Paul Bernays	Paul Bernays
John Dewey	John Dewey
Defensor Sporting	Defensor Sporting
Empire Maker	Empire Maker
Davie County	Davie County North Carolina
Backstreet Boys	Backstreet Boys
Joan Robinson	Joan Robinson
StokeonTrent	StokeonTrent
Tatsuji Fujinami	Tatsumi Fujinami
Home	Home
Dhani Harrison	Dhani Harrison
Aristide Briand	Aristide Briand
Paulo Wanchope	Paulo Wanchope
BYE BYE	Bye Bye
Kollupitiya	Kollupitiya
Kadwallada Washburn	Cadwallader C Washburn
Yuki Mizumoto	Hiroki Mizumoto
Vivid	Vivid
Monke	Möngke Khan
Giants Causeway	Giants Causeway
Saint Clair County	St Clair County Alabama
Hawkins County	Hawkins County Tennessee
CD Lugo	CD Lugo
Led Zeppelin I	Led Zeppelin
Franz Rosenzweig	Franz Rosenzweig
University of Minnesota Twin Cities	University of Minnesota
Juan Francisco Moreno	Juanfran
Sweet Impact	Sweet Impact
Black Flag	Black Flag
David Lloyd Johnston	David Johnston
Takahiro Matsumoto	Tak Matsumoto
Henrico County	Henrico County Virginia
Fedora	Fedora
horrorcore	Horrorcore
Christian Archibald Herter	Christian Herter
iTunes Store	ITunes Store
Viceroyalty of Rio de la Plata	Viceroyalty of the Río de la Plata
Choi Yongsoo	Choi Yongsoo
Come Back to Me	Come Back to Me
George L Harrison	George L Harrison
Palestine	Palestine
Cho Gui Jing	Cho Kwijea
Maurice Allais	Maurice Allais
Civitalparella	Civitaluparella
Anderson Bruford Wakeman Howe	Anderson Bruford Wakeman Howe
German Communist Party	Communist Party of Germany
Karosti characters	Kharosthi
Gary Powell	Gary Powell
Michigan	Michigan
Thomas Ewing	Thomas Ewing
Williams FW16	Williams FW16
Battle of Mexico City	Battle for Mexico City
Saint Clair County	St Clair County Michigan
Merrimack	Merrimack New Hampshire
Henry Fitzalan  Howard	Henry FitzalanHoward 14th Duke of Norfolk
Fortuna Düsseldorf	Fortuna Düsseldorf
Kaneiweg County	Kanabec County Minnesota
The 37th longterm stay	Expedition 37
Buffalo	Buffalo New York
Omotsukiyo  Prayer	Oborozukiyo
Duran Duran	Duran Duran
Beautiful World	Beautiful World
JeanBedel Bokassa	JeanBédel Bokassa
Why did I fall in love with you3F	Dōshite Kimi o Suki ni Natte Shimattandarō3F
Charles Cornwallis	Charles Cornwallis 1st Marquess Cornwallis
Andrew Stevenson	Andrew Stevenson
Nagoya City Mizuho Park Athletic Stadium	Mizuho Athletic Stadium
Polltoli	Pollutri
Touch My Body	Touch My Body
Real Valladolid	Real Valladolid
Stadionur National	Arena Națională
Stop Crying Your Heart Out	Stop Crying Your Heart Out
Shenzhen	Shenzhen
Shijiazhuang Yongchang Football Club	Shijiazhuang Ever Bright FC
Waxie	Waxy
Two Hearts Beat as One	Two Hearts Beat as One
William Patterson	William Paterson
The Runaways	The Runaways
Telenor Arena	Telenor Arena
Rami Hamdallah	Rami Hamdallah
Taro Nakayama	Taro Nakayama
1st Army	First United States Army
John Cale	John Cale
Baby One More Time	Baby One More Time
Sweep	Sweep
Bella Union	Bella Union
George Canning	George Canning
Papal States	Papal States
FLOW THE BEST	Flow The Best
Tatar	Tatar language
Maine de Bilan	Maine de Biran
Vittorio Emanuele II	Victor Emmanuel II of Italy
The Last Samurai	The Last Samurai
明	Ming dynasty
Solate	Soleto
Princeton Institute for Advanced Study	Institute for Advanced Study
Montreal Impact	Montreal Impact
Crosby  Stills Nash  Young	Crosby Stills Nash  Young
Eighth Army	Eighth United States Army
King and Queen County	King and Queen County Virginia
Akihiro Sakata	Akihiro Sakata
Murfreesboro	Murfreesboro Tennessee
Mark E Kelly	Mark Kelly
Bolivia	Bolivia
Abram Hewitt	Abram Hewitt
Stadio Olimpico di Roma	Stadio Olimpico
Gibson SG	Gibson SG
Feel My Heart	Feel My Heart
Manuel Sanchis Ontijuelo	Manuel Sanchís Hontiyuelo
Lacroix	Lacerta
Indian Space Research Organization	Indian Space Research Organisation
Fukushima United FC	Fukushima United FC
Henry VI	Henry VI of England
Sunday Silence	Sunday Silence
To LOVERu	To LoveRu
Redmond	Redmond Washington
Cant Stop Loving You	I Just Cant Stop Loving You
Michel Ariyo  Marie	Michèle AlliotMarie
Kijuro Shidehara	Kijūrō Shidehara
One Vision	One Vision
Thomas Terry Connelly	Tom Connally
President of Malta	President of Malta
YURA・YURA  Vibration	Yura Yura
Communist Party of the Russian Federation	Communist Party of the Russian Federation
Polynesian	Polynesian
Dont shoot the pianist	Dont Shoot Me Im Only the Piano Player
San Joaquin County	San Joaquin County California
Empire of Brazil	Empire of Brazil
Yasuya Uchida	Uchida Kosai
Family Party	Family Party
ETH Zurich	ETH Zurich
Flavor Of Life	Flavor of Life
Yabloko	Yabloko
Maria de las Mercedes de Borbone  dos Sicilias	Princess María de las Mercedes of BourbonTwo Sicilies
Tim Burgess	Tim Burgess
Hamilton County	Hamilton County Texas
Future World	Future World
UEFA Champions League 201011	201011 UEFA Champions League
Gila County	Gila County Arizona
Nakano Ward	Nakano Tokyo
Filipe Nyusi	Filipe Nyusi
Helsingland	Hälsingland
Roger Taney	Roger B Taney
BaltoFinnish languages	Finnic languages
Massafra	Massafra
Jan Peter Balkenende	Jan Peter Balkenende
Aya Matsuura	Aya Matsuura
Symbolical Krises	Symboli Kris S
Moshe Katsav	Moshe Katsav
Vital Remains	Vital Remains
A walk in the park	A Walk in the Park
Aries	Musca
Golgoroth	Gorgoroth
Escape the Fate	Escape the Fate
Arabic Egyptian dialect	Egyptian Arabic
AD Alcorcon	AD Alcorcón
Sylvain Armand	Sylvain Armand
Wayudi Wahid	Wahyudi Wahid
Becamex Binh Duong	Becamex Bình Dương FC
Rodolfo Graziani	Rodolfo Graziani
JosephLouis Lagrange	JosephLouis Lagrange
Kenkichi Ueda	Kenkichi Ueda
Tonga	Tonga
Zane Al  Abidin Ben Ali	Zine El Abidine Ben Ali
You Rock My World	You Rock My World
Simple Plan	Simple Plan
French Championship Top 14	Top 14
Blount County	Blount County Tennessee
Herkimer County	Herkimer County New York
System of a Down	System of a Down
Ogden Mills	Ogden L Mills
Hearts Cry	Hearts Cry
Roger Taylor	Roger Taylor
Province of Pordenone	Province of Pordenone
San Marco La Cátra	San Marco la Catola
Kevin Johnson	Kevin Johnson
Franklin County	Franklin County New York
free	Flea
SEVEN	Seven
cold sea Start in my life	Tsumetai Umi Start in My Life
Gokamatsu Gymnasium	LeSports Center
George Curzon	George Curzon 1st Marquess Curzon of Kedleston
Moshe Ben  Maymon	Maimonides
Smith County	Smyth County Virginia
Regulus	Regulus
Greenland	Greenland
Walt Disney Records	Walt Disney Records
Daegu Stadium	Daegu Stadium
Braxton County	Braxton County West Virginia
George Eliot	George Eliot
Yuri Glazukov	Yury Glazkov
Michael Ökerfeldt	Mikael Åkerfeldt
Derek and the Dominos	Derek and the Dominos
Joao Gilberto	João Gilberto
Edward Brooke	Edward Brooke
LaSalle County	LaSalle County Illinois
Yardbirds	The Yardbirds
San Antonio	San Antonio
Mikan	Mikan
Melbourne Victory FC	Melbourne Victory FC
Iberville County	Iberville Parish Louisiana
rumor	Rumours
The Velvet Underground	The Velvet Underground
Meghan Wing	Megan Wing
Red Star Belgrade	Red Star Belgrade
Lynn County	Linn County Kansas
Hugh Grosvenor	Hugh Grosvenor 1st Duke of Westminster
BABYMETAL	Babymetal
Greek letters	Greek alphabet
Jorge Rivera	Skayde
Spinoso	Spinoso
Madison County	Madison County North Carolina
International Football Federation	FIFA
Theodor Heuss	Theodor Heuss
UFC 25	UFC 25
Nicola Sarkozy	Nicolas Sarkozy
Cupello	Cupello
Winston Churchill	Winston Churchill
Sekiya Ino	Hiroya Ino
Yoshihiro Katayama	Yoshihiro Katayama
Chuwan Leekpai	Chuan Leekpai
Umberto Bossi	Umberto Bossi
Don Felder	Don Felder
Henry John Temple	Henry John Temple 3rd Viscount Palmerston
Narihiro Hachisuka	Hachisuka Narihiro
Gusii	Gusii language
Ganyu Oseni	Ganiyu Oseni
Elena de Borbone y de Grecia	Infanta Elena Duchess of Lugo
Mark Blundell	Mark Blundell
Kurt Campbell	Kurt M Campbell
MASSIVE WONDERS	Massive Wonders
Otis Blue	Otis Blue Otis Redding Sings Soul
Ama City	Ama Aichi
James Madison	James Madison
Force	Force
Rose Francine Rogombe	Rose Francine Rogombé
Muhammad Suissemez	Muhammed Suiçmez
Shigeko Higashikuni	Shigeko Higashikuni
Combined Fleet	Combined Fleet
Galileo	Galileo
The Pope	Pope
Expo 2015 Milano	Expo 2015
Samsung Group	Samsung
David Crosby	David Crosby
Fornax	Fornax
Racing Club	Racing Club de Avellaneda
Church Slavonic	Church Slavonic language
Roxelana	Roxelana
Hunan Express Line	Honam High Speed Railway
STS134	STS134
Matta Louise	Princess Märtha Louise of Norway
CHEMISTRY	Chemistry
CLANNAD	Clannad
City of Eden	Eden no Machi
Graham County	Graham County Kansas
Ethiopian Empire	Ethiopian Empire
Welsh Premier League	Welsh Premier League
KitaNagoya City	Kitanagoya
Army of the Cumberland	Army of the Cumberland
Georgios I	George I of Greece
Yoshiaki Manabe	Yoshiaki Manabe
Thomas Nelson Jr	Thomas Nelson Jr
Hideyoshi Toyotomi	Toyotomi Hideyoshi
Coptic characters	Coptic alphabet
Ah 	Aa
Vaclav Havel	Václav Havel
French	French language
Sapporo	Sapporo
Santomero	SantOmero
Miyabi Natsuyaki	Miyabi Natsuyaki
UFC 82	UFC 82
Maurice Gibb	Maurice Gibb
Tono City	Tōno Iwate
TONE	Tone
Ya  Broad Street	Give My Regards to Broad Street
Suffolk County	Suffolk County New York
Imabari City	Imabari Ehime
Henry Stanbury	Henry Stanbery
Resident Evil Revelations 2	Resident Evil
Linkin Park	Linkin Park
Durham County	Durham County North Carolina
YUI	Yui
Rioni	Lioni
Richard Neville	Richard Neville 16th Earl of Warwick
Shinshin Party	New Frontier Party
Ferrari F2008	Ferrari F2008
Billy Corgan	Billy Corgan
SECOND STORY	Second Story
Central Italian dialect	Central Italian
Luis I	Luís I of Portugal
Emmons County	Emmons County North Dakota
Malmo	Malmö
Pavel Popovich	Pavel Popovich
Central Java	Central Java
Caliphe	Carife
Effingham County	Effingham County Georgia
Province of Cosenza	Province of Cosenza
Nishinomiya City	Nishinomiya
Toyoake City	Toyoake Aichi
Skin Yard	Skin Yard
VOICE	Voice
Democratic Party of Gabon	Gabonese Democratic Party
John Mowbray	John de Mowbray 2nd Duke of Norfolk
Latin	Latin
Calabria	Calabria
Tackey  Tsubasa	Tackey  Tsubasa
Burley	Bull Lea
BOLERO	Bolero
Joseph Muscat	Joseph Muscat
Jerry Brown	Jerry Brown
Israel	Israel
Dean Acheson	Dean Acheson
Forever Love	Forever Love
Take That	Take That
See you tomorrow	Sore dewa Mata Ashita
Pham Van Don	Phạm Văn Đồng
Lebanese Premier League	Lebanese Premier League
Aquila	Aquila
Bruce Schneier	Bruce Schneier
Yoichi Doi	Yoichi Doi
Masquerade	This Masquerade
State of Rio Grande do Sul	Rio Grande do Sul
Marion County	Marion County Mississippi
Northern Ireland	Northern Ireland
UFC 145	UFC 145
Tokelauan	Tokelauan language
Gheorghe Gheorghiu  Desi	Gheorghe GheorghiuDej
Laura Carz	Lola Cars
WEC 43	WEC 43
Tufilo	Tufillo
Södermanland County	Södermanland County
UFC 85	UFC 85
A Night at the Opera	A Night at the Opera
Caldwell County	Caldwell Parish Louisiana
Okidoki	Okey Dokey
Saitama Seibu Lions	Saitama Seibu Lions
Västerbotten County	Västerbotten County
Godflesh	Godflesh
Principality of Serbia	Principality of Serbia
UFC 50	UFC 50
MercedesBenz Superdome	MercedesBenz Superdome
DJ Ashba	DJ Ashba
Turkey National Football Team	Turkey national football team
WAR	War
Spanish	Spaniards
Ryan Babel	Ryan Babel
Fujieda MYFC	Fujieda MYFC
Warren Christopher	Warren Christopher
Putnam County	Putnam County West Virginia
Defster Records	Defstar Records
Singapore Dollar	Singapore dollar
Like a Love3F	Like a Love3F
Hanover World Fair	Expo 2000
Felix Pappalardi	Felix Pappalardi
Arnold Heaney	Arnold Heeney
Gem Archer	Gem Archer
Al Hilal	AlHilal FC
Custer County	Custer County Montana
Pratiba Patil	Pratibha Patil
Volusia County	Volusia County Florida
spiral	Spiral
Paul III	Pope Paul III
Orgasm	Orgasm
Soyuz T9	Soyuz T9
Kingdom of Navarre	Kingdom of Navarre
Bukhara	Bukhori dialect
Karakalpak	Karakalpak language
BEGIN	Begin
Edgar Lung	Edgar Lungu
FC Moscow	FC Moscow
Prime Minister	Prime Minister of Japan
Chowan County	Chowan County North Carolina
Albemarle County	Albemarle County Virginia
Uno 	¡Uno
Reincarnation	Reincarnation
Telugu characters	Telugu script
shellac	Shellac
One Room Disco	One Room Disco
Nintendo DS	Nintendo DS
John Oliva	Jon Oliva
Russell Allen	Russell Allen
Greenville	Greenville South Carolina
Rick Danko	Rick Danko
Empress Michiko	Empress Michiko
Cataraugus County	Cattaraugus County New York
Wilson County	Wilson County Texas
After Earth	After Earth
Fender Jazzmaster	Fender Jazzmaster
Clement VII	Pope Clement VII
Person County	Person County North Carolina
Steve Perry	Steve Perry
Ukrainian	Ukrainian language
DO THE MOTION	Do the Motion
Rick Rubin	Rick Rubin
Kana Muramoto	Kana Muramoto
DIVE TO BLUE	Dive to Blue
BEST FICTION	Best Fiction
Atlanta Campaign	Atlanta Campaign
Park County	Park County Montana
FUSE OF LOVE	Fuse of Love
Fukuoka Softbank Hawks	Fukuoka SoftBank Hawks
Williams FW11	Williams FW11
Cage	Cage
Saski Baskonia	Saski Baskonia
Kenji Sawada	Kenji Sawada
alleged	Alleged
Ri Dynasty	Lý dynasty
Ride	Ride
Ringo Starr	Ringo Starr
Dont wanna cry	Dont Wanna Cry
Neverbend	Never Bend
Lafayette County	Lafayette County Arkansas
Daisuke Nasu	Daisuke Nasu
Valdis Dombrowskis	Valdis Dombrovskis
Beijing Railway Station	Beijing Railway Station
Soyuz TMA11	Soyuz TMA11
Podemos	Podemos
Avengers Assemble	The Avengers
Sacramento Kings	Sacramento Kings
Giaga County	Geauga County Ohio
Omitama City	Omitama
Checker Records	Checker Records
Clark County	Clarke County Virginia
Price County	Price County Wisconsin
Mihai I	Michael I of Romania
Oconee County	Oconee County South Carolina
M60 machine gun	M60 machine gun
Democratic Party	Democratic Party of Japan
Marshallese	Marshallese language
region	Regions of England
Teiichi Tanigaki	Sadakazu Tanigaki
Real Emotion 1000 Words	Real Emotion 1000 no Kotoba
Cinder	Sinndar
Juichi Terauchi	Hisaichi Terauchi
Oromo	Oromo people
Mughal Empire	Mughal Empire
Cerule	Serle
Get Back	Get Back
Martin Schultz	Martin Schulz
Toy Story	Toy Story
Nantucket	Nantucket
Johnny Christ	Johnny Christ
Constantinos II	Constantine II of Greece
Kiss Me GoodBye	Kiss Me GoodBye
Soviet Union	Soviet Union
Kansas City	Kansas City Missouri
Nevermore	Nevermore
Kashiwanoha Park General Stadium	Kashiwanoha Park Stadium
Sacred Sword	Toto IV
If I Let You Go	If I Let You Go
Macedonian	Macedonian language
Lafayette County	Lafayette County Florida
Adams County	Adams County Idaho
Nicholas Katzenbach	Nicholas Katzenbach
Principality of Greater Bulgaria	Principality of Bulgaria
UFC 133	UFC 133
Balestia Khalsa FC	Balestier Khalsa FC
Castro County	Castro County Texas
Pocket Monsters the Movie Diamond  Pearl Giratina and Bouquet of Ice Sky Shaymin	Pokémon
James Hamilton	James Hamilton 3rd Duke of Abercorn
European Socialist Party	Party of European Socialists
Hines County	Hinds County Mississippi
Answer	Answer
RostovonDon	RostovonDon
Hwang Sun Hong	Hwang Sunhong
John Pershing	John J Pershing
Hiroto Komoto	Hiroto Kōmoto
International Super Hits	International Superhits
Clermont Foot	Clermont Foot
Yasutsuna Kigoshi	Kigoshi Yasutsuna
POD	POD
Nicholas of Myra	Saint Nicholas
Let It Bleed	Let It Bleed
Puebla FC	Puebla FC
Mysterious Ways	Mysterious Ways
Kim Seong Soo	Kim Seongsu
Jakarta	Jakarta
Kuan Apaiwong	Khuang Aphaiwong
Kim Young Nam	Kim Yongnam
Lady Gaga	Lady Gaga
Alberta	Alberta
McPherson County	McPherson County South Dakota
Victor Bulwer  Lytton	Victor BulwerLytton 2nd Earl of Lytton
Falaris	Phalaris
James Peek	James Peake
Yankee Stadium	Yankee Stadium
Pritvi Bir Bikram Shaha	Prithvi of Nepal
Millwall FC	Millwall FC
Hermann Müller	Hermann Müller
Japan	Japan
Daryl Hall  John Oates	Hall  Oates
John Paul I	Pope John Paul I
UC Sampdoria	UC Sampdoria
Creator	Kreator
Do You Know What I Mean  3F	DYou Know What I Mean3F
Ferrari F60	Ferrari F60
Yuki Nakai	Yuki Nakai
John Sparkman	John Sparkman
Fender Jazz Bass	Fender Jazz Bass
GNU Core Utilities	GNU Core Utilities
SKIN	Skin
Bunny Yarth SC	Baniyas Club
Pierre Laval	Pierre Laval
John Bonham	John Bonham
Roman Herzog	Roman Herzog
Frederic Chilba	Frederick Chiluba
Rosenda Stadion	Råsunda Stadium
Nigeria	Nigeria
Democratic Justice Party	Democratic Justice Party
Casole Bruzio	Casole Bruzio
Technique	Technique
Adventurers	Bōkenshatachi
Adelaide United FC	Adelaide United FC
house	House music
Midland County	Midland County Michigan
Chris Farlow	Chris Farlowe
Ulyanovsk Oblast	Ulyanovsk Oblast
Giorgio Moroder	Giorgio Moroder
Modest Mouse	Modest Mouse
Yukihiro Takahashi	Yukihiro Takahashi
Republic Records	Republic Records
Cannonball Adderley	Cannonball Adderley
4th Ward Chiba Prefecture	Chiba 4th district
Tag of War	Tug of War
My Beloved Layla	Layla
Pamplona	Pamplona
James McCreary	James B McCreary
James William Trimble	James William Trimble
Edward Rell Madigan	Edward Rell Madigan
Papiamento	Papiamento
Lowndes County	Lowndes County Mississippi
Robert Mercer Talia Fellow Hunter	Robert M T Hunter
Dongguk University	Dongguk University
Muhammad Hussein Tantawi	Mohamed Hussein Tantawi
Sub Pop	Sub Pop
Amintre Fanfani	Amintore Fanfani
Freeman Freeman  Thomas	Freeman FreemanThomas 1st Marquess of Willingdon
Shout to the Walls	Shout to the Walls
John Forsyth	John Forsyth
United States Department of State	United States Department of State
Konrad Adenauer	Konrad Adenauer
Bimlek	Bimelech
Swiss German	Swiss German
Syrian	Syriac alphabet
Guardian	The Guardian
Robert P Letcher	Robert P Letcher
Rosalyn Carter	Rosalynn Carter
Greene County	Greene County Alabama
French Amateur Championship	Championnat de France Amateur
Douglas MacArthur	Douglas MacArthur
Ruined in a Day	Ruined in a Day
Giovanni Leone	Giovanni Leone
Battle of Atlanta	Battle of Atlanta
Offspring	The Offspring
Alison Reed	Allison Reed
Flower funeral	Kasou
February Revolution	February Revolution
Luis Maria de Orleans e Braganza	Prince Luís of OrléansBraganza
Aiken County	Aitkin County Minnesota
Livingston County	Livingston County Kentucky
K League Challenge	K League Challenge
Otto von Bismarck	Otto von Bismarck
Kingdom	Kingdome
Medina County	Medina County Ohio
Battle of Fredericksburg	Battle of Fredericksburg
Shine	Shine
Cochise County	Cochise County Arizona
Richard Woodville	Richard Woodville 1st Earl Rivers
Cars	Cars
Prison Break	Prison Break
Patrick Ewing	Patrick Ewing
Never Forget	Never Forget
Led Zeppelin IV	Led Zeppelin IV
Grand Traverse County	Grand Traverse County Michigan
Rev Beach	Reb Beach
Flowers with love	Ai o Komete Hanataba o
Killing Me	Killing Me
Kazutoshi Kawahara	Kazuhisa Kawahara
Kalamazoo	Kalamazoo Michigan
Lewis County	Lewis County Missouri
CROSS ROAD	Cross Road
Hiragama Line	Pyongbu Line
Magic	Magic
National League	National League
Azerbaijan Football Federation Association	Association of Football Federations of Azerbaijan
Soyuz12	Soyuz 12
Mineral County	Mineral County West Virginia
Young American	Young Americans
John Burgoyne	John Burgoyne
Lee County	Lee County Florida
Chase	Chase
Topville	Top Ville
Keiji Mutoh	Keiji Mutoh
Imola Circuit	Autodromo Enzo e Dino Ferrari
Kagawa Prefectural Marugame Stadium	Kagawa Marugame Stadium
Tenchijin	Tenchijin
Guardian Media Group	Guardian Media Group
Volker Weidler	Volker Weidler
Young Jeezy	Young Jeezy
Zigmanthus balchitis	Zigmantas Balčytis
Boldric	Baldric
Miguel I	Miguel I of Portugal
Basque Country	Basque Country
Lawrence County	Laurens County South Carolina
Lets look up and walk	Sukiyaki
Blelim Jemaili	Blerim Džemaili
Second Manuel Valls Cabinet	Second Valls Government
NOAA	National Oceanic and Atmospheric Administration
Bakhtiari	Bakhtiari dialect
Emperor Goyozei	Emperor GoYōzei
Mick Jones	Mick Jones
Osomatsukun	Osomatsukun
IPod touch	IPod Touch
Edward Ord	Edward Ord
Mitsumasa Yonai	Mitsumasa Yonai
Malaysia	Malaysia
Vine	Vine
Gashugai	Qashqai language
County Tyrone	County Tyrone
Gentaro Kodama	Kodama Gentarō
Ultramarine in a certain town	Aru Machi no Gunjō
Karl XV	Charles XV of Sweden
Saint Clair County	St Clair County Illinois
Phil Spector	Phil Spector
George Voinovich	George Voinovich
Palatino	Palatine Hill
IPhone 5s	IPhone 5S
Jackson County	Jackson County North Carolina
Shinpei Goto	Gotō Shinpei
LGV North Line	LGV Nord
Liverpool	Liverpool
German Socialist Unity Party	Socialist Unity Party of Germany
MFSB	MFSB
Webby	Webbie
Terrorizer	Terrorizer
Ophiuchus	Ophiuchus
Solaai	Soraai
Midsummer Sounds good 	Manatsu no Sounds Good
Carl Menger	Carl Menger
Fukuo Tadayo	Tadayo Fukuo
KallukTurkic languages	Karluk languages
Noboru Takeshita	Noboru Takeshita
Technical Death Metal	Technical death metal
Blur	Blur
AC Ajaccio	AC Ajaccio
First Mariner Arena	Royal Farms Arena
Former German Touring Car Championship	Deutsche Tourenwagen Meisterschaft
Chichester Parkinson  Fortescue	Chichester ParkinsonFortescue 1st Baron Carlingford
Goshogawara City	Goshogawara Aomori
Mumtaz Mahal	Mumtaz Mahal
Webster County	Webster Parish Louisiana
Iron County	Iron County Michigan
Prime Minister	Prime Minister of South Korea
Mantova Province	Province of Mantua
Amway Center	Amway Center
A League	A Lyga
Ursula von der Leyen	Ursula von der Leyen
Arminia Bielefeld	Arminia Bielefeld
Kyoto Station	Kyōto Station
Macon County	Macon County Tennessee
Fort Worth Flyers	Fort Worth Flyers
Green County	Greene County Ohio
Malay	Malay language
Zhang Goryeo	Zhang Gaoli
CAPSULE	Capsule
Equipoise	Equipoise
Discord Records	Dischord Records
Cornish	Cornish language
Personal Ensun	Personal Ensign
Viktoria Sinitsina	Victoria Sinitsina
Sterling County	Sterling County Texas
GD EstorilPraia	GD Estoril Praia
Clement Attlee	Clement Attlee
Screamo	Screamo
Cherokee County	Cherokee County Georgia
Harriet Harman	Harriet Harman
Marion County	Marion County Indiana
Kensuke Sasaki	Kensuke Sasaki
Daiyamonde	Daiyamonde
Bullet for my Valentine	Bullet for My Valentine
Charles Wood	Charles Wood 1st Viscount Halifax
Motley Crue	Mötley Crüe
Awakening of Poseidon	In the Wake of Poseidon
Beautiful  Dirty Rich	Beautiful Dirty Rich
PASSENGER	Passenger
Windows Mobile	Windows Mobile
Alexander Hugh Holmes Stewart	Alexander Hugh Holmes Stuart
Gambia	The Gambia
Niagara Falls	Niagara Falls New York
Jawaharlal Nehru	Jawaharlal Nehru
Birmingham City FC	Birmingham City FC
Ector County	Ector County Texas
Vestergötland	Västergötland
MOON blossom	Moon Blossom
US Ambassador to Japan	United States Ambassador to Japan
Sindhi	Sindhi language
Lindsey Buckingham	Lindsey Buckingham
After Dark	After Dark
The Ultimate Fighter 17 Finale	The Ultimate Fighter
Machej Novak	Matěj Novák
Andrzej Duda	Andrzej Duda
In Another World	Dans un autre monde
Johann Schneider  Ammann	Johann SchneiderAmmann
Alone in my room	Alone in My Room
Graham Bonnet	Graham Bonnet
Mondaris	Mondariz
Saidanza	Ara
Barry County	Barry County Michigan
University of Melbourne	University of Melbourne
Yosuke Fujigaya	Yōsuke Fujigaya
François Mauriac	François Mauriac
Ewe	Ewe language
George Karl	George Karl
Mago Tsuru Kei	Sohn Hakkyu
Nouhak Poomsawan	Nouhak Phoumsavanh
Howard University	Howard University
William Lyon Mackenzie King	William Lyon Mackenzie King
John Stark	John Stark
Gulf Rupee	Gulf rupee
Shimizu SPulse	Shimizu SPulse
Williams FW19	Williams FW19
Ricky Nelson	Ricky Nelson
AKB48	AKB48
Central Federal District	Central Federal District
Bighorn County	Big Horn County Montana
Linda McCartney	Linda McCartney
Everlasting	Everlasting
Soyuz TMA2	Soyuz TMA2
Relapse Records	Relapse Records
Saint Helena County	Saint Helena Parish Louisiana
Henri Matisse	Henri Matisse
Keith Mitchell	Keith Mitchell
The charm is amazing	Miryoku ga Sugoi yo
Hello Sadness	Kanashimi yo Konnichi wa
Dark Castle Entertainment	Dark Castle Entertainment
Masayoshi Ito	Masayoshi Ito
Tosuke Hirata	Hirata Tosuke
Plastic Ono Band	Plastic Ono Band
Talking Book	Talking Book
Crys Calico	Krizz Kaliko
SNOW FLAKE  Memory Persistence  PULSE	Snow Flake
Banharn Shirapa Archer	Banharn Silpaarcha
Igor Spyriband	Igor Shpilband
First Army	First Army
Hands	Hands
Valery Kuvasov	Valeri Kubasov
DoKiDoKi☆Morning	Doki Doki Morning
Don Dokken	Don Dokken
James Murphy	James Murphy
Friedrich Schiller University Jena	University of Jena
WHITE ALBUM	White Album
Sugar	Sugar
Wood County	Wood County West Virginia
Secret of my heart	Secret of My Heart
Province of Piacenza	Province of Piacenza
A Le Coq Arena	A Le Coq Arena
Allen Iverson	Allen Iverson
Rebirth	Rebirth
Zushi City	Zushi Kanagawa
Morgan County	Morgan County West Virginia
Ai no Uta	Ai no Uta
LaLa	LaLa
Elena Ilyinov	Elena Ilinykh
Naruto City	Naruto Tokushima
Rasmus Lindgren	Rasmus Lindgren
Alena Khimki	Arena Khimki
National Kasumigaoka Athletic Stadium	National Olympic Stadium
Nepal	Nepal
Love the island	Love the Island
Somerset County	Somerset County New Jersey
Akbar	Akbar
Jackson5	The Jackson 5
Chilean Socialist Party	Socialist Party of Chile
Gillingham FC	Gillingham FC
Burk County	Burke County North Dakota
Urdu	Urdu alphabet
Barham	Bahram
Milwaukee Railroad	Chicago Milwaukee St Paul and Pacific Railroad
Richard P Feynman	Richard Feynman
Italian Democratic Socialist Party	Italian Democratic Socialist Party
Melodic Hardcore	Melodic hardcore
European Tour	PGA European Tour
Mind Games	Mind Games
Edogawa	Edo River
Syria	Syria
Hickman County	Hickman County Tennessee
Phillips II Arena	Philip II Arena
Hungaroring	Hungaroring
Babe	Babe
George Goschen	George Goschen 1st Viscount Goschen
Uva Province	Uva Province
Magic Power of Love	Whats Love Got to Do with It
James Buchanan	James Buchanan
Maximilian	Maximilian I of Mexico
Hungarian Peoples Republic	Hungarian Peoples Republic
Ilya Tokachenko	Ilia Tkachenko
Bolton Wanderers FC	Bolton Wanderers FC
Leopold II	Leopold II Holy Roman Emperor
Zahiagine Elbegdorj	Tsakhiagiin Elbegdorj
Josiah Tattnall	Josiah Tattnall
Trung Chin	Trường Chinh
Tamara Moskvina	Tamara Moskvina
Halland County	Halland County
Sauber C14	Sauber C14
My Dinh National Stadium	Mỹ Đình National Stadium
Shanxi	Shanxi
John Singer Sargent	John Singer Sargent
Tascalawas County	Tuscarawas County Ohio
TPain	TPain
The Internet	The Internet
Goro Matsui	Gorō Matsui
Gilles de Ferrand	Gil de Ferran
True Face	True Faith
Terry Chimes	Terry Chimes
Albert II	Albert II Prince of Monaco
Hungarian Grand Prix	Hungarian Grand Prix
Mastodon	Mastodon
Fitzhugh Lee	Fitzhugh Lee
President of Mongolia	President of Mongolia
Soyuz 15	Soyuz 15
Lorne County	Roane County West Virginia
Sanzo Nosaka	Sanzo Nosaka
Ferdinand I	Ferdinand I of Bulgaria
Great American Ball Park	Great American Ball Park
Reds	Queensland Reds
Rolling Stones	The Rolling Stones
Pork County	Polk County Georgia
Caroline Kennedy	Caroline Kennedy
Stained	Staind
Koryomal	Koryomar
Rainbow	Niji
Football Federation of Australia	Football Federation Australia
Louisiana State University	Louisiana State University
Serbia	Serbia
John Adair	John Adair
Keisuke Kurihara	Keisuke Kurihara
SouthendonSea	SouthendonSea
Kobe Universiade Memorial Stadium	Kobe Universiade Memorial Stadium
Sylvia	Queen Silvia of Sweden
Baltimore Orioles	Baltimore Orioles
United Russia	United Russia
Barry Adamson	Barry Adamson
UEFA EURO 2016 Qualifying Group B	UEFA Euro 2016 qualifying Group B
J	J
Winter Love	Winter Love
Thabo Mbeki	Thabo Mbeki
HSBC Arena	HSBC Arena
Cyril Neville	Cyril Neville
IPhone 4	IPhone 4
Marvelettes	The Marvelettes
Biyuden	Vuden
Hidehiko Hoshino	Hidehiko Hoshino
UFC 60	UFC 60
Iichiro Hatoyama	Iichirō Hatoyama
Yuchun	Park Yoochun
George Osborne	George Osborne
Whiteside County	Whiteside County Illinois
Portage County	Portage County Ohio
Burger	Burgher people
Overton County	Overton County Tennessee
Richland County	Richland County Wisconsin
Chester Nimitz	Chester W Nimitz
Slint	Slint
Denis Diderot	Denis Diderot
Louisiana	Louisiana
Monthly Shonen Ace	Monthly Shōnen Ace
Ligurian	Ligurian
George Crook	George Crook
Shelby County	Shelby County Ohio
Phil Anselmo	Phil Anselmo
Eternal King Kitashirakawa	Prince Nagahisa Kitashirakawa
Hosni Mubarak	Hosni Mubarak
Always	Always
Okeechobee County	Okeechobee County Florida
Kiyoshi Maekawa	Kiyoshi Maekawa
Zatetrak	The Tetrarch
Misaki Park Stadium	Misaki Park Stadium
Synergy	Sinergy
Fugazi	Fugazi
NBCUniversal	NBCUniversal
You	You
power pop	Power pop
Hamlin County	Hamlin County South Dakota
Julian Lennon	Julian Lennon
Timo Turki	Timo Tolkki
Jared Ingersoll	Jared Ingersoll
To your town	Kimi no Machi Made
William Grenville	William Grenville 1st Baron Grenville
Marcos Venancio de Albuquerque	Ceará
Toshiba	Toshiba
GIRL NEXT DOOR	Girl Next Door
Hailtreeson	Hail To Reason
Sportsmans Park	Sportsmans Park
Angola	Angola
Heng Samrin	Heng Samrin
Baby Dont Cry	Baby Dont Cry
Shelmer	Schermer
Labor Party	Labour Party
Jefferson County	Jefferson County Alabama
Takeo Kawamura	Takeo Kawamura
Astrid de Suede	Astrid of Sweden
Robert Oppenheimer	J Robert Oppenheimer
Milton Keynes	Milton Keynes
Soyuz TMA8	Soyuz TMA8
Raymond Poincare	Raymond Poincaré
Hiaki Maeda	Akira Maeda
Descore	Deathcore
	Pau PyrénéesAtlantiques
Teruyuki Moniwa	Teruyuki Moniwa
Shinjiro Koizumi	Shinjirō Koizumi
Magic Christian Music	Magic Christian Music
Gonzales County	Gonzales County Texas
Scott County	Scott County Tennessee
Aerosmith	Aerosmith
Kirkland	Kirkland Washington
Sturdy House	Hardhome
Bonner County	Bonner County Idaho
Maria II	Maria II of Portugal
Shamoser	Chamossaire
Hovhannes Kachaznuni	Hovhannes Kajaznuni
Serbian Cup	Serbian Cup
Klaus Meine	Klaus Meine
Oregon County	Oregon County Missouri
corn	Korn
Wilfredo Pareto	Vilfredo Pareto
Wild in the Streets	Slippery When Wet
ROSIER	Rosier
Camden County	Camden County Missouri
AFC Champions League	AFC Champions League
Julia Obertas	Julia Obertas
The Beatles 65	Beatles 65
Brain Reform	Piece of Mind
Anders Frieden	Anders Fridén
Make You Happy	Make You Happy
Prince Rose	Prince Rose
Tomorrows way	Tomorrows Way
Polydor Records	Polydor Records
EmiliaRomagna	EmiliaRomagna
Sum 41	Sum 41
Hollogin Choibalsan	Khorloogiin Choibalsan
Akio Kuma	Fumio Kyūma
Cameroon	Cameroon
Ernst Kaltenbrunner	Ernst Kaltenbrunner
UEFA EURO 2016	UEFA Euro 2016
℃ute	Cute
Benedict XV	Pope Benedict XV
Henry Alexander Wise	Henry A Wise
Metroid	Metroid
Tulare County	Tulare County California
SLV	Satellite Launch Vehicle
Pete Sinfield	Peter Sinfield
Kazimierz Marcinkiewicz	Kazimierz Marcinkiewicz
Thomas Corwin	Thomas Corwin
overprotected	Overprotected
Chiefs Crown	Chiefs Crown
Reading	Reading Berkshire
Ulrika Eleonora av Danmark	Ulrika Eleonora of Denmark
Artpop	Artpop
Aroon Progressive	Gō on Progressive
Pedro Rodriguez Ledesma	Pedro
Blue	Blue
Thea	Sia Furler
Kingdom of Yugoslavia	Kingdom of Yugoslavia
Munetaka Higuchi	Munetaka Higuchi
Shenyang	Shenyang
The Great Castle of Harren	The Ghost of Harrenhal
Dance Punk	Dancepunk
Burning Rain	Burning Rain
Pen Noot	Penn Nouth
Henry Fitzalan  Howard	Henry FitzalanHoward 15th Duke of Norfolk
Paul von Hindenburg	Paul von Hindenburg
Stray Heart	Stray Heart
Yuki no Hana	Yuki no Hana
DiVA	Diva
Lovin  You Baby	I Was Made for Lovin You
Royal Academy	Royal Academy
Masaaki Shirakawa	Masaaki Shirakawa
Greatest Hits III  Dedicated to Freddie Mercury 	Greatest Hits III
Lee ChunSu	Lee Chunsoo
William Westmoreland	William Westmoreland
Agrigento Province	Province of Agrigento
Shamaldar	Shamardal
Fumitake Miura	Fumitake Miura
Suzuka City	Suzuka Mie
New Wave	New wave music
Steve Jones	Steve Jones
Tom Ridge	Tom Ridge
Dinwiddie County	Dinwiddie County Virginia
Romanian	Romanian language
Pierre Mesmer	Pierre Messmer
Dim Boger	Dimmu Borgir
The Circus	The Circus
Stellan Skarsgård	Stellan Skarsgård
Yukihiro	Yukihiro
The Tears	The Tears
Madhav Kumar Nepal	Madhav Kumar Nepal
George Marshall	George Marshall
Colin	Colin
Chelmsford	Chelmsford
Boskey County	Bosque County Texas
Wembley Stadium	Wembley Stadium
5 Seconds of Summer	5 Seconds of Summer
Ebetsu City	Ebetsu Hokkaido
New Approach	New Approach
Batak characters	Batak alphabet
Knox County	Knox County Illinois
DAISHI DANCE	Daishi Dance
Joichi Ito	Joi Ito
Oskar Zariski	Oscar Zariski
Country Blues	Country blues
MercedesBenz Stadium	MercedesBenz Stadium
Hertfordshire	Hertfordshire
Oyabe City	Oyabe Toyama
Lilac	Syringa vulgaris
Sadistic Mika Band	Sadistic Mika Band
Battle of Mine Run	Battle of Mine Run
Twilight Brick Road	Goodbye Yellow Brick Road
LAquila Department	Province of LAquila
Rudolph Giuliani	Rudy Giuliani
George W Bush	George W Bush
Chen Chao	Trần dynasty
Alexander II	Alexander II of Russia
Martirano Lombardo	Martirano Lombardo
Giant Baba	Giant Baba
Capouti	Capote
Rob Portman	Rob Portman
Allan Holdsworth	Allan Holdsworth
The Secret Code	The Secret Code
Isabela County	Isabella County Michigan
Ishikari Promotion Bureau	Ishikari Subprefecture
Switzerland National Football Team	Switzerland national football team
Shujiro Nagata	Hidejirō Nagata
Shinshiro City	Shinshiro Aichi
Rose	The Rose
Yuozas Orekas	Juozas Olekas
Camden County	Camden County North Carolina
William Blake	William Blake
Ilya Glebov	Ilja Glebov
Joshua Chamberlain	Joshua Chamberlain
Horst Zindermann	Horst Sindermann
Abel Barbo	Abel Balbo
Orange County	Orange County Texas
Bakir Izetbegovic	Bakir Izetbegović
WISH	Wish
MGM Records	MGM Records
John Middleton Clayton	John M Clayton
Bletchingley	Bletchingly
Trivium	Trivium
Lincoln County	Lincoln County West Virginia
Kofu City	Kōfu
Salt Lake County	Salt Lake County Utah
Radiohead	Radiohead
Burley County	Burleigh County North Dakota
Crypteria	Krypteria
Devo	Devo
Henry County	Henry County Illinois
Dolly Parton	Dolly Parton
Tottori Municipal Soccer Stadium	Tottori Bank Bird Stadium
Ian McLagan	Ian McLagan
Frio County	Frio County Texas
STS128	STS128
Kind of Magic	A Kind of Magic
The Stalin	The Stalin
Kingdom of Cyprus	Kingdom of Cyprus
Vytautas Landsbergis	Vytautas Landsbergis
Sacred House	Houses of the Holy
Emperor Entertainment Group	Emperor Entertainment Group
Grade County	Glades County Florida
Mr	Mister
Tyne and Wear	Tyne and Wear
Richard Nixon	Richard Nixon
Billy Cobham	Billy Cobham
North Ndebele	Zimbabwean Ndebele language
Norodom Ranaridit	Norodom Ranariddh
Brandon Flowers	Brandon Flowers
François Fillon	François Fillon
Southern Province	Southern Province Sri Lanka
Steve Strange	Steve Strange
Ilhan Mansuz	İlhan Mansız
Doraemon Nobitas history of space exploration	Doraemon
Oleg Vasiliev	Oleg Vasiliev
Jani Stefanovic	Jani Stefanovic
Mary I	Mary I of England
Wake County	Wake County North Carolina
Semitic	Semitic languages
Balkh Province	Balkh Province
Rabbit	Lepus
Hu Jintao	Hu Jintao
Ron Paul	Ron Paul
Fergie Frederiksen	Dennis Frederiksen
Jackson	Jackson Mississippi
Swedish	Swedes
University of London	University of London
Jorg Michael	Jörg Michael
Primera Division	Argentine Primera División
Within Temptation	Within Temptation
Single collection nicopachi	Single Collection
Aozora Pedal	Aozora Pedal
Toyota TF109	Toyota TF109
Boys Like Girls	Boys Like Girls
Irish October	October
Shelby County	Shelby County Missouri
Chung Dongyoung	Chung Dongyoung
Karachi	Karachi
Pasquale Camerengo	Pasquale Camerlengo
Arlen Spector	Arlen Specter
Jason Newsted	Jason Newsted
Alain Prost	Alain Prost
Patrice Lauzon	Patrice Lauzon
Government of the Russian Federation	Government of Russia
Bay Middleton	Bay Middleton
Randolph County	Randolph County West Virginia
Algirdas Butkevichus	Algirdas Butkevičius
roll with it	Roll with It
David Villa	David Villa
Florence and the Machine	Florence and the Machine
Washington County	Washington Parish Louisiana
Charles de Montesquieu	Montesquieu
West Flemish	West Flemish
Affection	Affection
Province of Milan	Province of Milan
Bunkyo Ward	Bunkyō
Forsyth County	Forsyth County North Carolina
Juventus Stadium	Juventus Stadium
The 41st Long Stay	Expedition 41
Ionia County	Ionia County Michigan
Dionne Warwick	Dionne Warwick
Massimo Scali	Massimo Scali
Endless sorrow	Endless Sorrow
Tattnall County	Tattnall County Georgia
Chariton County	Chariton County Missouri
Hideo Kodama	Hideo Kodama
Derby	Derbi
AJ Auxerre	AJ Auxerre
Jeff Loomis	Jeff Loomis
World in Motion	World in Motion
Darkane	Darkane
Decatur	Decatur Georgia
Lapland	Lapland
Uvalde County	Uvalde County Texas
Premier Liga	Premier League of Bosnia and Herzegovina
Smart Strike	Smart Strike
Baltic Empire	Swedish Empire
Rugby Football Union	Rugby Football Union
Bad Romance	Bad Romance
Ronnie Lane	Ronnie Lane
Livin  on a Player	Livin on a Prayer
The Beatles	The Beatles
John Bassett Moore	John Bassett Moore
Sarceda de Caseras	Salceda de Caselas
US Secretary of the Interior	United States Secretary of the Interior
Pink Spider	Pink Spider
Alexander McCook	Alexander McDowell McCook
TBS	TBS
CF Belenenses	CF Os Belenenses
Kushiro General Promotion Bureau	Kushiro Subprefecture
Bowling for Soup	Bowling for Soup
Queens County	Queen Annes County Maryland
Lou Reed	Lou Reed
Korean War	Korean War
Jones County	Jones County Texas
disco	Disco
Thomas Hobbes	Thomas Hobbes
Dmitry Medvedev	Dmitry Medvedev
Daniel Butterfield	Daniel Butterfield
Democratic Party	Democratic Party
Dinosaur Jr	Dinosaur Jr
Clifford Husbans	Clifford Husbands
CW Television Network	The CW
Tupolev	Tupolev
Nice	Nice
Mickey Mouse	Mickey Mouse
UFC 101	UFC 101
Saint Croix County	St Croix County Wisconsin
Shauki Ben Saada	Chaouki Ben Saada
Toranosuke Katayama	Toranosuke Katayama
East of England	East of England
Etmund Husserl	Edmund Husserl
Guillaume de Luxembourg	Guillaume Hereditary Grand Duke of Luxembourg
Al Faisaly Amman	AlFaisaly SC
Alan Wilder	Alan Wilder
Chiptune	Chiptune
Spiritual Beggars	Spiritual Beggars
Hugh Swinton Legley	Hugh S Legaré
Fukuyama City	Fukuyama Hiroshima
Al Wahdat Club	AlWehdat SC
Stranger	The Stranger
Julian Casablancas	Julian Casablancas
accept	Accept
Edward Stanley	Edward Stanley 15th Earl of Derby
Battle of the Bulge	Battle of the Bulge
Tears	Tears
Bryan County	Bryan County Georgia
QueenPaul Rogers	Queen  Paul Rodgers
Lars Valerian Alfors	Lars Ahlfors
Alexey Mikhailchenko	Oleksiy Mykhaylychenko
Maxim Stavisky	Maxim Staviski
East Asian Football Federation	East Asian Football Federation
Komono Town	Komono Mie
Saint Louis County	St Louis County Minnesota
Naoto Kan	Naoto Kan
Montgomery County	Montgomery County North Carolina
Victory	Victory
New York City Subway	New York City Subway
Brigham Young University	Brigham Young University
Astrid de Belgic	Princess Astrid of Belgium Archduchess of AustriaEste
Cearer SC	Ceará Sporting Club
WNBA	Womens National Basketball Association
SoyuzU2	SoyuzU2
Artur Dmitriev	Artur Dmitriev
Catch Me If you wanna	Catch Me
Moscow University of International Relations	Moscow State Institute of International Relations
Paul Doumer	Paul Doumer
Janis Joplin	Janis Joplin
George J Tenet	George Tenet
Moore County	Moore County Texas
Kosovo Socialist Autonomous Region	Socialist Autonomous Province of Kosovo
Emmanuel Pirro	Emanuele Pirro
Tongan	Tongan language
Ensiferum	Ensiferum
Kantai Collection Kancolle	Kantai Collection
Kasugai City	Kasugai Aichi
Des Moines County	Des Moines County Iowa
Prime Minister of France	Prime Minister of France
Edin Dzeko	Edin Džeko
Lout County	Routt County Colorado
Nashua	Nashua
Olim Nakhkarov	Olim Navkarov
Edward Lowe	Edward Law 1st Earl of Ellenborough
JeanPierre Jausseau	JeanPierre Jaussaud
Southern Army	Southern Expeditionary Army Group
Duchy of SaxeCoburgGotha	SaxeCoburg and Gotha
Arcona County	Alcona County Michigan
James Callaghan	James Callaghan
Tama Ward	Tamaku Kawasaki
Stoner Rock	Stoner rock
Isshiki	Hitoiro
H	H
Im Gonna SCREAM	Im Gonna Scream
William Frist	Bill Frist
Mark Arm	Mark Arm
Tarim	Trym Torson
Careless Whisper	Careless Whisper
FC Lokomotiv Moscow	FC Lokomotiv Moscow
Dodge County	Dodge County Wisconsin
Benjamin Wade	Benjamin Wade
STS32	STS32
Ukigumo	Ryosuke Nagaoka
Richard Cross	R A Cross 1st Viscount Cross
Vancouver	Vancouver
Sound Horizon	Sound Horizon
Mflo	MFlo
Lisbon	Lisbon
Spring of Life	Spring of Life
Hocking County	Hocking County Ohio
Tokushima Prefecture	Tokushima Prefecture
Dancer of the Night	Yoru no Odoriko
List of Chilean Presidents	President of Chile
History Past  Present and Future Book 1	HIStory
Melon Memorial Day	Melon Kinenbi
Victor Metcalfe	Victor H Metcalf
Merciful Fate	Mercyful Fate
European Conservative Reform Alliance	Alliance of European Conservatives and Reformists
Martignano	Martignano
San Marino	San Marino
US Secretary of Veterans Affairs	United States Secretary of Veterans Affairs
Calcasieu County	Calcasieu Parish Louisiana
MICHAEL	Michael
Andrew H Foote	Andrew Hull Foote
3rd Division	3rd Division
Maitripala Sirisena	Maithripala Sirisena
Mexico	Mexico
Century Media Records	Century Media Records
Wolf Hidden	Ōkami Kakushi
Racer X	Racer X
Forever the Sickest Kids	Forever the Sickest Kids
Republic of Vietnam Air Force	Vietnam Air Force
James Lawrence Orr	James Lawrence Orr
Charles Bolden	Charles Bolden
Chardon	Challedon
Windows Movie Maker	Windows Movie Maker
Jiss Boy	This Boy
Adelaide Urban Course	Adelaide Street Circuit
CenturyLink Fields	CenturyLink Field
Samaritan	Samaritan alphabet
Battle of Yellow Tavan	Battle of Yellow Tavern
Yuki Ikemoto	Tomoki Ikemoto
Back to the Future PART2	Back to the Future Part II
If You Ask Me To	If You Asked Me To
John Locke	John Locke
Kraftwerk	Kraftwerk
Lancaster County	Lancaster County Pennsylvania
Limburg	Limburg
BEST SELECTION 2010	Best Selection 2010
Fat Wreck Causes	Fat Wreck Chords
Kohoku Ward	Kōhokuku Yokohama
Fire and Blood	Fire and Blood
Parajano	Palagiano
Feyenoord Stadion	De Kuip
Josep Borrell	Josep Borrell
Stephen Douglas	Stephen A Douglas
Denver Nuggets	Denver Nuggets
Montefredane	Montefredane
Calvin Coolidge	Calvin Coolidge
Departure	Departure
Drake	Drake
AngloFrisian Group	AngloFrisian languages
John Y Brown Jr	John Y Brown Jr
Thespakusatsu Gunma	Thespakusatsu Gunma
Monthly CoroCoro Comic	CoroCoro Comic
Marco Rubio	Marco Rubio
Tei Towa	Towa Tei
W Averell Harriman	W Averell Harriman
Wageningen	Wageningen
Newminster	Newminster
Supreme Leader of Iran	Supreme Leader of Iran
Yangon United FC	Yangon United FC
Gibylla von Sachsen  Coburg Gotha	Princess Sibylla of SaxeCoburg and Gotha
Benjamin Franklin	Benjamin Franklin
Donald Rumsfeld	Donald Rumsfeld
Monongalia County	Monongalia County West Virginia
Alfred Gusenbauer	Alfred Gusenbauer
Oxfordshire	Oxfordshire
US dollars	United States dollar
Seward County	Seward County Kansas
Soyuz TM26	Soyuz TM26
Nghe An Province	Nghệ An Province
Eyed Wait for Life	Id Wait for Life
Albert Hammond Jr	Albert Hammond Jr
Ono City	Ōno Fukui
Sabine County	Sabine Parish Louisiana
Arthur W Radford	Arthur W Radford
Shaman	Shaman
Hans Zimmer	Hans Zimmer
Brazil	Brazil
Wibbo County	Wibaux County Montana
Take a Bow	Take a Bow
Riccardo Fati	Ricardo Faty
John Howard	John Howard 1st Duke of Norfolk
Ichinosuke Oka	Oka Ichinosuke
Imangalli Tasmagambetov	Imangali Tasmagambetov
Shigenobu Okuma	Ōkuma Shigenobu
STS122	STS122
Guinea	Guinea
Mikhail Gorbachev	Mikhail Gorbachev
Borose	Borås
Jet	Jet
Say Anything	Say Anything
Coventry	Coventry
SR Nathan	S R Nathan
RocknRoll Circus	Rock n Roll Circus
Haruomi Hosono	Haruomi Hosono
CRUSH	Crush
CA Juventus	Clube Atlético Juventus
Takaya Kurokawa	Takaya Kurokawa
Las Vegas	Las Vegas
Cuckoo	Common cuckoo
Thomas Howard	Thomas Howard 3rd Duke of Norfolk
Sheikh Zayed Stadium	Zayed Sports City Stadium
Wish You The Best	Wish You the Best
Dubstep	Dubstep
Genuine	Genuine
Desha County	Desha County Arkansas
Prince Tomohito	Prince Tomohito of Mikasa
Skiffle	Skiffle
FC Ryukyu	FC Ryūkyū
Shrewsbury Town FC	Shrewsbury Town FC
A Perfect Circle	A Perfect Circle
Chinese Kuomintang	Kuomintang
John Davis Long	John Davis Long
Hugh McCulloch	Hugh McCulloch
Five Finger Death Punch	Five Finger Death Punch
Spongano	Spongano
Haakon VII	Haakon VII of Norway
Gerald Green	Gerald Green
Dingiri Bandar Wijeetunga	Dingiri Banda Wijetunga
Central Party of Finland	Centre Party
play	Pray
Apollo 14	Apollo 14
Kawasaki City	Kawasaki Kanagawa
DocumentaLy	Documentaly
International Baseball Federation	International Baseball Federation
President of India	President of India
Simeon Sakskoburg Gotzki	Simeon SaxeCoburgGotha
WaffenSS	WaffenSS
Riley County	Riley County Kansas
Yunnan	Yunnan
Mehdi Bazargan	Mehdi Bazargan
Hartford	Hartford Connecticut
Man in the Mirror	Man in the Mirror
Edwin Sumner	Edwin Vose Sumner
Quezon	Quezon City
Buyeo	Buyeo languages
Ultravox	Ultravox
Saint Charles County	St Charles County Missouri
Vatican	Vatican City
Ehime Prefecture	Ehime Prefecture
Heizo Takenaka	Heizō Takenaka
CANDY GIRL	Candy Girl
TIME	Time
German Empire	German Empire
Westerly	Westerly Rhode Island
Motorhead	Motörhead
India National Football Team	India national football team
NEC Green Rockets	NEC Green Rockets
Nizza Ebb	Nitzer Ebb
The Seven Deadly Sins	The Seven Deadly Sins
My Love	My Love
Fantastic Mac	Fleetwood Mac
Tiznow	Tiznow
Presence	Presence
Kings of Leon	Kings of Leon
Carnage	Carnage
Electric Light Orchestra	Electric Light Orchestra
Ullevi	Ullevi
Aomori City	Aomori Aomori
Anzenchitai	Anzen Chitai
Sakhalin Oblast	Sakhalin Oblast
Hubei	Hubei
Duty	Duty
Yasunari Kawabata	Yasunari Kawabata
Vance County	Vance County North Carolina
Markus Babel	Markus Babbel
Yoko Kanno	Yoko Kanno
M83	M83
Yachiyo City	Yachiyo Chiba
Minnesota Timberwolves	Minnesota Timberwolves
President of Latvia	President of Latvia
UFC Fight Night	UFC Fight Night
London Heathrow Airport	Heathrow Airport
E	E
Post Grunge	Postgrunge
Scala	Scala
Pedro Bispo Moreira Junior	Pedro Júnior
Maria Feodorovna	Maria Feodorovna
Valkyria Chronicles	Valkyria Chronicles
South East England	South East England
Tim Skold	Tim Sköld
Neil Halstead	Neil Halstead
Pyongyang Station	Pyongyang Station
Yuya Niwa	Yuya Niwa
Windsor Park	Windsor Park
Mamunoon Hussain	Mamnoon Hussain
Luke Edward Wright	Luke Edward Wright
Thomas Hitzlsperger	Thomas Hitzlsperger
Inspiration is DEAD	Inspiration Is Dead
Joseph Holt	Joseph Holt
Mariahs Storm	Mariahs Storm
Toyota TF108	Toyota TF108
Yadkin County	Yadkin County North Carolina
UFC Live	UFC Live
Liaoning	Liaoning
Identity	Identity
Charles Howard	Charles Howard 11th Duke of Norfolk
Yoshiaki Hatta	Yoshiaki Hatta
Kearney County	Kearny County Kansas
Knox County	Knox County Ohio
Charles County	Charles County Maryland
Riccardo Liddell	Rickard Rydell
Jorn Lande	Jørn Lande
Glen Johnson	Glen Johnson
Infuse your body with love	Ai o Karada ni Fukikonde
Sissago County	Chisago County Minnesota
Felix de Luxembourg	Prince Félix of Luxembourg
Top Gear	Top Gear
Coshocton County	Coshocton County Ohio
The Beatles are Coming Ya Ya Ya	A Hard Days Night
pop music	Pop music
Kiss	Kiss
Changing of the Guard	Changing of the Guards
Aryan Brotherhood	Aryan Brotherhood
Gay Crusader	Gay Crusader
Chuck Berry	Chuck Berry
Roy Khan	Roy Khan
SST record	SST Records
Kim Il Sung	Kim Ilsung
Clay County	Clay County Tennessee
Yuki Kashiwagi	Yuki Kashiwagi
Valentinas Masronis	Valentinas Mazuronis
Walworth County	Walworth County Wisconsin
Latvia	Latvia
Louis Mountbatten	Louis Mountbatten 1st Earl Mountbatten of Burma
BOOM BOOM SATELLITES	Boom Boom Satellites
FC Spartak Moscow	FC Spartak Moscow
See	San
President of the Republic	President of France
Osami Nagano	Osami Nagano
McDowell County	McDowell County North Carolina
Warren County	Warren County Mississippi
Republic of Korea	South Korea
Lionel Nathan de Rothschild	Lionel Nathan de Rothschild
1st Marine Division	1st Marine Division
Milton Nascimento	Milton Nascimento
Dream Traveler	Mull of Kintyre
Robert Jenkinson	Robert Jenkinson 2nd Earl of Liverpool
James II	James II of England
Augustus Fitzroy	Augustus FitzRoy 3rd Duke of Grafton
Air Macau	Air Macau
Dont Look Back Into The Sun	Dont Look Back into the Sun
Yoshifumi Fujita	Yoshihito Fujita
Racing 92	Racing 92
Yolo County	Yolo County California
Kurt Georg Kiesinger	Kurt Georg Kiesinger
Didier Drogba	Didier Drogba
Jahangir	Jahangir
Raleigh County	Raleigh County West Virginia
Olimpiyski Stadium	Olimpiyskiy National Sports Complex
Bulgaria national football team	Bulgaria national football team
Chuvash Republic	Chuvashia
Brighton	Brighton
Lao script	Lao alphabet
High Wycombe	High Wycombe
Sacramento	Sacramento California
All Time Law	All Time Low
JCW Beckham	J C W Beckham
Ryuji Bando	Ryūji Bando
WoopsI Did It Again	Oops I Did It Again
A	A
Early Modern English	Early Modern English
Gold Mark	German gold mark
Old Irish	Old Irish
Tokyo Station	Tokyo Station
Its So Hard	Its So Hard
University of Bristol	University of Bristol
Roberts County	Roberts County Texas
Keita Isozaki	Keita Isozaki
Puccimoni	Petitmoni
Madison County	Madison County New York
International Monetary Fund	International Monetary Fund
Carpignano Salentino	Carpignano Salentino
Samuel Houston	Sam Houston
Hida Mountains	Hida Mountains
Metal Blade Records	Metal Blade Records
Gucci Main	Gucci Mane
Li Keqiang	Li Keqiang
Brunswick County	Brunswick County Virginia
My Sun	Boku no Taiyō
QueenAdam Lambert	Queen  Adam Lambert
Surrey	Surrey
Perl	Perl
Shide Emperor	Tự Đức
Teton County	Teton County Montana
Break the Records by you  for you	Break the Records
Rain of Castamere	The Rains of Castamere
Shuichi Gonda	Shūichi Gonda
Scott Brown	Scott Brown
Dipendra Bir Bikram Shaha	Dipendra of Nepal
Duval County	Duval County Texas
Overflowing Love Hold Wipe Tears	Afuresō na Ai Daite Namida o Fuite
Bob Marley	Bob Marley
Mari El Republic	Mari El
wolf and lion	The Wolf and the Lion
Northwest Airlines	Northwest Airlines
Edward	Prince Edward Earl of Wessex
Junko Onishi of Village Vanguard	Live at the Village Vanguard
Maria Mkhortova	Maria Mukhortova
KomiPermyak	KomiPermyak language
Left Democrats	Democrats of the Left
Ai Yamatsuka	Yamantaka Eye
Niwattamrong Boonsongpaisan	Niwatthamrong Boonsongpaisan
John Sedgwick	John Sedgwick
Giordano Bruno	Giordano Bruno
Infinite	Infinite
Knock of Happiness	Let Em In
Mississippi County	Mississippi County Missouri
CS Emelek	Club Sport Emelec
Kim Il Sung University	Kim Ilsung University
Lemmy Kilmister	Lemmy
Broward County	Broward County Florida
Burk County	Burke County North Carolina
Erina Mano	Erina Mano
In the wind	Kaze no Naka de
Warren Harding	Warren G Harding
Pyongyang City Sports Team	Pyongyang City Sports Club
Three 6 Mafia	Three 6 Mafia
Louisa County	Louisa County Iowa
Charlie Ex	Charli XCX
Yomiuri Television Broadcast	Yomiuri Telecasting Corporation
HEART STATION Stay Gold	Heart Station
Bruce Welch	Bruce Welch
Bruce	Blues
Maninka	Maninka language
Vladimir Shpidla	Vladimír Špidla
Mauno Koivisto	Mauno Koivisto
Yamato City	Yamato Kanagawa
James Steinberg	James Steinberg
Spitz	Spitz
Fooladshahr Stadium	Foolad Shahr Stadium
Province of Venice	Province of Venice
BIGBANG	Big Bang
Seiji Maehara	Seiji Maehara
Brenda Lee	Brenda Lee
14th Area Army	Japanese Fourteenth Area Army
The pillows	The Pillows
Heisuke Hironaka	Heisuke Hironaka
Clark County	Clark County Missouri
Elizaveta	Elizabeth of Russia
Pink Cream 69	Pink Cream 69
Apollo 17	Apollo 17
Dodge Intrepid	Dodge Intrepid
Pasay	Pasay
University of Navarre	University of Navarra
John L Helm	John L Helm
FC Seoul	FC Seoul
Morgan County	Morgan County Tennessee
Ferdinand de Saussure	Ferdinand de Saussure
Shanghai Pudongyuanshen Stadium	Yuanshen Sports Centre Stadium
Bellseat	Belsito
Importance of Being Idol	The Importance of Being Idle
Hugh Scott	Hugh Scott
Hutu	Hutu
Liaoning Hong Football Club	Liaoning Whowin FC
Province of Salerno	Province of Salerno
Angola Civil War	Angolan Civil War
Itabashi Ward	Itabashi
Spanish Communist Party	Communist Party of Spain
Northern Dancer	Northern Dancer
Arthur Burns	Arthur F Burns
Europe	Europe
Debian	Debian
Anges SCO	Angers SCO
Andrew Jackson	Andrew Jackson
Superstition	Superstition
Nagoya City General Gymnasium	Nippon Gaishi Hall
BLEACH	Bleach
Guarani FC	Guarani FC
Hill Prince	Hill Prince
Dark Funeral	Dark Funeral
Make It Big	Make It Big
Yoshifumi Muto	Kabun Mutō
San Francisco	San Francisco
Apollo 13	Apollo 13
St Albans	St Albans
Fagiano Okayama Next	Fagiano Okayama Next
Hirosei Nakano	Kansei Nakano
Patrick County	Patrick County Virginia
Atomic Heart	Atomic Heart
Vinnie Colaiuta	Vinnie Colaiuta
Nelson County	Nelson County North Dakota
Millleaf	Mill Reef
Aston Villa FC	Aston Villa FC
Marcel Faessler	Marcel Fässler
China National Football Team	China national football team
ESPN2	ESPN2
Seiko Noda	Seiko Noda
Smells Like Teen Spirit	Smells Like Teen Spirit
Lincoln County	Lincoln County Idaho
Ruby	Ruby
Spencer Percival	Spencer Perceval
UFC 117	UFC 117
Daniel Finch	Daniel Finch 2nd Earl of Nottingham
Federal Council	Swiss Federal Council
Wayne County	Wayne County Pennsylvania
Christopher Boyage	Christopher Boyadji
George Villiers	George Villiers 4th Earl of Clarendon
Save Me	Save Me
I Bet You Look Good on the Dance Floor	I Bet You Look Good on the Dancefloor
Uptown Girl	Uptown Girl
NHK Educational Television	NHK Educational TV
Tsunku♂	Tsunku
Morihiro Hosokawa	Morihiro Hosokawa
Outrage	Outrage
PSV Eindhoven	PSV Eindhoven
Giles County	Giles County Tennessee
Copa America Centenario	Copa América Centenario
Leopold Sedar Senghor	Léopold Sédar Senghor
Freestone County	Freestone County Texas
Centaurus	Centaurus
Maximum The Hormone	Maximum the Hormone
Trust Your Love	Trust Your Love
Toms	TOMS
Joachim Gauck	Joachim Gauck
Stokes County	Stokes County North Carolina
Yngwie Malmsteen	Yngwie Malmsteen
Samuel Crawford	Samuel W Crawford
Tianhe Sports Center Stadium	Tianhe Stadium
Taisanbok	Magnolia grandiflora
HiNRG	HiNRG
Cape Cross	Cape Cross
Innocent VIII	Pope Innocent VIII
LOST ANGELS	Lost Angels
Kazuya Yamamura	Kazuya Yamamura
Sporting Lokeren	KSC Lokeren OostVlaanderen
Crispiano	Crispiano
Mark Ronson	Mark Ronson
Fyodor Dostoevsky	Fyodor Dostoyevsky
The End Record	The End Records
Soyuz 18a	Soyuz 7KT No39
Tommy Walter	Tommy Walter
Beautiful World Kiss  Cry	Beautiful World
Southern Rhodesia	Southern Rhodesia
Across the Universe	Across the Universe
Tani Tachijo	Tani Tateki
July Monarchy	July Monarchy
Kingdom of Nizam	Hyderabad State
Jay Rock	Jay Rock
Konyaspor	Konyaspor
Satoshi Yamaguchi	Satoshi Yamaguchi
Boz Scaggs	Boz Scaggs
Arabic	Arabic alphabet
How To Dismantle An Atomic Bomb	How to Dismantle an Atomic Bomb
Lowndes County	Lowndes County Alabama
Matti Vanhanen	Matti Vanhanen
Cherry Blossoms in Sweet and Sour Spring	Amazuppai Haru ni Sakura Saku
Yannick Gers	Janick Gers
Kingdom of Ireland	Kingdom of Ireland
Black Sabbath	Black Sabbath
William Maxwell Everts	William M Evarts
Sassari Province	Province of Sassari
Hoang Vu Sam Son	Hoàng Vũ Samson
Microsoft Windows NT	Windows NT
Tim Hardaway	Tim Hardaway
Eizo Sakamoto	Eizo Sakamoto
Dearest	Dearest
The Edge	The Edge
Germany National Football Team	Germany national football team
Suginami Ward	Suginami
Skanes	Scania
Charles Evans Hughes	Charles Evans Hughes
Mikio Aoki	Mikio Aoki
Cheap Trick at Budokan	Cheap Trick at Budokan
French Fourth Republic	French Fourth Republic
Sidney Godolphin	Sidney Godolphin 1st Earl of Godolphin
Space Lock	Space rock
Behind the Mask	Behind the Mask
Metal Gear Rising Revengeance	Metal Gear Rising
Steamboat Willie	Steamboat Willie
Not yet	Not Yet
Swaps	Swaps
Dodridge County	Doddridge County West Virginia
The 18th Ward of Tokyo	Tokyo 18th district
Anthony Meunier	Anthony Mounier
Ken Andrews	Ken Andrews
Alicia de Borbone  Parma	Infanta Alicia Duchess of Calabria
United States Army Special Forces Group	Special Forces
Soyuz TMA1	Soyuz TMA1
Final Fantasy Series	Final Fantasy
Because You Loved Me	Because You Loved Me
Ikuto Hidaka	Ikuto Hidaka
Heaven and Hell	Heaven  Hell
OASIS	Definitely Maybe
Ryan Tedder	Ryan Tedder
Colin Cazim  Richards	Colin KazimRichards
Airsteriga	Austrian Football First League
Chris Impellitteri	Chris Impellitteri
Karl Marx	Karl Marx
Beep Sunshine Sunshine	Beep
Rama VIII	Ananda Mahidol
Bang B	Bun B
Stanislav Morozov	Stanislav Morozov
Malvorent Creations	Malevolent Creation
Peter Geach	Peter Geach
Jesper Stromblad	Jesper Strömblad
Progressive Metal	Progressive metal
George Romney	George W Romney
Minoru Niihara	Minoru Niihara
Brandon Forsythe	Brandon Forsyth
Jose Luis Rodriguez Zapatero	José Luis Rodríguez Zapatero
Anthony Principi	Anthony Principi
Hausa	Hausa language
Washoe County	Washoe County Nevada
John Squire	John Squire
Gore Grind	Goregrind
Mongolian Peoples Republic	Mongolian Peoples Republic
Limestone County	Limestone County Texas
Cleburne County	Cleburne County Alabama
FC Metalist Kharkiv	FC Metalist Kharkiv
Yukio Hatoyama	Yukio Hatoyama
Henri	Henri Grand Duke of Luxembourg
Los Angeles Lakers	Los Angeles Lakers
Stark County	Stark County Illinois
Soyuz	Soyuz
Buchanan County	Buchanan County Iowa
Lies and Truth	Lies and Truth
Henry Russells	Henry Lascelles 6th Earl of Harewood
Sri Lanka Air Force	Sri Lanka Air Force
electronic core	Electronicore
Club Universidad Nacional	Club Universidad Nacional
Massimo Gobbi	Massimo Gobbi
Daur	Daur language
Berlin Olympiastadion	Olympiastadion
Charlotte	Charlotte North Carolina
Idi Amin	Idi Amin
African Americans	African Americans
Damageplan	Damageplan
Celtic FC	Celtic FC
Italian	Italian language
Sorrowful Heartbeat	Where Does My Heart Beat Now
Georgy Malenkov	Georgy Malenkov
Wayne County	Wayne County West Virginia
Jefferson County	Jefferson County Colorado
FTISLAND	FT Island
John Adams	John Adams
Campeonato Sanmarinese	Campionato Sammarinese di Calcio
Wayne Krantz	Wayne Krantz
Galia County	Gallia County Ohio
Apisit Wechachiwa	Abhisit Vejjajiva
MTA Regional Bus Operations	MTA Regional Bus Operations
Miwa	Miwa
Evenki	Evenks
BOYFRIEND	Boyfriend
Eastland County	Eastland County Texas
Villarreal CF B	Villarreal CF B
FC Dinamo Bucharest	FC Dinamo București
Tauraj	Taurasi
	Puppis
Carlos Santana	Carlos Santana
Masayoshi Takemura	Masayoshi Takemura
Sebastian Piñera	Sebastián Piñera
Yankee Stadium	Yankee Stadium
Washington County	Washington County Minnesota
Axis	Axis
Arkansas	Arkansas
Second French Republic	French Second Republic
Pitkin County	Pitkin County Colorado
Faris	Pharis
Star County	Starr County Texas
Pickaway County	Pickaway County Ohio
Naslula	Nasrullah
New Age	Valar Dohaeris
George Zweig	George Zweig
Boyko Borisov	Boyko Borissov
Rocky Junior	Roque Júnior
Westlife	Westlife
McDowell County	McDowell County West Virginia
Madison County	Madison County Virginia
William Noland	William F Knowland
Cambrian	Cumbric
Lonigo	Lonigo
Paul Volcker	Paul Volcker
Tove Law	Tove Lo
Nobuyuki Abe	Nobuyuki Abe
Lady Soul	Lady Soul
Houston County	Houston County Minnesota
Weight and Bleed	Wait and Bleed
Korean	Koreanic languages
Yu Zhengsheng	Yu Zhengsheng
Sagittarius	Sagittarius
Private Dancer	Private Dancer
John Russell	John Russell 1st Earl Russell
Anna	Anna Jagiellon
Mighty Avengers	The Mighty Avengers
Alison Krauss	Alison Krauss
George V	George V
Jean	Jean Grand Duke of Luxembourg
Koji Takano	Koji Takano
Killer Queen	Killer Queen
Greenwood County	Greenwood County Kansas
Alvin Gentry	Alvin Gentry
Green Horizon  Horizon	Horizon
FC Augsburg	FC Augsburg
Hans Luther	Hans Luther
Berkshire County	Berkshire County Massachusetts
Nippon Ad Systems	Nihon Ad Systems
Fergie	Fergie
John Foster Dulles	John Foster Dulles
Vangelis	Vangelis
High Flyer	Highflyer
Cheap Trick	Cheap Trick
Prince Abdullah Al Faisal Stadium	Prince Abdullah Al Faisal Stadium
Anna Semenovich	Anna Semenovich
Cherry Girl Fate	Cherry Girl Unmei
Vinnie Paul	Vinnie Paul
San Francisco Bay Area	San Francisco Bay Area
Yoshimasa Hayashi	Yoshimasa Hayashi
Paul Desmond	Paul Desmond
CODE NAME BLUE	Code Name Blue
Kawataisei	Ha Daesung
Ancient Rome	Ancient Rome
FL Studio	FL Studio
Soulfly	Soulfly
Sound of Silence	Sounds of Silence
Steam	Steam
Prince Lee Gift	Princely Gift
Timur	Timurid Empire
Cyrillic	Cyrillic script
Covington County	Covington County Alabama
Thomas E Dewey	Thomas E Dewey
Dan Hawkins	Dan Hawkins
Glenn Hubbard	Glenn Hubbard
ALWAYS	Always
Kokubara	Kokborok
SKE48	SKE48
Khin	Vietnamese people
Edward Kennedy	Ted Kennedy
Socialist Federal Republic of Yugoslavia	Socialist Federal Republic of Yugoslavia
Yen Sari	Ieng Sary
Nocera Terinese	Nocera Terinese
10th longterm stay	Expedition 10
Greek Civil War	Greek Civil War
Northwestern University	Northwestern University
Greene County	Green County Wisconsin
Andrews County	Andrews County Texas
William Lamb	William Lamb 2nd Viscount Melbourne
Trincomalee District	Trincomalee District
Higashiomi City	Higashiōmi
trip hop	Trip hop
BLESS	Bless
DIABOLOS	Diabolos
North  Central America and Caribbean Football Federation	CONCACAF
City of Sunderland	City of Sunderland
Tarot	Tarot
Emperor Monmu	Emperor Monmu
Reims	Reims
G∞VER	Goover
Mericri	Merry Chri
Hall	Hole
Shahid Dastgerdi Stadium	Shahid Dastgerdi Stadium
Legendary Champion	We Are the Champions
Estadio Santiago Bernabéu	Santiago Bernabéu Stadium
Ramones	Ramones
El Grand Senor	El Gran Senor
Help	Help
Mineshaft	Mineshaft
Danzig	Danzig
Fillet	Filetto
UNITE	Unite
Hardman County	Hardeman County Tennessee
Dave Brubeck	Dave Brubeck
Give in to Me	Give In to Me
Lorne County	Roane County Tennessee
ABC	ABC
Satsuki Eda	Satsuki Eda
Ray Blasier	Ray Brassier
Fragile	Fragile
Montella	Montella
Bernard Sumner	Bernard Sumner
United States Deputy Secretary of Defense	United States Deputy Secretary of Defense
Cries of the Soul	Rattle and Hum
Color Change	Color Change
Stranger in Moscow	Stranger in Moscow
Enrico Fermi	Enrico Fermi
College of William and Mary	College of William  Mary
William Seward	William H Seward
Juarez Cartel	Juárez Cartel
Love	Love
Henry Addington	Henry Addington 1st Viscount Sidmouth
James Dimon	Jamie Dimon
Wilson County	Wilson County Tennessee
Kenosha County	Kenosha County Wisconsin
Reuben Rivlin	Reuven Rivlin
Violets	Viola
King of Canada	Monarchy of Canada
Sofia de Borbon	Infanta Sofía of Spain
Sid Barrett	Syd Barrett
Bobby Womack	Bobby Womack
Murcia	Murcia
FLOW ANIME BEST	Anime Best
SwedenNorway	Union between Sweden and Norway
Mahmoud Jibril	Mahmoud Jibril
Judson Kilpatrick	Hugh Judson Kilpatrick
Are Women Slaves to the World	Woman Is the Nigger of the World
Pratra Perinha	Pratola Peligna
Touched by the Hand of God	Touched by the Hand of God
John Langdon	John Langdon
Robisu Wagner	Wagner Lopes
Elbe River	Elbe
Unchained Melody	Unchained Melody
This is the One	This Is the One
Toyota Platz	Toyota Platz
John Breckinridge	John Breckinridge
Spanish	Spanish language
SS	Schutzstaffel
Second Battle of Corinth	Second Battle of Corinth
Valencian	Valencian
Thomas McKean Thompson McKennan	Thomas McKean Thompson McKennan
Out of Our Heads	Out of Our Heads
Marwari	Marwari language
Curtis LeMay	Curtis LeMay
Delaney  Bonnie	Delaney  Bonnie
Whitesnake	Whitesnake
Hand County	Hand County South Dakota
Caroline Matilda of Wales	Caroline Matilda of Great Britain
Richland County	Richland County Ohio
Pete Townshend	Pete Townshend
Shinji Tarutoko	Shinji Tarutoko
Dire Straits	Dire Straits
Autotrax	Autolux
Good Girl Gone Bad	Good Girl Gone Bad
Mother Love Bone	Mother Love Bone
Thani Bin Jassim Stadium	Thani bin Jassim Stadium
Shujiro Hara	Shūjirō Hara
First Niagara Center	First Niagara Center
King Abdullah Stadium	King Abdullah II Stadium
Dream Express	Dream Express
Pittsburgh	Pittsburgh
New Kent County	New Kent County Virginia
Henri Poincare	Henri Poincaré
Simon Bradstreet	Simon Bradstreet
Siurugus Donigara	Siurgus Donigala
Mercer County	Mercer County North Dakota
Robin Trower	Robin Trower
Israeli Premier League	Israeli Premier League
Sheryl Cole	Cheryl FernandezVersini
Yaeyama Islands	Yaeyama Islands
Hakonemachi	Hakone
Spaceship do do do 	Sorafune Do Do Do
Thurston County	Thurston County Washington
John Breckinridge	John C Breckinridge
Body Language	Body Language
MESSAGE PERSONAL	Message Personal
Let It Be Naked	Let It Be Naked
Maria Amelia de Braganza	Princess Maria Amélia of Brazil
I LOVED YESTERDAY	I Loved Yesterday
Nathaniel Green	Nathanael Greene
Jake Shimabukuro	Jake Shimabukuro
Aoshima Nakano Football Club	Qingdao Jonoon FC
Jackson County	Jackson County West Virginia
Fulton County	Fulton County Arkansas
Lenzi Cabinet	Renzi Cabinet
Orochi	Oroch language
Pablo Hernández	Pablo Hernández
Tom Jones	Tom Jones
Sakura City	Sakura Chiba
Peter Mandelson	Peter Mandelson
NAKED Fight Together Tempest	Naked Fight Together Tempest
Hasan Rouhani	Hassan Rouhani
St Pancras Station	St Pancras railway station
Far Eastern Federal District	Far Eastern Federal District
magazine	Magazine
Boys Over Flowers	Boys Over Flowers
Ogikubo Station	Ogikubo Station
South Korea National Football Team	South Korea national football team
Kathleen Sebelius	Kathleen Sebelius
Yitzhak Benzbi	Yitzhak BenZvi
Ozomatri	Ozomatli
Chris Ess	Kris S
Charles Townshend	Charles Townshend 2nd Viscount Townshend
Huddersfield Town FC	Huddersfield Town AFC
Cornelius Van Steenwick	Cornelius Van Steenwyk
Impellitteri	Impellitteri
NEW WORLD	New World
White Flower	Shiroi Hana
Colin Redgrave	Corin Redgrave
Ive Gotta Feeling	Ive Got a Feeling
Isaac Hayes	Isaac Hayes
Lee County	Lee County Alabama
Meddlesome	Meddle
Allegheny County	Allegany County New York
The Legend of Zelda Series	The Legend of Zelda
Porto Alegre	Porto Alegre
Red River Campaign	Red River Campaign
Sao Paulo	São Paulo
Nick Van Exel	Nick Van Exel
Thai	Thai language
United Kingdom	Commonwealth of Nations
Hell Teacher Nube	Hell Teacher Nūbē
Gabriel Garcia  Marquez	Gabriel García Márquez
Another Part of Me	Another Part of Me
Liam Gallagher	Liam Gallagher
High Chaparral	High Chaparral
Gilbert Elliott  MurrayKininmound	Gilbert ElliotMurrayKynynmound 2nd Earl of Minto
Seni Pramoth	Seni Pramoj
Mitsuru Nagata	Mitsuru Nagata
Portugal national football team	Portugal national football team
Tom Evans	Tom Evans
Battle of Jonesborough	Battle of Jonesborough
Camden	London Borough of Camden
Shimonoseki City	Shimonoseki
Unified European Left  Northern Green Left Alliance	European United LeftNordic Green Left
Green County	Greene County Tennessee
Pork County	Polk County Florida
Jacques Santerre	Jacques Santer
Poinset County	Poinsett County Arkansas
Leeds United AFC	Leeds United FC
Toyota City	Toyota Aichi
Red	Kurenai
Talisman	Talisman
Bobby Ellsworth	Bobby Ellsworth
Herbie Hancock	Herbie Hancock
Dont Don	Dont Don
Chengde	Chengde
Estudiantes	Estudiantes de La Plata
Yellowstone County	Yellowstone County Montana
Nobutaka Machimura	Nobutaka Machimura
Alvin W Berkeley	Alben W Barkley
Gauteng	Gauteng
Secret	Secret
Sonjikai	Sun Jihai
American English	American English
Henry Howard	Henry Howard 13th Duke of Norfolk
William the Third	William the Third
El Prado	El Prado
Kd Lang	Kd lang
UFC Fight Night	UFC Fight Night
Principality of Transylvania	Principality of Transylvania
Kuroyume	Kuroyume
Shoichi Nakagawa	Shōichi Nakagawa
Arnhem	Arnhem
Maori	Māori language
Will County	Will County Illinois
List of Pokémon	List of Pokémon
Dont Look Back in Anger	Dont Look Back in Anger
EmiliaRomagna	EmilianRomagnol language
Vavuniya Province	Vavuniya District
University of Pittsburgh	University of Pittsburgh
Sam Totman	Sam Totman
San Diego Padres	San Diego Padres
Pete Routh	Pete Rouse
Clay County	Clay County Kansas
The Boys	The Boys
Jamaica National Football Team	Jamaica national football team
William Cavendish	William Cavendish 2nd Duke of Devonshire
Rusyn	Rusyn language
Peter Ewers	Peter Iwers
Lakkipal County	Lac qui Parle County Minnesota
Walker County	Walker County Georgia
Virginia	Virginia
Nobuoki Asada	Asada Nobuoki
STS101	STS101
At the Gates	At the Gates
Thank you Kangeki Amestorm	Kansha Kangeki Ame Arashi
Diana	Diana Princess of Wales
Joaquin Almunia	Joaquín Almunia
GNOME	GNOME
Etsujiro Uehara	Etsujirō Uehara
Sing gently	Killing Me Softly
LOSC Lille Metropole	Lille OSC
Battle of Sailors Creek	Battle of Sailors Creek
Greenbrier County	Greenbrier County West Virginia
Eric Clapton	Eric Clapton
John Calhoun	John C Calhoun
Afar	Afar language
Takashi Sekizuka	Takashi Sekizuka
NASCAR	NASCAR
Tony Tan	Tony Tan
Ernst Abbe	Ernst Abbe
Diego Perez	Diego Pérez
Kesennuma City	Kesennuma
Gonbei Yamamoto	Yamamoto Gonnohyōe
Numazu City	Numazu Shizuoka
Ryan Hunter  Ray	Ryan HunterReay
Cancer	Delphinus
Why3F	Keep Your Head Down
For You Blue	For You Blue
Williams FW15C	Williams FW15C
Gansu	Gansu
Ralph Towner	Ralph Towner
AFC Cup 2013	2013 AFC Cup
Boris Gryzlov	Boris Gryzlov
Kingdom of Cambodia	Kingdom of Cambodia
Oleksandr Turchinov	Oleksandr Turchynov
Glagolitic script	Glagolitic alphabet
Livingston Tallmadge Merchant	Livingston T Merchant
Mississippi River	Mississippi River
Gyeongbu Line	Gyeongbu Line
Cape Town	Cape Town
Mark Lomonaco	Mark LoMonaco
Hikaru Matsunaga	Hikaru Matsunaga
Korekiyo Takahashi	Takahashi Korekiyo
Catania	Province of Catania
Frank Ocean	Frank Ocean
AAA	AAA
William Alexander Graham	William Alexander Graham
Tamil	Tamil language
Condoleezza Rice	Condoleezza Rice
Miami County	Miami County Kansas
George Nugent  TempleGrenville	George NugentTempleGrenville 1st Marquess of Buckingham
AC ArlesAvignon	AC ArlesAvignon
Elysio	Helissio
Empire of AustriaHungary	AustriaHungary
Mr Kakura Aishin	Aisin Gioro
Nick Clegg	Nick Clegg
Gregory VII	Pope Gregory VII
Georgia White	Jeordie White
Henry W Slocum	Henry Warner Slocum
Jealousy	Jealousy
Foreigner	Foreigner
Estudio Gobernador Magalhães Pinto	Mineirão
Soyuz TMA07M	Soyuz TMA07M
Clay County	Clay County Indiana
1FC Nuremberg	1 FC Nürnberg
Mirrorcle World	Mirrorcle World
Market County	Marquette County Michigan
Miracle	Kiseki
Ry Cooder	Ry Cooder
FC Mittiland	FC Midtjylland
SinoJapanese War	First SinoJapanese War
Pierre Taki	Pierre Taki
Kitasenju Station	KitaSenju Station
Paul Konchesky	Paul Konchesky
Keigo Kiyoura	Kiyoura Keigo
Atletico Mineiro	Clube Atlético Mineiro
Pika Pika Fantajin	Pika Pika Fantajin
Hampden County	Hampden County Massachusetts
Lee Camp	Lee Camp
Metropolitan Transportation Authority	Metropolitan Transportation Authority
Claudius	Claudius
Netherlands Antilles	Netherlands Antilles
Yoshiaki Takagi	Yoshiaki Takaki
The 25th longterm stay	Expedition 25
Happy Magic  Smile Project 	Happy Magic
Minnesota	Minnesota
Glassnote Records	Glassnote Records
WASP	WASP
Vanuatu	Vanuatu
All night long	All Night Long
M Shadows	M Shadows
Thai characters	Thai alphabet
Georgia National Rugby Team	Georgia national rugby union team
Cyclades	Cyclades
Future Shards	Mirai no Kakera
Thomas Metcalf	Thomas Metcalfe
VALENTI	Valenti
Jose Azurmendi	Joxe Azurmendi
Lonoke County	Lonoke County Arkansas
Ullevaal Stadion	Ullevaal Stadion
NHK General Television	NHK General TV
Boredoms	Boredoms
Green County	Greene County Georgia
DICE	Dice
CA Independiente	Club Atlético Independiente
Anderson County	Anderson County Kansas
Cat Power	Cat Power
Karl Popper	Karl Popper
Boris Paichade Stadium	Boris Paichadze Dinamo Arena
Purge	The Night Lands
President of the European Council	President of the European Council
Francis Osborne	Francis Osborne 5th Duke of Leeds
Russia	Russia
Chesapeake	Chesapeake Virginia
Dennis Rodman	Dennis Rodman
RTÉ Two	RTÉ2
Montgomery County	Montgomery County Illinois
Ann Venemann	Ann Veneman
FC Viktoria Plzen	FC Viktoria Plzeň
Marlon Dickerson	Mahlon Dickerson
Brazilian Portuguese	Brazilian Portuguese
Dukedom of Brittany	Duchy of Brittany
Battle of the Wasteland	Battle of the Wilderness
Niger	Niger
Taketora Ogata	Taketora Ogata
Province of Barcelona	Province of Barcelona
PARTY TIME	Party Time
Lebanon	Lebanon
Soyuz27	Soyuz 27
Strikeforce	Strikeforce
Mrs Robinson	Mrs Robinson
Jet Pilot	Jet Pilot
Destiny	Destiny
Choi Seongguk	Choi Sungkuk
Henderson County	Henderson County Texas
Otsego County	Otsego County New York
Kings College	Kings College Cambridge
Edmund Phelps	Edmund Phelps
NIFL Championship 1	NIFL Championship 1
Argent	Argent
Paul Simon	Paul Simon
Grand Duke of Luxembourg	Grand Duke of Luxembourg
Machine Gun Etiquette	Machine Gun Etiquette
WILD Dr	Wild
Licking County	Licking County Ohio
Masashi Kuranari	Tadashi Kuranari
Alain Poel	Alain Poher
Uli Jon Roth	Uli Jon Roth
Manchester City FC	Manchester City FC
Vladislav Zohnirsky	Vladislav Zhovnirski
Angel Maria Villar	Ángel María Villar
Baoding	Baoding
Nagano Olympics	1998 Winter Olympics
Levi Lincoln Jr	Levi Lincoln Jr
Kentucky	Kentucky
Liv	Vivre
Apple A5	Apple A5
Iran	Iran
Alliance 90 Green Party	Alliance 90 The Greens
Ingrid Alexandra	Princess Ingrid Alexandra of Norway
Unreal Engine	Unreal Engine
CONNETTA	Connetta
Oriol	Aureole
Noxavie County	Noxubee County Mississippi
Somali	Somalis
Pashto	Pashto
James Harris	James Harris 3rd Earl of Malmesbury
Game Boy Color	Game Boy Color
Southern African Football Association Council	Council of Southern Africa Football Associations
SpaceX CRS2	SpaceX CRS2
Sichuan	Sichuan
Kashima City	Kashima Ibaraki
Henry Pelham	Henry Pelham
Solanin	Solanin
Simon Wright	Simon Wright
MalayoPolynesian	MalayoPolynesian languages
quicksand	Quicksand
BEST  first things 	Best
Dream Theater	Dream Theater
UFC 171	UFC 171
The Price of Passion ESCAPE	Jōnetsu no Daishō Escape
Yuji Kimura	Yuji Kimura
Unshu mandarin orange	Citrus unshiu
Oromo	Oromo language
STS102	STS102
Crockett County	Crockett County Tennessee
Wakayama City	Wakayama Wakayama
Slip anchor	Slip Anchor
Gallatin County	Gallatin County Montana
Sanskrit	Siddhaṃ script
Hardcore Punk	Hardcore punk
Let Go	Let Go
Gunshi Kanbei	Gunshi Kanbei
Turier	Tuglie
Wyoming County	Wyoming County New York
First Time	First Time
Montgomery County	Montgomery County Tennessee
Acherno	Acerno
Sinot Riga	Czech First League
Gustav Adolf	Prince Gustaf Adolf Duke of Västerbotten
Pivotal	Pivotal
Brands Hatch	Brands Hatch
Clark Clifford	Clark Clifford
Ramzan Kadyrov	Ramzan Kadyrov
Human League	The Human League
Sofia	Sofia
Runnels County	Runnels County Texas
Cumberland County	Cumberland County New Jersey
David Cameron	David Cameron
Doctor Fager	Dr Fager
Silenos	Silenoz
Three Rivers Stadium	Three Rivers Stadium
Sauber C20	Sauber C20
Toyohashi City	Toyohashi
Haruhiko Kuroda	Haruhiko Kuroda
1st Manuel Valls Cabinet	First Valls Government
Astana	Astana
Sonia	Queen Sonja of Norway
Old Eastern Slavonic	Old East Slavic
University of Oxford	University of Oxford
Sheikh Khalifa International Stadium	Sheikh Khalifa International Stadium
Brunswick	Brunswick Maine
Angelos Basinas	Angelos Basinas
Gabriel Marcel	Gabriel Marcel
