Allianz Riviera	Allianz Riviera
Jose Mario Vaz	José Mário Vaz
Free Software Foundation	Free Software Foundation
Malmo FF	Malmö FF
Rajendra Bikram Shaha	Jackson County Arkansas
Dream Evil	Dream Evil
Felix Grandi	Felix Grundy
How Do I Survive3F	How Do I Survive3F
Victoria Stadium	Victoria Stadium
Knox County	Knox County Tennessee
Wayne County	Wayne County North Carolina
The Firm	The Firm
Expo 2010	We Can Work It Out
Bordeaux	Kuwana Mie
Karim Matmur	Karim Matmour
Hirosaki City	Hirosaki Aomori
Dan Gurney	Dan Gurney
Ahmad Naseef	Ahmed Nazif
Coverdale Page	Coverdale•Page
Henry Petty  Fitzmaurice	Henry PettyFitzmaurice 3rd Marquess of Lansdowne
Street Cry	Street Cry
Outlook Express	Mockingbird
Harrison Schmidt	Harrison Schmitt
Soyuz22	Soyuz 22
LOVE  HONEY	Love  Honey
Like a Virgin	ND Soft Stadium Yamagata
Weifang City	Weifang
Gilbert Elliott  MurrayKinnymound	Gilbert ElliotMurrayKynynmound 1st Earl of Minto
Overijssel	Overijssel
Udmurt	Udmurt language
Crispy Park	Crispy Park
Rockingham County	Maury County Tennessee
Hellas Verona FC	Hellas Verona FC
Taman	Tamang language
Battikaloa District	Batticaloa District
Perry County	Perry County Tennessee
Kanagawa Prefecture 11th Ward	Kanagawa 11th district
Natalia Annenko	Natalia Annenko
Patti Smith	Patti Smith
Champagne Supernova	Champagne Supernova
Omiya Station	Ōmiya Station
Urho Kekkonen	Urho Kekkonen
Morelia	Ruthenian language
George McGovern	George McGovern
Mari Kibiniemi	Mari Kiviniemi
Deathlike Silence Productions	Deathlike Silence Productions
The Orb	James Barbour
Desperate Housewives	Desperate Housewives
Infiniti M	Siskiyou County California
Infinity M	Infiniti M
Ilocano	Frederick William I of Prussia
Fontana Records	Fontana Records
Windows Me	Bernard FitzalanHoward 16th Duke of Norfolk
Microsoft Windows Millennium Edition	Windows ME
DRAGON GATE	Dragon Gate
United Launch Alliance	United Launch Alliance
Inferno	Inferno
Alex Skolnick	Alex Skolnick
Precipitation	Iberia Parish Louisiana
Gagarin Launch Pad	Gagarins Start
FaughaBallagh	Precipitation
Sky News	Sky News
Forever	FaughaBallagh
SDN48	Terminator Salvation
Calhoun County West Virginia	Morning Musume
Caldwell County Missouri	Monfero
Hiroshima Prefecture	Hiroshima Prefecture
NKVD	Ricardo
Caldwell County	Caldwell County Missouri
San Germano dei Berici	San Germano dei Berici
Peoples Commissariat for Internal Affairs	NKVD
Soyuz 36	Soyuz 36
In the Zone	In the Zone
Maldives National Stadiumv	Northern Ryukyuan languages
Chicago	Chicago
MAX	MAX
Galor National Stadium	National Football Stadium
Phoenician script	Phoenician alphabet
Nadir Belhaj	Nadir Belhadj
Galit Chait	Galit Chait
Edogawa Ward	Edogawa Tokyo
AIR	Air
Nazli Nasir	Nazri Nasir
Allegany County Maryland	FC Sion
Celestine IV	Pope Celestine IV
Ryan Playfair	Lyon Playfair 1st Baron Playfair
United States Secretary of Defense	United States Secretary of Defense
Allegheny County	Allegany County Maryland
University of Toronto	University of Toronto
Dan Palmer	Dan Palmer
Mexico City	Mexico City
Malaysia National Football Team	Malaysia national football team
Tatsuro Yamashita	Tatsuro Yamashita
President of the European Commission	President of the European Commission
Overkill	Overkill
Milwaukee	Milwaukee
Fulton County	Fulton County Illinois
Tucana	News of the World
Electropop	Electropop
Oliver Wolcott	Battles of Khalkhin Gol
Snow drop	Snow Drop
Worcester County	Worcester County Massachusetts
Arcaneus	Tucana
PlayStation Mobile	PlayStation Mobile
Nathan Clifford	Nathan Clifford
1FSV Mainz05	Prince Arthur Duke of Connaught and Strathearn
Cecil County	Maximilian I Holy Roman Emperor
Isle	Isle
Rated R	Drink It Down
Monroe County	Monroe County Pennsylvania
Duane Allman	Duane Allman
Mansi	Mansi language
Michelle	Michelle
Tsugi no Ashiato	Rated R
Vice President of the Republic of China	Vice President of the Republic of China
House of SaxeCoburgGotha	House of SaxeCoburg and Gotha
Bastro	Bastro
MinamiAlps Yamanashi	Windows 95
HEART	Prince Claus of the Netherlands
Next footsteps	Tsugi no Ashiato
Christina Aguilera	Christina Aguilera
Apple Incorporated	Apple Inc
Oh Love	Oh Love
Artur Mas i Gavarró	MinamiAlps Yamanashi
EXILE	Exile
Old Uyghur	Old Uyghur language
EskimoAleut language family	Prince Henry Duke of Gloucester
Western Province Sri Lanka	Endless Rain
Hugh Padgham	Hugh Padgham
Arthur Mas	Artur Mas i Gavarró
Sonera Stadium	Sonera Stadium
Dancing Queen	Dancing Queen
Blaine County	Blaine County Montana
Western Province	Western Province Sri Lanka
Louis Krages	Knox County Missouri
Lets Stay Together	Lets Stay Together
United Football League	United Football League
Black Metal	Black metal
Keiichi Aichi	Kiichi Aichi
MIYAVI	Miyavi
Ghazi	Ghazi of Iraq
Luis Crages	Louis Krages
Genichiro Tenryu	Genichiro Tenryu
Sporting Braga	SC Braga
Gyuha Choi	Choi Kyuhah
Jonas Kjellgren	Jonas Kjellgren
Georges Bataille	Georges Bataille
Roberto	Roberto
Steve Clifford	Steve Clifford
Liberal Party	Liberal Party
Peter Cosgrove	Peter Cosgrove
Iwamizawa City	Iwamizawa Hokkaido
Triangle	Power to the People
Stephen Wilson	Steven Wilson
Social Democratic Party of Lithuaniavv	Kinokawa Wakayama
Emanuel Swedenborg	Emanuel Swedenborg
Norio Suzuki	Norio Suzuki
The Siege of Corinth	Siege of Corinth
Gladwin County	Gladwin County Michigan
⊿	Triangle
Preston County	Preston County West Virginia
Lithuanian Social Democratic Party	Cần Thơ
Jethro Tull	Jethro Tull
Avoiles County	Avoyelles Parish Louisiana
Satoshi Katayama	Tetsu Katayama
Shaanxi	Chouteau County Montana
Falling Into Infinity	Falling into Infinity
Mississippi	Mississippi
STAND BY ME Doraemon	Stand by Me Doraemon
Slovenian PrvaLiga	Middlesex County Connecticut
STS75	STS75
Darth Vader	Darth Vader
Country Pop	Country pop
Is the Order a Rabbit3F	Is the Order a Rabbit3F
Lower Austria	Lower Austria
Prince Edward County	Prince Edward County Virginia
1SNL	Slovenian PrvaLiga
French	French people
Indie Recordings	Indie Recordings
Draco	Norio Omura
Sergey Stepashin	Sergei Stepashin
Gai Assulin	Mizo language
Sauber C21	Sauber C21
FRELIMO	Hélio Castroneves
Nine Years War	Philip V of Spain
Southern Rhodesian Pound	Southern Rhodesian pound
Spotlight	Brighton and Hove
Lehigh County	Lehigh County Pennsylvania
Guy Aslin	Gai Assulin
Democratic Convergence of Catalonia	Rutgers University
Mozambique Liberation Front	FRELIMO
Jack Lew	Nine Years War
Richard Thompson	Richard W Thompson
United Airlines	United Airlines
Region of Matera	Province of Matera
Mercer County Missouri	Roberto Bolaño
Catalan Democracy	Democratic Convergence of Catalonia
Cameron Jerome	Cameron Jerome
Jacob Lu	Jack Lew
Battle of Five Forks	Battle of Five Forks
Isahaya City	Isahaya Nagasaki
Pratra Sella	Pratola Serra
Shiritsu Ebisu Chugaku	Mercer County Missouri
Franz Fanon	Frantz Fanon
Gilles Deleuze	Gilles Deleuze
Apple TV	Apple TV
Battlefield	Battlefield
Grand Duchy of Halych  Volhynia	Jiří Paroubek
Katale Toyama	Kataller Toyama
William L Marcy	Shiritsu Ebisu Chugaku
Jermaine Jackson	Democracy is Freedom The Daisy
John Muth	John Muth
Stjepan Mesic	Stjepan Mesić
Imperial Prince Kaninnomiya Sahihito	Prince Kanin Kotohito
Gaining through losing	Gaining Through Losing
Freza Grandinaria	Fresagrandinaria
William Mercy	William L Marcy
Yuta Minami	Yuta Minami
National Olympic Stadium	Yuki Ozawa
Madagascar	Madagascar
Jiro Kawasaki	Jirō Kawasaki
Irving Fisher	Irving Fisher
Akita Prefecture	Akita Prefecture
Daniel Erlandson	Daniel Erlandsson
Bjorn Yellotte	Björn Gelotte
Phnom Penh Olympic Stadium	Olympic Stadium
Tsukihime	Tsukihime
Saint John the Baptist County	St John the Baptist Parish Louisiana
King Tom	King Tom
Rage Against the Machine	Rage Against the Machine
FC Lorient	FC Lorient
Patrick Leahy	Patrick Leahy
Creed	Creed
Dikab County	DeKalb County Georgia
Mountains and Vipers	The Mountain and the Viper
Koga Ibaraki	Oswego County New York
Elizabeth I	Elizabeth I of England
Yi Siyeong	Maine
Shiribeshi General Promotion Bureau	Pope Sixtus IV
Preble County	Preble County Ohio
william	William
UFC 158	UFC 158
Koga City	Koga Ibaraki
Sacramento Rivercats	Kyoto Prefecture
Lee Siyoung	Yi Siyeong
Kaze o Ukete	Dade County Missouri
Army of the Potomac	Army of the Potomac
Lund	Lund
Obituary	Obituary
Shinzo Oya	Shinzō Ōya
AS Rome	AS Roma
Taro Katsura	Katsura Tarō
Liberal Union Party	Liberal Unionist Party
By the Wind	Kaze o Ukete
Tibetan script	Tibetan alphabet
Monthly Comic Dengeki Daioh	Dengeki Daioh
Buchanan County	Buchanan County Virginia
Hotel California	Hotel California
UFC on Fox	Antrim County Michigan
National Assembly of Cambodia	Eveline WidmerSchlumpf
Monroe County	Monroe County Michigan
Daniel Miller	Daniel Miller
John Spencer 8th Earl Spencer	Rock the Casbah
Left Brain	Left Brain
QBasic	DeeeLite
Red	Red
UFC on FOX 10	Nishitōkyō Tokyo
SideOneDummy Records	National Assembly of Cambodia
Fumio Goto	Fumio Gotō
Ayumu Goromaru	Ayumu Goromaru
Edward Spencer	John Spencer 8th Earl Spencer
Hermann Hesse	Hermann Hesse
Henri Pescarolo	Henri Pescarolo
Oktibbeha County Mississippi	Marcelo Gallardo
Mason County Illinois	Washington County Pennsylvania
Sideone dummy record	SideOneDummy Records
Oita Trinita	Oita Trinita
Brian Molko	Brian Molko
Mission	Expedition 21
Fine Gael	Afar people
Oneida County	Oneida County Idaho
Kurume City	Kurume Fukuoka
Octibecha County	Oktibbeha County Mississippi
Mason County	Mason County Illinois
Jackson Browne	David Ellefson
Federation of European Football Associations	UEFA
BraganzaCoburgo Family	House of BraganzaSaxeCoburg and Gotha
Lita Ford	Lita Ford
Hugo Grotius	Social Democrats
Fina Gale	Yeom Kihun
Shake It Up	Low Franconian languages
Battle of Chancellorsville	Battle of Chancellorsville
Vigo	Vigo
Ivan Krall	Ivan Kral
Jackson Brown	Jackson Browne
Cowley County	Cowley County Kansas
Operation Barbarossa	Operation Barbarossa
THE FACE	The Face
Shigenori Togo	Shigenori Tōgō
National Diet	National Diet
Shekira Soundtrack	Shake It Up
Umar Willahadikusma	Umar Wirahadikusumah
Theodore Schultz	Theodore Schultz
Dunn County	Dunn County Wisconsin
Wilhelmina	Wilhelmina of the Netherlands
Ruben González Rocha	Rubén González Rocha
Michael Schenker Group	Michael Schenker Group
Soyuz25	Soyuz 25
Baruch de Spinoza	Baruch Spinoza
Hardy County	Hardy County West Virginia
Viggianello	Kongo language
Prime Minister of Romania	Antlia
Three Days Grace	Three Days Grace
Paul Patton	Paul E Patton
American Airlines Arena	Autodromo Nazionale Monza
Ulster County	Ulster County New York
My Back Pages	My Back Pages
Just Good Friends	Just Good Friends
Alisa Agafonova	Alisa Agafonova
Independiente Medellín	Independiente Medellín
Reichi Nakaido	My Generation Understand
Low German	Low German
Kenzumi Suematsu	Suematsu Kenchō
Jacob Marschak	Jacob Marschak
Jessie Brown	Jesse Brown
PlayStation 3	PlayStation 3
Yoko Ono	Yoko Ono
Tropicana Field	Tropicana Field
EA Guingan	Melanie C
Taylor County	Taylor County Texas
Spain under Franco	Francoist Spain
Reiichi Nakaido	Reichi Nakaido
Gaiska Mendieta	Gaizka Mendieta
Pierce County	Pierce County North Dakota
Henry L Stimson	Airi Suzuki
Path of Punishment	Heart Station
Club African	Club Africain
I HAVE NEVER SEEN	I Have Never Seen
Thomas Robinson 2nd Baron Grantham	Jonathan Belcher
Norwich	Norwich
Okhotsk Subprefecture	Chthonic
Bengali	Bengali language
John Kerry	John Kerry
George Clinton	George Clinton
Emerson Fittipaldi	Emerson Fittipaldi
Henry Stimson	Henry L Stimson
Emperor Kanmu	Emperor Kanmu
Alister	Allister
Dreaming Now	La Salle County Texas
Thomas Robinson	Thomas Robinson 2nd Baron Grantham
Scream 4	Prince Carl Duke of Västergötland
Okhotsk General Promotion Bureau	Okhotsk Subprefecture
Province of Reggio Calabria	Dai Hakken
Nikolay Rukavishnikov	T no odokanai Ai to Shitteitani Osaekirezu ni Aishitsuzuketa
Kasımpaşa SK	Brittonic languages
Yvonne Elliman	Yvonne Elliman
Cacak	Čačak
Seattle Thru	New Castle County Delaware
Vittorio Emanuele III	Madagascar
Lee County	Lee County Illinois
Takashi Kiyama	Michael Jacksons This Is It
Soyuz TMA02M	Soyuz TMA02M
Prime Minister of Lesotho	Iwata Shizuoka
Draco Rosa	Draco Rosa
John Feldman	John Feldmann
California	California
Kasum Pasha SK	Kasımpaşa SK
Kingdom of Iraq	Kingdom of Iraq
Sadorian	Sadri language
Visions	Visions
Sakura no Hanabiratachi	Killer Kowalski
Dunn County North Dakota	Japan Restoration Party
You Are the Sunshine of My Life	Takashi Kiyama
Feel fine	Feel Fine
Mark Antony	Google Chrome
Mobutu Sese Seko	Mobutu Sese Seko
Message in a Bottle	Utah Jazz
In the Closet	In the Closet
Wilhelm Cuno	SoninLaw
Neil DeGrasse Tyson	Neil deGrasse Tyson
Its all Love	Its All Love
Thomas Wharton	Thomas Wharton 1st Marquess of Wharton
Sakura Petals	Philippine languages
Dun County	Dunn County North Dakota
Sunshine	You Are the Sunshine of My Life
Amagasaki City	Caerleon
Lincoln Parish Louisiana	Mark Antony
Beady Eye	Walther Funk
Messages of loneliness	Message in a Bottle
STAY AWAY	Stay Away
Pierre Pflimlin	Lord William Bentinck
Sotho	Commando
French Indochina	French Indochina
Speaker of the United States House of Representatives	Speaker of the United States House of Representatives
Mahinda Rajapaksa	Mahinda Rajapaksa
Minato Ward	Minato Tokyo
Bernie Worrell	Bernie Worrell
Expedition 39	Coast to Coast
Lincoln County	Lincoln Parish Louisiana
Key to the Mint	Key to the Mint
Libertarian Party	Libertarian Party
Kouki Hirota	Kōki Hirota
Pierre Frimlan	Pierre Pflimlin
Bradford County	Bradford County Florida
FK Partizani Tirana	FK Partizani Tirana
Windows Phone	Windows Phone
Patricia Roberts Harris	Patricia Roberts Harris
Synyster Gates	Puffy AmiYumi
Grancona	Grancona
The 39th longterm stay	Expedition 39
Hard Rock	Hard rock
Don Carlos Buell	Don Carlos Buell
Nîmes Olympiad	Nîmes Olympique
Faulkner County Arkansas	Mayumi Moriyama
Isabel do Brasil	Isabel Princess Imperial of Brazil
Guy Carleton 1st Baron Dorchester	Fushimiku Kyoto
Arctic Monkeys	Arctic Monkeys
UFC	Otto of Greece
NMB48	Lost
Highlands County	Highlands County Florida
John Adams Dix	John Adams Dix
Sinister Gates	Synyster Gates
JosephineCharlotte de Belgic	Princess Joséphine Charlotte of Belgium
Essiliga	Esiliiga
The Corrs	The Corrs
Hull City AFC	Hull City AFC
Toyota Belta	Toyota Belta
Falkner County	Faulkner County Arkansas
Perkins County	Algerian Ligue Professionnelle 1
Guy Carlton	What Is Life
Himya	Himyar
DEEP RIVER	Deep River
Delta County	Delta County Michigan
Ragusa Province	Nobuteru Ishihara
Stockholm county	Stockholm County
Myanmar National Football Team	Myanmar national football team
Apocalyptica	Apocalyptica
World Athletics Championships	IAAF World Championships in Athletics
Suharto	Suharto
Steve Hackett	Steve Hackett
Soyuz 14	Mitchell County North Carolina
Clive Barr	Clive Burr
Star Trek Beyond	Star Trek Beyond
Wolfmother	Wolfmother
Henry Paulson	Henry Paulson
Maze	Al Cohn
Emery County	Emery County Utah
Aries	Aries
Rutherford County	Rutherford County Tennessee
Esprit Arena	Esprit Arena
Denki Groove	Vincent Siew
Got to Get You into My Life	Got to Get You into My Life
Brian Wilson	Brian Wilson
Karl XI	Charles XI of Sweden
Papiermark	German Papiermark
Anna Lee Fisher	Anna Lee Fisher
Elizabeth Anscombe	Princess Marie Louise of Bulgaria
American Bison	American bison
Monroe County New York	Oroch people
M・a・z・e	But Aishō
Ueno Station	Ueno Station
Elk County	Elk County Kansas
Happiness	Happiness
Dennis Ritchie	Dennis Ritchie
STYLE	Thomas Friends
Joinville EC	Joinville Esporte Clube
Higashikuninomiya Prince Naruhiko	Prince Naruhiko Higashikuni
Andrew Bonner Law	Bonar Law
Henry II of France	Kumagaya Athletic Stadium
4th Division	4th Division
Heracles Almelo	Elena of Montenegro
Boris III	Boris III of Bulgaria
The Winery Dogs	The Winery Dogs
Queen Rocks	Queen Rocks
Monroe County	Princess Marie Louise of Hanover
UFC on Foxv	Nevada County California
Emperor Junna	Emperor Junna
James Tobin	Burial
Sabinianus	Pope Sabinian
BoB	BoB
No Doubt	Shinjuku
ClermontFerrand	ClermontFerrand
Cant Stand Losing You	Expedition 42
Karl Barth	Karl Barth
Henri II	Henry II of France
Robert Anderson	Ryūsei Sharirara
Hercules Armello	Barnes County North Dakota
United National Party	United National Party
Nottingham Forest FC	Nottingham Forest FC
Mannar District	Mannar District
VAMPS	Vamps
UFC on FOX 11	UFC on Fox
Billy Sheehan	Billy Sheehan
19th longterm stay	Expedition 19
Millennium Stadium	Millennium Stadium
Maria Elisabeth von Bavaria	Princess Maria Elisabeth of Bavaria
Kings Best	Kings Best
Steve Kahn	Steve Keirn
Leave Me Alone	Leave Me Alone
Portuguese people	President of Romania
