Gary Barlow	Gary Barlow
Villarreal CF B	Villarreal CF B
Putnam County (Florida)	Putnam County, Florida
Battle of Sevastopol (World War II)	Siege of Sevastopol (1941–42)
Giorgio Moroder	Giorgio Moroder
Back Off Boogaloo	Back Off Boogaloo
Opteron	Opteron
Okeechobee County (Florida)	Okeechobee County, Florida
Hiro Yamamoto	Hiro Yamamoto
Isaac Tousey	Isaac Toucey
Prokopis Pavlopoulos	Prokopis Pavlopoulos
Colin Thurston	Colin Thurston
Justin Trudeau	Justin Trudeau
Stillwater County (Montana)	Stillwater County, Montana
PGA European Tourv	Krizz Kaliko
Fire (U2 song)	Fire (U2 song)
Friedrich Nietzsche	Friedrich Nietzsche
Kim Seong Soo	Kim Seong-su
Bancroft Davis	Bancroft Davis
Fitzhugh Lee	Fitzhugh Lee
Supernatural (album)	Supernatural (Santana album)
Tell Him	CS Sedan Ardennes
Skin Yard	Skin Yard
Maxim Litvinov	Maxim Litvinov
External carotid artery	External carotid artery
Wish You The Best	Wish You the Best
UEFA EURO 2016 Qualifying Group C	UEFA Euro 2016 qualifying Group C
Omaha	Omaha, Nebraska
African National Congress	African National Congress
Spanish	Spaniards
Sukenori Kabayama	Kabayama Sukenori
Mikhail Saakashvili	Mikheil Saakashvili
Lucas Oil Stadium	Lucas Oil Stadium
Balto-Finnish languages	Finnic languages
Uruguayan Primera División	Arthur Wellesley, 1st Duke of Wellington
Solate	Soleto
Ikawa Shizuoka	Koto, Tokyo
SV Darmstadt 98	SV Darmstadt 98
Friesland	Friesland
Victor Metcalfe	Victor H. Metcalf
Razorlight	Razorlight
Dorset	Dorset
Dallas	Dallas
In the Wings	In the Wings (horse)
George Michael	George Michael
Crockett County (Tennessee)	Crockett County, Tennessee
George W. Bush	George W. Bush
Halifax County (Virginia)	Halifax County, Virginia
I have a dream	I Have a Dream (song)
Fairfield County (Connecticut)	Fairfield County, Connecticut
Marquis of Salisbury	Marquess of Salisbury
Derek Bell	Derek Bell (racing driver)
Camden County (Missouri)	Camden County, Missouri
Sam Might Say	Some Might Say
Shonan Bellmare	Shonan Bellmare
Volusia County (Florida)	Volusia County, Florida
Henry Wilson	Henry Wilson
BOLERO (Mr.Children's Album)	Bolero (Mr. Children album)
Houghton County (Michigan)	Houghton County, Michigan
Pondera County (Montana)	Pondera County, Montana
Victor Hope 2nd Marquess of Linlithgow	Battle of South Mountain
John Edwards	John Edwards
Dave Mustaine	Dave Mustaine
Bulloch County Georgia	Enrai (Tooku ni Aru Akari)
Saburo Okita	Saburo Okita
Alemannic	Alemannic German
Illinois Institute of Technology	Illinois Institute of Technology
Manga Time Kirara	Manga Time Kirara
TIGER & BUNNY	Tiger & Bunny
Ultramarine Biyori	Gunjō Biyori
Goodyear	Goodyear Tire and Rubber Company
Amway Arena	Amway Arena
sonic (band)	Chthonic (band)
SpaceX CRS-2	SpaceX CRS-2
Walter Funck	Walther Funk
Stanislaus County (California)	Stanislaus County, California
Massachusetts	Massachusetts
Clement Attlee	Clement Attlee
Busanda	Busanda
SHINE	Shine
John McLean	Soyuz 17
Fukushiro Nukaga	Fukushiro Nukaga
Satsuma Sendai City	Satsumasendai, Kagoshima
Mette-Marit (Crown Princess of Norway)	Mette-Marit, Crown Princess of Norway
A new battle begins	The Wars to Come
Ramiz Aria	Ramiz Alia
Edward (Duke of Kent)	Prince Edward, Duke of Kent
Marion County (West Virginia)	Marion County, West Virginia
Lowndes County (Mississippi)	Lowndes County, Mississippi
U.S. Secretary of Veterans Affairs	United States Secretary of Veterans Affairs
Primera Division ( Venezuela)	Venezuelan Primera División
Band on the Run	Band on the Run
Colin Redgrave	Corin Redgrave
The Beatles Anthology 3	Anthology 3
Han Byeongsoo	Han Duck-soo
Boyko Borisov	Boyko Borissov
Suwon Samsung Bluewings	Suwon Samsung Bluewings
John Herschel Glenn	John Glenn
Decisive three minutes	Oishii Kisetsu
The Edge of Glory	The Edge of Glory
Basque Country	Basque Country (autonomous community)
Bruce Kulick	Bruce Kulick
Philadelphia Phillies	Philadelphia Phillies
Nakahara Ward	Nakahara-ku, Kawasaki
STS-95	STS-95
Senate (Italy)	Senate of the Republic (Italy)
Peter Green ( musician)	Peter Green (musician)
Jackson County Tennessee	Potomac Nationals
Chuck Hegel	Chuck Hagel
Timo Bernhardt	Timo Bernhard
Oscar Cardoso	Óscar Cardozo
VLeague 1	Mary of Teck
DAYBREAK'S BELL	Daybreak's Bell
Daniel Smith ( Surveyor)	Daniel Smith (surveyor)
Emperor Shomu	Emperor Shōmu
Masami Ihara	Masami Ihara
Castro County (Texas)	Castro County, Texas
I Shall Be Released	I Shall Be Released
Louisiana	Louisiana
Toyota Stadium	Toyota Stadium
Letna Stadium	Generali Arena
Caykur Rizespor	Çaykur Rizespor
Talking Heads	Talking Heads
Democratic Party	Dive to Blue
Tokelauan	Tokelauan language
Fuzhou	Fuzhou
Fujio Fujiko	Fujiko Fujio
O. K. Funky God	O.K. Funky God
Department of Savoie	Savoie
Yoshimi Watanabe	Kimiya Yui
Saki Shimizu	Saki Shimizu
Ernest Hemingway	Ernest Hemingway
Falbrav	Falbrav
AS Saint-Etienne	AS Saint-Étienne
Nobuaki Ishihara	Nobuteru Ishihara
Kershaw County (South Carolina)	Kershaw County, South Carolina
Yagamitoru	Toll Yagami
Courtney Cox	Courteney Cox
Mahavishnu Orchestra	Mahavishnu Orchestra
Visions	Visions (Stratovarius album)
Richard Stallman	Richard Stallman
AP Indy	A.P. Indy
Uniforms get in the way	Seifuku ga Jama o Suru
Vancouver (British Columbia)	Vancouver
Paul Cézanne	Paul Cézanne
Province of Cosenza	Province of Cosenza
Chrysler LHS	Chrysler LHS
I'm Stepping Out	I'm Stepping Out
Kyrgyz Soviet Socialist Republic	Kirghiz Soviet Socialist Republic
Byron Scott	Byron Scott
Primeira Liga	Primeira Liga
Dnieper River	Dnieper
Love, Day After Tomorrow	Love, Day After Tomorrow
John Hancock	John Hancock
Japanese rule (Taiwan)	Taiwan under Japanese rule
Iron County (Michigan)	Iron County, Michigan
Battle of Jonesborough	Battle of Jonesborough
Halloween (band)	Helloween
Ash (band)	Ash (band)
Winter Magic	Winter Magic (song)
Second ItaloEthiopian War	Nancy Reagan
Washington and Lee University	Washington and Lee University
Spencer Perceval	Three 6 Mafia
Sussex County (Virginia)	Sussex County, Virginia
Sergey Belbiro	Sergei Verbillo
Estadio Jose Alvarade	Estádio José Alvalade
Riverman	Riverman
Sugar Babes	Sugababes
Myanmar Football League	Myanmar National League
World Series	World Series
Sea The Stars	Sea the Stars
Robbie Robertson	Robbie Robertson
Them	Them (band)
Wim Cook	Wim Kok
Eddie Lewis	Eddie Lewis (American soccer)
FC Dinamo Bucharest	FC Dinamo București
Miryoku ga Sugoi yo	Birmingham City F.C.
Francis Osborne ( 5th Duke of Leeds)	Francis Osborne, 5th Duke of Leeds
Yankee Stadium	Yankee Stadium
Husker Do	Hüsker Dü
Ryuzo Morioka	Ryuzo Morioka
Cameron Jerome	Cameron Jerome
Euboea	Cornelius (musician)
Mozilla Firefox	Firefox
Jiro Horikoshi	Jiro Horikoshi
Three Rivers Stadium	Three Rivers Stadium
6th Division (Japanese Army)	6th Division (Imperial Japanese Army)
Schuyler County (Illinois)	Schuyler County, Illinois
Abhisit Vejjajiva	Scania
Daisuke Asakura	Daisuke Asakura
Celebration (U2 song)	A Celebration
Nemzeti Binoksharg I	Nemzeti Bajnokság I
Rhode Island	Rhode Island
Jackson County (Colorado)	Jackson County, Colorado
Charles Howard 11th Duke of Norfolk	Mehdi Bazargan
Dragon Dance ( Game of Thrones)	The Dance of Dragons
Korean Empire	Korean Empire
Lloyd Bentsen	Lloyd Bentsen
Reijiro Wakatsuki	Wakatsuki Reijirō
Gardenian	Gardenian
Nicola Sarkozy	Nicolas Sarkozy
Lynne Cheney	Evolution (Ayumi Hamasaki song)
Eternity (Every Little Thing album)	Eternity (Every Little Thing album)
Ouachita County (Louisiana)	Ouachita Parish, Louisiana
Beaver County (Oklahoma)	Beaver County, Oklahoma
Madison (Wisconsin)	Madison, Wisconsin
Ellis County (Texas)	Ellis County, Texas
Gates County (North Carolina)	Gates County, North Carolina
US Latina Calcio	U.S. Latina Calcio
Comintern	Communist International
Myron Timothy Herrick	Myron T. Herrick
Humboldt County (Nevada)	Humboldt County, Nevada
Randy Newman	Randy Newman
William IV (King of England)	William IV of the United Kingdom
Jeff Lynne	A.C. Cesena
Palopinto County (Texas)	Palo Pinto County, Texas
Singapore Dollar	Singapore dollar
McCloud River	Maurizio Domizzi
Orok people	Dory Funk Jr.
Nikolay Bulganin	Nikolai Bulganin
Mercer County (North Dakota)	Mercer County, North Dakota
Derby	Derbi
Hougang United FC	Hougang United FC
Sinfonia (band)	Symfonia
Oskar Zariski	Oscar Zariski
Malmo FF	Malmö FF
Guernsey County (Ohio)	Guernsey County, Ohio
Hindi	Hindi
AS Monaco	AS Monaco FC
Yukihiro	Yukihiro (musician)
Kia Tigers	Kia Tigers
Ritchie County (West Virginia)	Ritchie County, West Virginia
Falaris	Phalaris (horse)
Blind Face	Blind Faith
Dream Fighter	Dream Fighter
women	Some Girls
Robert Menendez	Bob Menendez
Limestone County (Texas)	Limestone County, Texas
Socket AM2+	Socket AM2+
Bob Ezrin	Bob Ezrin
Elisabeth (Empress of Austria)	Empress Elisabeth of Austria
FIFA Club World Cup	FIFA Club World Cup
The Workers' Party of Korea	Workers' Party of Korea
Pittsburgh Pirates	Pittsburgh Pirates
Kantai Collection -Kancolle-	Kantai Collection
Liberal Party of Canada	Liberal Party of Canada
Vladimir Lyakhov	Vladimir Lyakhov
Lyla (Oasis song)	Lyla (song)
Mason County (West Virginia)	Mason County, West Virginia
Oirat	Oirat language
James Butler ( 1st Duke of Ormonde)	James Butler, 1st Duke of Ormonde
Tani Tachijo	Tani Tateki
Knox County (Illinois)	Knox County, Illinois
Pat Harrison	Pat Harrison
Lilium auratum	Susan Collins
Post Hardcore	Post-hardcore
Xian	Xi'an
Marina (Duchess of Kent)	Princess Marina of Greece and Denmark
Yokkaichi City	Yokkaichi, Mie
Dubai	Dubai
dead or alive5	Dead or Alive 5
Fueled by Ramen	Fueled By Ramen
United States Secretary of Agriculture	United States Secretary of Agriculture
GO!!!	Go (Flow song)
Ken Andrews	Ken Andrews
Hainanese	Hainanese
Dusseldorf	Düsseldorf
Wolfmother	Wolfmother
Mao Abe	Mao Abe
Ranasimha Premadasa	Ranasinghe Premadasa
Madison County Tennessee	Tommy Aldridge
The 35th long-term stay	Expedition 35
Curtis Wilbur ( politician)	Curtis D. Wilbur
Ferdinand I (King of Bulgaria)	Ferdinand I of Bulgaria
Nigorai Saaansun	Nikolaj Sørensen
Everett Dirksen	Everett Dirksen
Veglie	Battle of Stones River
Bernhard I (Duke of Braunschweig-Lüneburg)	Bernard I, Duke of Brunswick-Lüneburg
Rock County (Wisconsin)	Rock County, Wisconsin
Talisman (Band)	Talisman (band)
Hironobu Kageyama	Hironobu Kageyama
Saga Prefecture	Saga Prefecture
Australian Labor Party	Australian Labor Party
Tuolumne County (California)	Tuolumne County, California
Kanji	Chinese characters
Claude Shannon	Claude Shannon
Tanis Belvin	Tanith Belbin White
Tears for Fears	Tears for Fears
Ultra Madonna ~ Greatest Hits	The Immaculate Collection
All Ends	All Ends
FC Twente	FC Twente
Arthur Mastic Hyde	Arthur M. Hyde
Bob Dylan	Bob Dylan
Midge Euro	Midge Ure
Montferland	Montferland
Soyuz TM-31	Soyuz TM-31
Hindustani	Hindustani language
Roma	Romani language
Nuclear Blast	Nuclear Blast
Me (misono's album)	Me (Misono album)
Isuzu Gemini	Isuzu Gemini
Furci	Lauro Cavazos
Mongol-Southern Song War	Mongol conquest of the Song dynasty
Morrow County (Ohio)	Morrow County, Ohio
Introducing the Beatles	Introducing The Beatles
Isaac Stevens	Isaac Stevens
American Bison	American bison
Killer Tune	Killer-tune
Jen Saki	Jen Psaki
Beltrami County Minnesota	Vĩnh Long Province
Linux	Linux
Lequile	Cardiff City F.C.
Legend of the Legendary Hero	The Legend of the Legendary Heroes
LOST (6th season)	Lost (season 6)
FC Krasnodar	FC Krasnodar
King Crimson	King Crimson
Allen County (Ohio)	Allen County, Ohio
Young Jock	Yung Joc
near-tick	Nearctic (horse)
News Corporation ( 1979-2013)	News Corporation
Webster County (Louisiana)	Webster Parish, Louisiana
Vizcaya Province	Biscay
Batak characters	Batak alphabet
Constantine I of Greece	People's Chamber
Gediminas Kirkiras	Gediminas Kirkilas
Party of Labour of Albania	Roundell Palmer, 1st Earl of Selborne
Lunenburg County (Virginia)	Lunenburg County, Virginia
Greene County (New York State)	Greene County, New York
Alex Turner	Alex Turner (musician)
Theodore Whitmore	Theodore Whitmore
Kaufman County Texas	Indonesian language
Napoleon Bonaparte	Napoleon
Lee Hae Chang	Lee Hae-chan
Colombian Revolutionary Army	FARC
Olympique Lyonnais	Olympique Lyonnais
Williams FW19	Williams FW19
Fundamental Love	Fundamental Love
Egon Klebsch	Egon Klepsch
Kohoku Ward	Kōhoku-ku, Yokohama
Faulk County South Dakota	Turkey
Coalition for the Radical Left	Syriza
The Flaming Lips	The Flaming Lips
Marianne Faithful	Marianne Faithfull
Al Unser Jr.	Al Unser, Jr.
Bring It On Home To Me	Bring It On Home to Me
Manchester City FC	Manchester City F.C.
Lowndes County (Georgia)	Lowndes County, Georgia
Takashi Sugiura	Takashi Sugiura
Kardinal Offishall	Cyprus
Rikken Minseito	Rikken Minseitō
Wood County (West Virginia)	Wood County, West Virginia
idling!!! (group)	Idoling!!!
Madison County (Montana)	Madison County, Montana
Nissan Leopard	Nissan Leopard
Alfonso XIII (King of Spain)	Alfonso XIII of Spain
Phil Lynott	Phil Lynott
Hiro Matsuda	Hiro Matsuda
AKB48	AKB48
Symphonic Black Metal	Symphonic black metal
Sing gently (album)	Killing Me Softly (Roberta Flack album)
Carnage	Carnage (band)
Got to Get You into My Life	Got to Get You into My Life
Masayoshi Takemura	Masayoshi Takemura
Groove Metal	Groove metal
Umbria	Umbria
your te	Kimi no Te
Brenby IF	Brøndby IF
Them Crooked Vultures	Them Crooked Vultures
BE TOGETHER	Be Together
Kerris	Kelis
Uruguay	Uruguay
Edward III (King of England)	Edward III of England
Day Tripper	Day Tripper
Aristotle	Aristotle
Love Me Do	Love Me Do
Yuki Kashiwagi	Yuki Kashiwagi
Dikab County (Georgia)	DeKalb County, Georgia
Let Yourself Go	Let Yourself Go (Green Day song)
Judd Allan Gregg	Judd Gregg
Curitiba	Curitiba
Glades County Florida	Sadistic Mika Band
Vibo Valentia Province	Province of Vibo Valentia
Robert Zoellick	Robert Zoellick
Soyuz 7KT No39	Province of Salerno
Elena Kustalova	Elena Kustarova
Edward Stanley ( 17th Earl of Derby)	Edward Stanley, 17th Earl of Derby
Elbridge Gerry	Elbridge Gerry
William Cavendish ( 4th Duke of Devonshire)	William Cavendish, 4th Duke of Devonshire
Pierluigi Collina	Pierluigi Collina
Windows Store	Windows Store
Monroe County New York	Oroch people
Lamberto Dini	Lamberto Dini
Joseph Hooker	Joseph Hooker
Loic Duval	Loïc Duval
Nickelodeon (TV channel)	Nickelodeon
Thessaloniki	Thessaloniki
James Cecil ( 1st Marquess of Salisbury)	James Cecil, 1st Marquess of Salisbury
Bitch Magnet	Bitch Magnet
Malcolm Turnbull	Malcolm Turnbull
KNVB Cup	KNVB Cup
Paola Ruffo di Calabria	Queen Paola of Belgium
Afuresō na Ai Daite Namida o Fuite	Valentinas Mazuronis
WEC 43	WEC 43
Vietnam People's Army	People's Army of Vietnam
Pierre François de Rigaud	Pierre de Rigaud, Marquis de Vaudreuil-Cavagnial
Sri Lanka Liberal Party	Sri Lanka Freedom Party
Maximilian I (Holy Roman Emperor)	Maximilian I, Holy Roman Emperor
Fairy King	Fairy King
Elbert County (Georgia)	Elbert County, Georgia
Munich Olympiastadion	Olympiastadion (Munich)
T-ARA	T-ara
John Hicks	John Hicks
Gibson EDS - 1275	Gibson EDS-1275
Roy Khan	Roy Khan
Mongolic languages	Manila
Naslula	Nasrullah (horse)
Karim Saidi	Karim Saidi
Touch Me ( The Doors song)	Touch Me (The Doors song)
Michael Schenker Group	Michael Schenker Group
Williams FW30	Williams FW30
US Salernitana 1919	U.S. Salernitana 1919
McA・T	M.c.A.T
Suwa City	Suwa, Nagano
Sergey Road	Sir Gaylord
Calhoun County West Virginia	Morning Musume
Nicolas Léonard Sadi Carnot	Nicolas Léonard Sadi Carnot
Kriya Sovetov Samara	FC Krylia Sovetov Samara
Ha Daesung	Celtic F.C.
Tamil	Tamil language
Daniel Finch ( 2nd Earl of Nottingham)	Daniel Finch, 2nd Earl of Nottingham
Tule	Two Lea
Can We Go Back	Can We Go Back
Robert F. Kennedy Memorial Stadium	Robert F. Kennedy Memorial Stadium
Montefredane	Montefredane
Sultan (Racehorse)	Sultan (horse)
Turkey National Football Team	Turkey national football team
North OssetiaAlania	John Chafee
Johnny Herbert	Johnny Herbert
ANSWER (Angela Aki album)	Answer (album)
Julian Huxley	Julian Huxley
CA San Lorenzo	San Lorenzo de Almagro
Osamu Nishimura	Osamu Nishimura
Erich Rader	Erich Raeder
Wyandot County (Kansas)	Wyandotte County, Kansas
Tyne and Wear	Tyne and Wear
British Columbia	British Columbia
Hip Hop Soul	Hip hop soul
Thomas Nelson Jr.	Thomas Nelson, Jr.
BELIEVE (MISIA song)	Believe (Misia song)
Klaus Iohannis	Arnold Schwarzenegger
CD Lugo	CD Lugo
Goguryeo	Goguryeo language
Anders Frieden	Anders Fridén
Cass County (North Dakota)	Cass County, North Dakota
Jackson (musical instrument maker)	Jackson Guitars
Echols County (Georgia)	Echols County, Georgia
Portland Timbers	Portland Timbers
Li Keqiang Cabinet	Li Keqiang Government
Comarca de Pontevedra	Pontevedra (comarca)
Adyghe	Adyghe language
Rick Astley	Rick Astley
Derlingdu	Derring-Do
Gray Sovereign	Grey Sovereign
Henkka Seppälä	Henk Timmer (footballer)
French and Indian War	French and Indian War
Pipes of Peace ( Music)	Pipes of Peace (song)
Soyuz TMA-15	Soyuz TMA-15
Mary J. Blige	Mary J. Blige
Walter Benjamin	Walter Benjamin
Orange County (North Carolina)	Orange County, North Carolina
National Assembly (Hungary)	National Assembly (Hungary)
Socrates	Socrates
President (Austria)	President of Austria
Saudi Arabian Air Force	Royal Saudi Air Force
Paul-Henri Spaak	Paul-Henri Spaak
Dragon Magazine (Fujimi Shobo)	Dragon Magazine (Fujimi Shobo)
Ware County (Georgia)	Ware County, Georgia
Humphreys County (Tennessee)	Humphreys County, Tennessee
RIVER (AKB48 song)	River (AKB48 song)
Radical Party	Radical Party (France)
Time goes by	Time Goes By
Yomiuri Television Broadcast	Yomiuri Telecasting Corporation
Jackson County (Missouri)	Jackson County, Missouri
US dollars	United States dollar
Richard Stone	Richard Stone
SE Palmeiras	Sociedade Esportiva Palmeiras
Veneto	Venetian language
The Little Fox	Vulpecula
Nicolas de Malbranche	Nicolas Malebranche
Robert Louis Stevenson	Robert Louis Stevenson
Papiamento	Papiamento
Pontiac Silverdome	Silverdome
Marios Iliopoulos	Marios Iliopoulos
Ilkhan Dynasty	Ilkhanate
Nazi Germany	Nazi Germany
Wibbo County (Montana)	Wibaux County, Montana
Platinum 9 DISC	Platinum 9 Disc
Giuliano Amato	Giuliano Amato
Albert Gallatin	Albert Gallatin
Tottori City	Tottori, Tottori
O2 Arena (London)	The O2 Arena
Yngwie Malmsteen	Yngwie Malmsteen
ANDROID	Android (TVXQ song)
Bruce Welch	Bruce Welch
Charles Edison	Charles Edison
Rita Coolidge	Rita Coolidge
College of Colorado	Colorado College
Jose Martinez Sanchez	Pirri
Bringing It All Back Home	Bringing It All Back Home
John Breckinridge	John C. Breckinridge
Dallas County (Alabama)	Dallas County, Alabama
PlayStation Vita	PlayStation Vita
Miguel de Cervantes	Miguel de Cervantes
Jane's Addiction	Jane's Addiction
Socialism International	Socialist International
Speedmetal	Speed metal
Coweta County (Georgia)	Coweta County, Georgia
Seo Yongduk	Andy Summers
Stanley County (South Dakota)	Stanley County, South Dakota
Falcon 9	Falcon 9
Minamijiro	Jirō Minami
Jamiroquai	Jamiroquai
Kimi no Machi Made	Barry Adamson
Hide	Hide (musician)
Independiente Medellín	Independiente Medellín
Ocean Bone	Oceanborn
Juntu Pal Si	Together for Yes
Independiente Santa Fe	Independiente Santa Fe
Chiang Ching-Kuo	Chiang Ching-kuo
San Antonio Spurs	San Antonio Spurs
Operation Barbarossa	Operation Barbarossa
Qualcomm Stadium	Qualcomm Stadium
Governor Morris	Gouverneur Morris
Guy Berryman	Guy Berryman
GOING UNDER GROUND	Going Under Ground
George (Duke of Kent)	Prince George, Duke of Kent
Harry Nilsson	Harry Nilsson
Cataraugus County (New York State)	Cattaraugus County, New York
Al Faisaly Amman	Al-Faisaly SC (Amman)
Weezer	Weezer
Real Madrid Baron Cest	Real Madrid Baloncesto
Estonia	Estonia
Shelby County Missouri	Trivium (band)
University of Melbourne	University of Melbourne
Holiday (Green Day song)	Holiday (Green Day song)
Garrett Lucas	Garrett Lucash
Corriel County (Texas)	Coryell County, Texas
William Allen ( politician)	William Allen (governor)
Colin Wilson	Colin Wilson
Death Angel	Death Angel
Charles Howard ( 11th Duke of Norfolk)	Charles Howard, 11th Duke of Norfolk
Flower (Kumi Koda's song)	Flower (Kumi Koda song)
Pet Shop Boys	Pet Shop Boys
Stanley County (North Carolina)	Stanly County, North Carolina
MTV	MTV
West Java	West Java
Dareka no Negai ga Kanau Koro	Mari Vartmann
Microsoft Office	Microsoft Office
Albania national football team	Albania national football team
Procol Harum	Procol Harum
Small Faces	Small Faces
Beijing National Stadium	Beijing National Stadium
Hilary Benn	Hilary Benn
hifi message	Hi-Fi Message
Bolton Wanderers FC	Bolton Wanderers F.C.
Brian Johnson	Brian Johnson
TONE (album)	Tone (TVXQ album)
Liga de Asenzo	Ascenso MX
Yuliya Tymoshenko	Yulia Tymoshenko
Throwing Muses	Throwing Muses
Loop (Novel by Koji Suzuki)	Loop (novel)
Ministry of Justice	Ministry of Justice (Japan)
Sideone dummy record	SideOneDummy Records
WOW (Junko Onishi's Album)	WOW (Junko Onishi album)
Polk County Georgia	Mind Games (song)
Henry (Duke of Gloucester)	Prince Henry, Duke of Gloucester
German Revolution of 191819	Kirill Meretskov
Alone in my room	Alone in My Room (Ami Suzuki song)
Norfolk Southern Railway	Norfolk Southern Railway
Can't Fight the Moonlight	Can't Fight the Moonlight
Clark County (Virginia)	Clarke County, Virginia
Walter Scher	Walter Scheel
Taurus	Phoenix (constellation)
Seward County (Kansas)	Seward County, Kansas
Crimean War	Crimean War
Democratic Convergence of Catalonia	Rutgers University
The White Stripes	The White Stripes
James Franck	Skåne County
Ryo Owatari	Ryo Owatari
Gesu no Kiwami Otome	Dareka no Negai ga Kanau Koro
Gojira	Province of Caserta
Toyota TF108	Toyota TF108
Come Back to Me	Come Back to Me (Utada Hikaru song)
TAKA Michinoku	Taka Michinoku
fated	Fated
Whatever People Say I Am , That 's What I 'm Not	Whatever People Say I Am, That's What I'm Not
The 41st Long Stay	Expedition 41
Yasser Arafat	Yasser Arafat
John's Soul	Plastic Ono Band
LeSports Center	Sylvain Armand
Taro Aso	Tarō Asō
Tito Jackson	Tito Jackson
John Harsanyi	John Harsanyi
Tibet Autonomous Region	Tibet Autonomous Region
William III (King of England)	William III of England
Atsushi Onita	Atsushi Onita
Rivers Cuomo	Rivers Cuomo
Incheon United FC	Incheon United FC
Anderson Hernanes de Carvalho Andrade Lima	Hernanes
ITV (UK)	ITV (TV network)
Tomokazu Myojin	Tomokazu Myojin
NIFL Championship 1	NIFL Championship 1
Cass County Missouri	Oh Jang-eun
Shikoku	Shikoku
Social Democratic Progressive Alliance	Progressive Alliance of Socialists and Democrats
THE FACE	The Face (album)
Soyuz TMA-08M	Soyuz TMA-08M
Tessa Virtue	Tessa Virtue
Taro Katsura	Katsura Tarō
Theodore Schultz	Theodore Schultz
Nintendo Wi-Fi Connection	Nintendo Wi-Fi Connection
Chad Smith	Chad Smith
Isaac Newton	Isaac Newton
John Lecomp	John LeCompt
Adolfo Suarez	Adolfo Suárez
Bell Labs	Bell Labs
Korea Railroad Corporation	Korail
North Ndebele	Zimbabwean Ndebele language
Edgecombe County (North Carolina)	Edgecombe County, North Carolina
Josh Homme	Josh Homme
INXS	INXS
Magnolia kobus	New York Red Bulls
Hangzhou Green City Football Club	Hangzhou Greentown F.C.
silicon	Silicon
Yellow Magic Orchestra	Yellow Magic Orchestra
Democratic Movement Party (Cyprus)	Democratic Rally
Bridge Over Tomorrow	Bridge over Troubled Water (song)
John Cleary	Jon Cleary (musician)
Kingdom of Iceland	Kingdom of Iceland
Hakodate City	Hakodate, Hokkaido
AROUND THE WORLD (Ami Suzuki's album)	Around the World (Ami Suzuki album)
Party Queen	Party Queen
Marie-France Dubreuil	Marie-France Dubreuil
UFC 128	UFC 128
Destiny's Child	Destiny's Child
Edward Douglas White	Edward Douglass White
Washington University in St Louis	Ali Tarhouni
Libya	Libya
Don Felder	Don Felder
Atripalda	Atripalda
Madison County New York	Charles County, Maryland
Pedro II (Emperor of Brazil)	Pedro II of Brazil
Japan	Japan
Foxconn	Foxconn
Berkeley County (West Virginia)	Berkeley County, West Virginia
Siver	Shiver (Coldplay song)
Waltari	Waltari
Jake Shimabukuro	Jake Shimabukuro
Combined Fleet	Combined Fleet
Howard University	Howard University
CF Monterrey	C.F. Monterrey
Renofa Yamaguchi FC	Renofa Yamaguchi FC
Oman League	Oman Professional League
Peace Delivered!!	Peace Otodoke!!
Lynn County (Iowa)	Linn County, Iowa
Nepali	Nepali language
Richard Dawkins	Richard Dawkins
University of Pisa	University of Pisa
Dreams Metro Gallery FC	Live at the Village Vanguard Vol. II (Junko Onishi album)
Edguy	Edguy
Weber County Utah	Delain
Shenzhen	Shenzhen
John Danforth	John Danforth
Ministry of Defense of Russia	Ministry of Defence (Russia)
John C Breckinridge	Help! (song)
Kimi no Tame ni Dekiru Koto	Club América
Feel my mind	Feel My Mind
Gagarin Launch Pad	Gagarin's Start
Aso Ward	Asao-ku, Kawasaki
Iredel County	Iredell County, North Carolina
Poland national football team	Khaled (horse)
Kyuss	Liberian Girl
Communist Party of the Soviet Union	Communist Party of the Soviet Union
FAIRY TAIL	Fairy Tail
ponder	Ponder (horse)
Tsai Ing-wen	Tsai Ing-wen
Inyo County (California)	Inyo County, California
Brunswick (Maine)	Brunswick, Maine
Ahmad Naseef	Ahmed Nazif
Jeff Scott Sort	Jeff Scott Soto
Real Zaragoza	Real Zaragoza
Mondaris	Mondariz
cast (band)	Cast (band)
KISS (L'Arc ~ en ~ Ciel album)	Kiss (L'Arc-en-Ciel album)
WEC 47	WEC 47
Jazz Rap	Jazz rap
Squinzano	Squinzano
Special Region of Yogyakarta	Special Region of Yogyakarta
First Love (Hikaru Utada's song)	First Love (Utada Hikaru song)
AIR (game)	Air (visual novel)
Soyuz 15	Soyuz 15
Alexander Ramsey	Alexander Ramsey
girls power	Speed Up (Kara song)
Tamara Moskvina	Tamara Moskvina
Tommy Walter	Tommy Walter
Supergrass	Supergrass
Iran Airways	Iran Air
BYE BYE	Bye Bye (Miliyah Kato song)
Saint Ballard	Saint Ballado
Sadorian	Sadri language
Alfred Deakin	Alfred Deakin
Meade County South Dakota	William Henry Smith (1825–1891)
Fortaleza EC	Fortaleza Esporte Clube
Gallo language	Matthew Blackmer
Korea	Korea
Kashima Soccer Stadium	Wuhan
Polish	Poles
Julius II (Pope)	Pope Julius II
Motion City Soundtrack	Motion City Soundtrack
Timur	Timurid Empire
Edward Bulwer - Lytton	Edward Bulwer-Lytton
JVC	JVC
Pokemon the Movie Advanced Generation Pokémon Ranger and Prince of the Blue Sea Manaphy	Pokémon Ranger and the Temple of the Sea
Ernst Kummer	Ernst Kummer
Cedar County (Missouri)	Cedar County, Missouri
Teijiro Toyoda	Teijirō Toyoda
Forbidden lover	Forbidden Lover (song)
Lincoln County (Montana)	Lincoln County, Montana
John Atta Mills	John Atta Mills
Daur	Daur language
Democratic Party (USA)	Democratic Party (United States)
contour (song)	Rinkaku (song)
TAJIRI	Yoshihiro Tajiri
The Fame	The Fame
Matti Vanhanen	Matti Vanhanen
Michigan	Michigan
USA Women's National Soccer Team	United States women's national soccer team
Shining (Crystal Kay's album)	Shining (EP)
Urichi	Ulch people
Wrigley Field	Wrigley Field
McConne County (Montana)	McCone County, Montana
Aftermath	Aftermath (The Rolling Stones album)
Copa do Brasil	Copa do Brasil
Paul Banks	Paul Banks (singer)
Smoke on the Water	Smoke on the Water
Placard of the Heart	Kokoro no Placard
Czech Republic	Czech Republic
progress-M	Progress-M
Luis Cass	Lewis Cass
Cyllene	Vanilla Ninja
Mike Terrana	Mike Terrana
Ravali County	Ravalli County, Montana
GUILTY (Ayumi Hamasaki's Album)	Guilty (Ayumi Hamasaki album)
Left Brain	Left Brain
HOCUS POCUS	Hocus Pocus (Kaela Kimura album)
Schuylkill County (Pennsylvania)	Schuylkill County, Pennsylvania
Any Other Way	(If There Was) Any Other Way
Richard Wellesley ( 1st Marquess Wellesley)	Richard Wellesley, 1st Marquess Wellesley
Adachi Ward	Adachi, Tokyo
Williams FW17	Williams FW17
William Legge ( 2nd Earl of Dartmouth)	William Legge, 2nd Earl of Dartmouth
Toyonaka City	Toyonaka, Osaka
Sagamihara City	Sagamihara
Linda McCartney	Linda McCartney
Bedizzole	Bedizzole
Yuki Mizumoto	Hiroki Mizumoto
High Wycombe	High Wycombe
The Gloria Record	Hindoo (horse)
The Verve	The Verve
Kofu City	Kōfu
Gottolob Frege	Gottlob Frege
Soyuz TMA-10M	Soyuz TMA-10M
Total Nonstop Action Wrestling	Windows Vista
Michael Mansfield	Mike Mansfield
Tonga	Tonga
All Japan Pro Wrestling	All Japan Pro Wrestling
Baruch de Spinoza	Baruch Spinoza
Japan National Rugby Team	Japan national rugby union team
List of Presidents of Armenia	President of Armenia
Fianna Foyle	Fianna Fáil
Kiribati	Gilbertese language
Paul Rodgers	Hamdan bin Rashid Al Maktoum
Vestra Gotaland County	Västra Götaland County
DRAGON GATE	Dragon Gate
FreeBASIC	FreeBASIC
Charles Franklin Brannan	Charles F. Brannan
Lady Gaga	Lady Gaga
Torlac dialect	Torlakian dialect
Lee Dorian	Lee Dorrian
Edison Chen	DragonForce
Zhou Enlai	Zhou Enlai
ZARD	Zard
ZPsert	ZP Theart
New Hampshire	New Hampshire
Rainbow (band)	Rainbow (rock band)
Westmoreland County (Virginia)	Westmoreland County, Virginia
Golden Coast	Golden Coast (Flow album)
Udeje	Udege people
SUEMITSU & THE SUEMITH	Suemitsu & the Suemith
Mel Collins	Mel Collins
Tajik	Tajik language
Aide Iskandar	Aide Iskandar
Johnson County (Texas)	Johnson County, Texas
Miss Universe	Miss Universe
Kengo Kimura	Kengo Kimura
Elmore County (Idaho)	Elmore County, Idaho
Fuji Television Network, Inc.	Fuji Television
Empire of Japan	Empire of Japan
God Save the Queen ( Sex Pistols song)	God Save the Queen (Sex Pistols song)
Jackson County North Carolina	John Burgoyne
Honey and Clover	Honey and Clover
French National Championship	Championnat National
Fender Musical Instruments Corporation	Rod Stewart
Takuro Kikuoka	Takuro Kikuoka
Montreal Impact	Montreal Impact
Eric Carmen	Eric Carmen
Expedition 28	NRG Stadium
Hiroyuki Taniguchi	Hiroyuki Taniguchi
Chandrika Kumaratunga	Chandrika Kumaratunga
Boldric	Baldric (horse)
Love so sweet	Love So Sweet
William F Knowland	Beep!! (Superfly song)
Ogai Mori	Mori Ōgai
Caelum	Dejan Savićević
Beat Takeshi	Takeshi Kitano
Avicii	Avicii
Amherst County (Virginia)	Amherst County, Virginia
Wilhelm Flick	Wilhelm Frick
SMILE (L'Arc ~ en ~ Ciel album)	Smile (L'Arc-en-Ciel album)
Gilles Deleuze	Gilles Deleuze
Nino Burjanadze	Nino Burjanadze
UFC 145	UFC 145
Malaysia Premier League	Malaysia Premier League
Sugababes	List of heads of state of the Central African Republic
McLean County (Illinois)	McLean County, Illinois
Syringa vulgaris	Sia Furler
Fidel Castro	Fidel Castro
Expedition 1	Fumiya Kogure
ICONIQ	Iconiq
Fender Telecaster	Fender Telecaster
William Jones ( Secretary of the Navy)	William Jones (statesman)
Luis Carrero Blanco	Luis Carrero Blanco
Giovanni Golia	Giovanni Goria
Padua Province	Province of Padua
Kalmah	Park Geun-hye
Babyface (musician)	Babyface (musician)
Stefan Johansson	Stefan Johansson
John Henry Snunu	John H. Sununu
Century Media Records	Century Media Records
Taylor County (Florida)	Taylor County, Florida
Saint Lucia	Saint Lucia
Eridanus	Eridanus (constellation)
Plastic Ono Band	Plastic Ono Band
Marie Antoinette	Marie Antoinette
Braganza-Coburgo Family	House of Braganza-Saxe-Coburg and Gotha
Withering to death.	Withering to Death.
ARCHE (album)	Arche (album)
National League	National League
New Year 's Day	New Year's Day (song)
Larimar County (Colorado)	Larimer County, Colorado
Nikolay Luyshkov	Nikolai Ryzhkov
Driver's High	Driver's High
Buckingham County (Virginia)	Buckingham County, Virginia
Léo Silva	Shanghai SIPG F.C.
Jestrykland	Gästrikland
Offspring	The Offspring
Chaotic Hardcore	Mathcore
Park Yoochun	Gorō Matsui
Christopher Boyage	Christopher Boyadji
Sanae Takaichi	Sanae Takaichi
William I German Emperor	Orion (Mika Nakashima song)
Samuel Ingham ( Secretary of the Treasury)	Samuel D. Ingham
Royal Hunt	Royal Hunt
Didier Drogba	Didier Drogba
Soyuz TMA-14M	Soyuz TMA-14M
GACKT	Gackt
Chris (Racehorse)	Kris (horse)
Stud Lance	Stade de Reims
Tammam Salam	Tammam Salam
Etmund Husserl	Edmund Husserl
Diptera	Fly
AFC Champions League 2007	2007 AFC Champions League
O Polinho	O Porriño
Nagaoka Niigata	Katakana
Morris County (New Jersey)	Morris County, New Jersey
Muammar Gaddafi	ACF Fiorentina
Patricia Roberts Harris	Patricia Roberts Harris
New Madrid County (Missouri)	New Madrid County, Missouri
Enrique Iglesias	Enrique Iglesias
McKenzie County (North Dakota)	McKenzie County, North Dakota
PYT	P.Y.T. (Pretty Young Thing)
Sergio Mattarella	Sergio Mattarella
Dewey County (South Dakota)	Dewey County, South Dakota
Atomic Heart	Atomic Heart
Kapampangan language	Lamb of God (band)
Telemundo	Telemundo
John Magruder	John B. Magruder
ML (programming language)	ML (programming language)
Tei Towa	Towa Tei
Khabarovsk Krai	Khabarovsk Krai
State of the Nation	State of the Nation (New Order song)
Overijssel	Overijssel
Edmund Randolph	Edmund Randolph
Nates Petznik	Nejc Pečnik
Max von Laue	Max von Laue
President of Sri Lanka	President of Sri Lanka
Zweigen Kanazawa	Zweigen Kanazawa
Parajano	Palagiano
Pipes of Peace	Pipes of Peace
Robin Gibb	Robin Gibb
Richard Thompson ( Secretary of the Navy)	Richard W. Thompson
Makoto	Makoto (wrestler)
Beti language	Atsugi, Kanagawa
Sanet	Thanet
Forbidden Tattoos	Love at First Sting
Sumter County (South Carolina)	Sumter County, South Carolina
Baibain (character)	Baybayin
Aoiku Shizuoka	Syros
Magic (Cars song)	Magic (The Cars song)
Wat Ive Dunn	What I've Done
David Hume	David Hume
Elvis Presley	Elvis Presley
Epirus	Epirus (region)
California Institute of Technology	California Institute of Technology
President of Malta	President of Malta
Juneau County (Wisconsin)	Juneau County, Wisconsin
Colin (Racehorse)	Colin (horse)
Franklin County (New York State)	Franklin County, New York
Franklin County (Ohio)	Franklin County, Ohio
Nevada	Nevada
SSC Naples	S.S.C. Napoli
Russian Soviet Union Socialist Republic	Russian Soviet Federative Socialist Republic
Ecstasy Records	Extasy Records
Rheinpark Stadion	Rheinpark Stadion
House of Representatives	God Gave Rock and Roll to You
Edward VII (King of England)	Edward VII
The 42nd Long Stay	Expedition 42
Circinus	Ashanti (singer)
Philadelphia County (Pennsylvania)	Philadelphia County, Pennsylvania
British Indian Empire	British Raj
UFC on Foxv	Nevada County, California
Franco Zeffirelli	Franco Zeffirelli
MOON (Kumi Koda's single)	Moon (EP)
Ruan Chao	Nguyễn dynasty
Israeli Labor Party	Pharrell Williams
Kuwait	Kuwait
Bear County (Texas)	Bexar County, Texas
James Donald Cameron	J. Donald Cameron
Egret	Egret
Helsingland	Hälsingland
Nintendo DS Lite	Nintendo DS Lite
Torrioni	SpaceX CRS-6
Madonna (singer)	Madonna (entertainer)
Crown Prince Naruhito and Princess Masako	Masako, Crown Princess of Japan
Tulsi	Tursi
Magnolia grandiflora	University of Navarra
John Deacon	John Deacon
Croatia	Croatia
Maria de las Mercedes de Borbone - dos Sicilias	Princess María de las Mercedes of Bourbon-Two Sicilies
Wilkes County (North Carolina)	Wilkes County, North Carolina
Anzenchitai (Rock band)	Anzen Chitai
Kesennuma City	Kesennuma
Carrollton (Texas)	Carrollton, Texas
John Wingate Weeks ( Secretary of War)	John W. Weeks
Jeju United FC	Jeju United FC
Sampson County (North Carolina)	Sampson County, North Carolina
Dilma Rousseff	Bad (album)
Daviess County Missouri	Kaz Hayashi
DRAIN AWAY	Drain Away
Issakena County (Mississippi)	Issaquena County, Mississippi
UGK	UGK
Liberty County (Montana)	Liberty County, Montana
Singapore	Singapore
Province of Reggio Emilia	Province of Reggio Emilia
Claude Raymond Wickard	Claude R. Wickard
grime	Grime music
Queen Mathilde of Belgium	French Community of Belgium
Fairyland (Ayumi Hamasaki's song)	Fairyland (Ayumi Hamasaki song)
Adrian Erlandson	Adrian Erlandsson
Limburg (Netherlands)	Limburg (Netherlands)
Estudiantes	Estudiantes de La Plata
Voyvod (band)	Voivod (band)
Mother Love Bone	Mother Love Bone
Kingdom	Kingdome
All the Way A Decade of Song	Hood County, Texas
Zhangjiakou	Zhangjiakou
Excuse Maybe	Iiwake Maybe
Coahuila	Coahuila
Marquis de Sade	Marquis de Sade
Ghazni	Ghazni Province
Boston Lincolnshire	Lanier County, Georgia
Prince George's County (Maryland)	Prince George's County, Maryland
Assyrian Modern Aramaic	Assyrian Neo-Aramaic
Alain Badiou	Alain Badiou
Dan Quayle	Dan Quayle
Europe (Band)	Europe (band)
John Smith ( Labour Leader)	John Smith (Labour Party leader)
Matt Sorum	Matt Sorum
University of Washington (St. Louis)	Washington University in St. Louis
Womanizer	Womanizer (song)
Glassnote Records	Glassnote Records
Hancock County (West Virginia)	Hancock County, West Virginia
Thomas Vikstrom	Thomas Vikström
Great American Ball Park	Great American Ball Park
Zwan	Zwan
Valencia CF	Valencia CF
FC Slovan Liberec	FC Slovan Liberec
Namegata City	Namegata, Ibaraki
hash (album)	Shades of Deep Purple
Kitto Daijōbu	Jacques Chaban-Delmas
Taylor County (Texas)	Taylor County, Texas
Tomei Expressway	Tōmei Expressway
Buffalo Bisons	Buffalo Bisons
Kantarou Suzuki	Kantarō Suzuki
Expedition 23	Monroe County, Ohio
Volga River	Volga River
Wu Denyih	Aosta Valley
George Ariyoshi	George Ariyoshi
Franz I (Holy Roman Emperor)	Francis I, Holy Roman Emperor
Kiss your generation	Anata no Sedai e Kuchizuke o
Hugo Chavez	Hugo Chávez
Carl von Linnaeus	Carl Linnaeus
Warren Christopher	Warren Christopher
Pillow of Winds	A Pillow of Winds
Tendo City	Tendō, Yamagata
Jeffrey Williams	Jeffrey Williams (astronaut)
Evenki	Evenki language
Ultravox	Ultravox
Domino Records	Domino Recording Company
Princess Thyra of Denmark	Waiting (Green Day song)
Gutter Twins	The Gutter Twins
Iris Murdoch	Iris Murdoch
Simeon Willis	Simeon S. Willis
IPhone 4	IPhone 4
AKS	AKS (company)
Battle of Pea Ridge	Battle of Pea Ridge
Fukuchiyama City	Fukuchiyama, Kyoto
Kalmyk	Kalmyk Oirat
Hinsdale County (Colorado)	Hinsdale County, Colorado
Parliament of Catalonia	Parliament of Catalonia
Moriya City	Moriya, Ibaraki
Torre de Passeri	Torre de' Passeri
George Colliers	George Kollias (drummer)
Aomori City	Aomori, Aomori
Duchane County (Utah)	Duchesne County, Utah
Appomattox Campaign	Appomattox Campaign
Rarotongan	Cook Islands Māori
David Lee Roth	David Lee Roth
Sign (FLOW song)	Sign (Flow song)
Paolo Barilla	Paolo Barilla
Fox Engine	Fox Engine
ram (album)	Ram (album)
Free Software Foundation	Free Software Foundation
Soyuz T-11	Soyuz T-11
SC Internacional	Sport Club Internacional
Yonezo Maeda	Yonezō Maeda
Susumu Hirasawa	Susumu Hirasawa
You're my sunshine	You're My Sunshine
Lionel de Rothschild	Lionel de Rothschild
Sofia (Queen of Spain)	Queen Sofía of Spain
Federal Chancellor (Austria)	Chancellor of Austria
Nashville Skyline	Nashville Skyline
Hole	Roque Júnior
Griffith Stadium	Griffith Stadium
Lawrence Hyde ( 1st Earl of Rochester)	Laurence Hyde, 1st Earl of Rochester
Florence and the Machine	Florence and the Machine
Two Spica	Twin Spica
Republic of Khakassia	Khakassia
Peter Hook	Peter Hook
John Rutledge	John Rutledge
James Wilson ( Secretary of Agriculture)	James Wilson (Secretary of Agriculture)
Montenegro	Montenegro
Central Federal District	Central Federal District
Frederica of Hanover	Kinpachi
Tom Morello	Tom Morello
San Juan County (Washington)	San Juan County, Washington
Harrison Schmidt	Harrison Schmitt
Ubuntu	Ubuntu (operating system)
Man in the Mirror	Man in the Mirror
Anne (Princess of England)	Anne, Princess Royal
Fulton County (New York State)	Fulton County, New York
Christmas Island (Australia)	Christmas Island
Sea Bird	Sea Bird
X Factor (TV show)	The X Factor (UK TV series)
President of Latvia	President of Latvia
IFA Premiership	NIFL Premiership
All By Myself	All by Myself
Eredivisie	Eredivisie
Iowa State University	Iowa State University
Friday Party	Friday Party
Edward Law 1st Earl of Ellenborough	The CW
Blue (Vocal Group)	Blue (English band)
Williams FW28	Williams FW28
United Left (Spain)	United Left (Spain)
Dumb Yankees	Damn Yankees (band)
Marathon County (Wisconsin)	Marathon County, Wisconsin
Wonhee Cho	Cho Won-hee
Prince Richard Duke of Gloucester	The Hollies
Anata no Sedai e Kuchizuke o	Akira Taue
Frank Murkowski	Frank Murkowski
Ventforet Kofu	Ventforet Kofu
5th Corps (North Army)	V Corps (Union Army)
Coverdale Page	Coverdale•Page
Darth Vader	Darth Vader
Tomiko Ban	Tomiko Van
Progressive Conservative Party of Canada	Progressive Conservative Party of Canada
Masato Yamazaki	Masato Yamazaki (footballer, born 1981)
Kita Tokyo	Gold Coast (British colony)
Gaelic	Goidelic languages
Johannes I (Pope)	Pope John I
Andrei Kozyrev	Andrei Kozyrev
Saguache County Colorado	Khanty language
John Turner	John Turner
Warning (song)	Warning (Green Day song)
The 40th Long Stay	Expedition 40
Sabah al - Salim Stadium	Sabah Al Salem Stadium
Antalyaspor	Antalyaspor
BoB	B.o.B
Navarre	Albert W. Tucker
Tom Traverts Bruce	Tom Traubert's Blues
Erbil SC	Erbil SC
Peter Carington 6th Baron Carrington	Blandford (horse)
Shigeko Higashikuni	Shigeko Higashikuni
Cacak	Čačak
Bihari	Bihari languages
Maibara Shiga	Mary Todd Lincoln
Charlie and the Chocolate Factory	Charlie and the Chocolate Factory (film)
Wilhelm Marx	Wilhelm Marx
Kagoshima United FC	Kagoshima United FC
Macon County (Tennessee)	Macon County, Tennessee
Akaishi Mountains	Akaishi Mountains
West Frisian	West Frisian language
Afars	Afar people
Thomas Mifflin	Thomas Mifflin
Orin Hatch	Orrin Hatch
Franklin County (Kansas)	Franklin County, Kansas
yuan (dynasty)	Yuan dynasty
Japanese	Japonic languages
Rutherford Hayes	Rutherford B. Hayes
campionato Paulista	Campeonato Paulista
Maersk	Marske (horse)
JJ rate	JJ Lehto
A Coruña Province	Province of A Coruña
Scotland	Scotland
Takashi Hara	Hara Takashi
Odakyu Odawara Line	Odakyū Odawara Line
Duane Allman	Duane Allman
A song for you ( album)	A Song for You (The Carpenters album)
Pyotr Kropotkin	Peter Kropotkin
Washington County (Maryland)	Washington County, Maryland
RSC Anderlecht	R.S.C. Anderlecht
Mughal Empire	Mughal Empire
Master Castle	Mastercastle
Seewoosagar Ramgoolam	Seewoosagur Ramgoolam
Caraveras County (California)	Calaveras County, California
Edward Hawke	Edward Hawke, 1st Baron Hawke
Northern Premier Football League	Northern Premier League
Taito Ward	Taitō
KataomoiFinally	Kataomoi Finally
Kirk Hammett	Kirk Hammett
Deja Vu ( album)	Déjà Vu (Crosby, Stills, Nash & Young album)
Cruzeiro EC	Cruzeiro Esporte Clube
Junichiro Koizumi	Junichirō Koizumi
George Campbell 6th Duke of Argyll	French Parliament
Washington County (Louisiana)	Washington Parish, Louisiana
Kiseki No1	Summonte
Mick Taylor	Mick Taylor
Aoi Ward	Aoi-ku, Shizuoka
Campeonato Brasileiro Serie D	Campeonato Brasileiro Série D
Turkmen	Turkmen language
George Bancroft ( Historian)	George Bancroft
Oconee County (Georgia)	Oconee County, Georgia
Elvis Costello	Elvis Costello
Ethiopian Empire	Ethiopian Empire
Andrew WK	Andrew W.K.
Dodridge County (West Virginia)	Doddridge County, West Virginia
Andre 3000	André 3000
Umberto Bossi	Umberto Bossi
Tasuke Nakamura (Soccer player)	Taisuke Nakamura
Pocahontas (Racehorse)	Pocahontas (horse)
I Bet You Look Good on the Dance Floor	I Bet You Look Good on the Dancefloor
Paravita	Parabita
Linn County Kansas	LeSports Center
Electric Boy	Electric Boy
Lebanese Premier League	Lebanese Premier League
Guadalupe County (Texas)	Guadalupe County, Texas
Josep Guardiola	Pep Guardiola
Republic of Genoa	Republic of Genoa
South Holland	South Holland
The Battle of Evermore	Charles Montagu-Scott, 4th Duke of Buccleuch
Jumping	Jumping (Kara song)
Al Wahdat Club	Al-Wehdat SC
German Socialist Unity Party	Socialist Unity Party of Germany
Thai	Thai language
Papa Roach	Papa Roach
Simtech S941	Simtek S941
Kingdom of Greece	Kingdom of Greece
Roberts County (South Dakota)	Roberts County, South Dakota
Henry Phipps 1st Earl of Mulgrave	San Pancrazio Salentino
Cambodia	Cambodia
Time Limit	For You (Utada Hikaru song)
Gwangju Songjeong Station	Gwangju Songjeong Station
Luis Guillermo Solis	Luis Guillermo Solís
Southampton	Southampton
STS-120	STS-120
Principality of Cieszyn	Duchy of Teschen
Aranian	Aranese dialect
Rogues on Main Street	Exile on Main St
Battle of Berlin	Battle of Berlin
UEFA EURO 2016 Qualifying Group H	UEFA Euro 2016 qualifying Group H
Desperate Housewives	Desperate Housewives
Prime Minister of South Korea	IPod Touch
Braxton Bragg	Braxton Bragg
Amway Center	Amway Center
Reggaeton	Reggaeton
One of Us Must Know	Deicide (band)
Golden Corda	La Corda d'Oro
Marshall Jewell	Marshall Jewell
Bib County (Alabama)	Bibb County, Alabama
White Riot (album)	The Clash (album)
Lake St. Clair (North America)	Lake St. Clair
Sauber C17	Sauber C17
Vaucluse	Vaucluse
Madison County (Tennessee)	Madison County, Tennessee
Rose Bowl (Stadium)	Rose Bowl (stadium)
Samuel Eilenberg	Samuel Eilenberg
Alexander Stubb	Alexander Stubb
Love the island	Love the Island
Gila County (Arizona)	Gila County, Arizona
Granville County (North Carolina)	Granville County, North Carolina
HJK Helsinki	Helsingin Jalkapalloklubi
George Monck 1st Duke of Albemarle	Ami Selection
Hirum Johnson	Hiram Johnson
Yoshiyuki Suzuki	Zenkō Suzuki
Clifton Reginald Wharton ( Junior)	Clifton R. Wharton, Jr.
Jesus (band)	Yes (band)
Premier of the Republic of China	People's Liberation Army
Amantea	Amantea
Italian Communist Party	Italian Communist Party
Jefferson County (Wisconsin)	Jefferson County, Wisconsin
King's Best	King's Best
firehouse	FireHouse (band)
Wort County (West Virginia)	Wirt County, West Virginia
Uncontrolled	Uncontrolled (album)
United New Democratic Party	United New Democratic Party
The Raconteurs	The Raconteurs
Hussein I	Hussein of Jordan
Möngke Khan	Santos FC
SpaceX CRS-3	SpaceX CRS-3
Expedition 38	Steve Marriott
Richmond (Rhode Island)	Richmond, Rhode Island
TELL ME (hide's song)	Tell Me (hide song)
Fujieda MYFC	Fujieda MYFC
Grateful Dead	Grateful Dead
Penza Region	Penza Oblast
Richard III (King of England)	Richard III of England
spiral (Koji Suzuki's novel)	Spiral (Suzuki novel)
Federal Republic of the Netherlands	Dutch Republic
Edward Thomas Schaefer	Ed Schafer
Swiss Social Democratic Party	Social Democratic Party of Switzerland
Troyes AC	Troyes AC
Maki Yamamoto	Masaki Yamamoto
Victoria Luise von Prussia	Princess Victoria Louise of Prussia
German Communist Party	Communist Party of Germany
Betty	Beti language
Be the Man	Be the Man
Levi Lincoln Sr.	Levi Lincoln, Sr.
Harrison County (Ohio)	Harrison County, Ohio
Dragonland	Dragonland
Marilyn Quayle	Marilyn Quayle
Beastie Boys	Beastie Boys
Sky News	Sky News
Gosei Sentai Dairanger	Gosei Sentai Dairanger
Kaori Mochida	Kaori Mochida
Weather Report	Weather Report
Bird Catcher	Birdcatcher (horse)
Williams FW11	Williams FW11
Expedition 39	Coast to Coast (Westlife album)
Kazuchika Okada	Kazuchika Okada
breezin	Breezin'
Ron Paul	Ron Paul
David Maxwell Fife ( 1st Earl Kilmuir)	David Maxwell Fyfe, 1st Earl of Kilmuir
Perry County (Arkansas)	Perry County, Arkansas
Frank Rijkaard	Frank Rijkaard
National Defense Academy	National Defense Academy of Japan
John F. Reynolds	John F. Reynolds
Sakai City	Sakai, Osaka
Avernant	Abernant (horse)
Althing	Althing
Ban Ki-moon	Ban Ki-moon
PNC Arena	PNC Arena
Raleigh County (West Virginia)	Raleigh County, West Virginia
Cook County (Illinois)	Cook County, Illinois
Kingdom of Thanjavur Maratha	Thanjavur Maratha kingdom
Tutsi	Tutsi
Michael Howard ( British politician)	Michael Howard
Annette Lu	Gerry Mulligan
Yenisei River	Yenisei River
Czech Social Democratic Party	Czech Social Democratic Party
Nanae Takahashi	Nanae Takahashi
Washington County (Minnesota)	Washington County, Minnesota
Berbers	Berbers
Exciting Wake Me Up	Wake Me Up Before You Go-Go
John Lennon	John Lennon
List of Pokémon (102-151)	List of Pokémon (102–151)
Ciriacco de Mita	Ciriaco De Mita
Melbourne City FC	Melbourne City FC
European Union for Freedom and Democracy	Alliance of Liberals and Democrats for Europe Group
Palatino	Palatine Hill
Cavalera Conspiracy	Cavalera Conspiracy
Fortuna Liga	Slovak Super Liga
Caroline County (Virginia)	Caroline County, Virginia
Andrano	Andrano
Allegany County New York	Woman Is the Nigger of the World
Richland County (Montana)	Richland County, Montana
Edwin T Meredith	Adolf von Baeyer
Ukrainian	Ukrainian language
Richard Montgomery	Richard Montgomery
Jean-Pierre Laffarin	Jean-Pierre Raffarin
Abington Township Montgomery County Pennsylvania	Mada Minu Ashita ni
Gangsta Rap	Gangsta rap
Yvelines	Yvelines
Second Battle of Corinth	Second Battle of Corinth
North Brabant	North Brabant
house (music)	House music
Davies County (Missouri)	Daviess County, Missouri
Frederick Engle	Frederick K. Engle
Michel Foucault	Michel Foucault
Giovanni Spadolini	Giovanni Spadolini
Magic Christian Music	Magic Christian Music
Roughn Tumble	Sergei Ivanov
Republic of the Congo	Republic of the Congo
Sigismund III	Sigismund III Vasa
The Prince of Winterfell	Olympic Stadium (Moscow)
Estudio Gobernador Magalhães Pinto	Mineirão
Green Desert	Green Desert (horse)
HEART STATION	Chuvashia
Leopold III (King of Belgium)	Leopold III of Belgium
Khuzestan Province	Khuzestan Province
ONE OK ROCK	One Ok Rock
Massive Attack	Massive Attack
HEARTFUL	Heartful
Soccer Bundesliga ( Germany)	Bundesliga
Loco Motion	The Loco-Motion
Love is in the glitter	How Deep Is Your Love (Bee Gees song)
Charles City County (Virginia)	Charles City County, Virginia
Yangon United FC	Yangon United F.C.
House of Saxe-Coburg-Kohari	House of Saxe-Coburg-Gotha-Koháry
Province of Siena	Province of Siena
Shoegazing	Shoegazing
TAKURO	Takuro (musician)
Bob Dole	Bob Dole
President of Pakistan	President of Pakistan
Alphonso Taft	Alphonso Taft
Bicycle Race	Bicycle Race
Michael Schumacher	Michael Schumacher
DeSoto County (Florida)	DeSoto County, Florida
Avengers (2012 movie)	The Avengers (2012 film)
Keep Your Head Down	Keep Your Head Down
Scott Parker	Scott Parker
Yuri	Lilium
Charles Anderson Wickliffe	Charles A. Wickliffe
Toronto FC	Toronto FC
Rattle and Hum	George V
Baghlan Province	Baghlan Province
Pigeonhead	Pigeonhed
Saarepol	Sar-e Pol Province
Chung Ilkwon	Georgia Dome
Michael I of Romania	Do the Motion
Petr Nechas	Petr Nečas
List of heads of state of Gabon	Princequillo
My Baboo	My Babu
Tribhuvan Bir Bikram Shaha	Tribhuvan of Nepal
John Nelson ( Attorney General)	John Nelson (lawyer)
Thriller (album)	Thriller (Michael Jackson album)
Nambaline Enkhbayar	Nambaryn Enkhbayar
Lee Chun-Su	Lee Chun-soo
William Cavendish - Bentinck ( 3rd Duke of Portland)	William Cavendish-Bentinck, 3rd Duke of Portland
Battle of Kennesaw Mountain	Battle of Kennesaw Mountain
Columbus (Ohio)	Columbus, Ohio
Joichi Ito	Joi Ito
Maldives National Stadiumv	Northern Ryukyuan languages
Test Valley	Test Valley
Space Shuttle	Space Shuttle
Keeper of the Seven Keys	National Liberal Party (Romania)
Upper Darby Township Delaware County Pennsylvania	Abdullah bin Khalifa Stadium
John Paul Jones ( musician)	John Paul Jones (musician)
Giovanni Silva the Oliveira	Giovanni Silva de Oliveira
Walton County (Georgia)	Walton County, Georgia
Gallant Fox	Gallant Fox
Samaritan	Samaritan alphabet
Canon Eagles	Canon Eagles
Mecca	Mecca
Liechtenstein	Liechtenstein
Grand County Utah	Martin Van Buren
Baldric	Otto von Bismarck
Children of Bodom	Children of Bodom
Estonian Cup	Estonian Cup
Mac OS X Snow Leopard	King's College, Cambridge
Philippine Commonwealth	Commonwealth of the Philippines
Pedro Enrique de Orleans y Braganza	Prince Pedro Henrique of Orléans-Braganza
Gilliger Prasad Koirala	Girija Prasad Koirala
Velvet Revolver	Velvet Revolver
Sony Computer Entertainment	Sony Computer Entertainment
Republic of Macedonia	Republic of Macedonia
PlayStation Mobile	PlayStation Mobile
Vytautas Landsbergis	Vytautas Landsbergis
Margaret Rea Seddon	Margaret Rhea Seddon
Sanders County Montana	INDYCAR
Terry Funk	Terry Funk
Easy Gore	Easy Goer
Dennis Cheryshev	Denis Cheryshev
Takaaki Kato	Katō Takaaki
Garicchio	Gallicchio
Scissor Sisters	Scissor Sisters
Neapolitan	Neapolitan language
Ruby	Ruby (programming language)
Henry Fitzalan - Howard ( 14th Duke of Norfolk)	Henry Fitzalan-Howard, 14th Duke of Norfolk
Arnold Rüütel	Djibouti
Nissan Motor	Nissan
John H. Clifford	John H. Clifford
C Douglas Dillon	The Rain Song
Oman national football team	Oman national football team
Joe Strummer	Joe Strummer
IndyCar Series	IndyCar Series
Alfonso de Borbone - dos Sicilias	Infante Alfonso, Duke of Calabria
Constitutional Kingdom of France	Kingdom of France (1791–92)
Korogaru Iwa Kimi ni Asa ga Furu	Madison County, Florida
MY HEART DRAWS A DREAM	My Heart Draws a Dream
Fukushima City	Fukushima, Fukushima
Asturias	Asturias
Cumberland County (Maine)	Cumberland County, Maine
The Troubles	Bhojpuri language
Deutsche Tourenwagen Meisterschaft	National Oceanic and Atmospheric Administration
Charles Spencer-Churchill 9th Duke of Marlborough	Fukui, Fukui
Portuguese	Portuguese people
Didier Burkarte	Didier Burkhalter
Luba	Luba-Kasai language
(I Like) The Way You Love Me	(I Like) The Way You Love Me
BEGIN (band)	Begin (band)
San Chirico Rapallo	San Chirico Raparo
Stellan Skarsgård	Stellan Skarsgård
Once Upon a Time ( TV drama)	Once Upon a Time (TV series)
Friedrich Ebert ( son)	Friedrich Ebert, Jr.
Bosnian	Bosnian language
Urban VIII (Pope)	Pope Urban VIII
Union between Sweden and Norway	San Francisco Bay Area
Whatcom County (Washington State)	Whatcom County, Washington
Sharmukhi character	Shahmukhi alphabet
Spanish Civil War	Spanish Civil War
William Cavendish 2nd Duke of Devonshire	Tom Jones (singer)
Saint Pierre and Miquelon	Saint Pierre and Miquelon
Lev Kamenev	Lev Kamenev
Huang Xin Tong	Huang Xintong
Serbian	Serbian language
President of Ukraine	President of Ukraine
venlo	Venlo
Rikichi Ando	Rikichi Andō
Point Coupe County (Louisiana)	Pointe Coupee Parish, Louisiana
Roger Taylor	Roger Taylor (Queen drummer)
Rain of Torture	Ryōjoku no Ame
Glorious Song	Glorious Song
West Australian (Racehorse)	West Australian (horse)
Alamakee County (Iowa)	Allamakee County, Iowa
Sporti Recife	Sport Club do Recife
Taiwan Electric Power Football Team	Taiwan Power Company F.C.
Shigenori Togo	Shigenori Tōgō
Ray Allen	Ray Allen
Astrakhan Oblast	Astrakhan Oblast
Arizona	Arizona
The Beatles are Coming Ya! Ya! Ya! (Song)	A Hard Day's Night (song)
LaLiga	Mars (Gackt album)
Flash Gordon ( album)	Flash Gordon (soundtrack)
Kingdom of Hawaii	Kingdom of Hawaii
Helloyeah	Hellyeah
Fulton County (Illinois)	Fulton County, Illinois
Washington County (Rhode Island)	Washington County, Rhode Island
trip hop	Trip hop
Mikhail Kuznetsov	Mikhail Vladimirovich Kuznetsov
Tears (X JAPAN songs)	Tears (X Japan song)
Terry Chimes	Terry Chimes
Aberdeen	Aberdeen
ASCENDEAD MASTER	Ascendead Master
Hartford County (North Carolina)	Hertford County, North Carolina
Chavalit Yongchaiyut	Chavalit Yongchaiyudh
Germanic	Germanic languages
Yaeyama Islands	Yaeyama Islands
Glen Johnson	Glen Johnson (English footballer)
free (musician)	Flea (musician)
Tsuchiura City	Tsuchiura
Leopold Sedar Senghor	Léopold Sédar Senghor
William Cecil 1st Baron Burghley	I-League
Sapporo Atsubetsu Park Stadium	Sapporo Atsubetsu Park Stadium
George Goschen ( 1st Viscount Goschen)	George Goschen, 1st Viscount Goschen
Life is beautiful (FLOW song)	Life is Beautiful (Flow song)
Joy Division	Joy Division
Homestead Records	Homestead Records
Kisses to Hell	Dressed to Kill (album)
Saad Hariri	Saad Hariri
Choi Sungkuk	Livingston T. Merchant
French Fourth Republic	French Fourth Republic
Whalebone	Whalebone (horse)
Henry James	Henry James
First Niagara Center	First Niagara Center
Umm Salal SC	Umm Salal SC
Otsego County New York	Gyeongbu Line
Teiichi Tanigaki	Sadakazu Tanigaki
roll with it ( album)	Roll with It (album)
Bach no Senritsu o Yoru ni Kiita Sei Desu	Girlfriend (Paul McCartney song)
Hua Guofeng	Hua Guofeng
Gabon	Gabon
Barry Manilow	Barry Manilow
Columbia County (Wisconsin)	Columbia County, Wisconsin
Orgiano	Orgiano
Yancey County (North Carolina)	Yancey County, North Carolina
New Rave	New rave
The Seven Deadly Sins (Manga)	The Seven Deadly Sins (manga)
Civitalparella	Civitaluparella
Morgan County (Missouri)	Morgan County, Missouri
Alexandr Lebezi	Alexander Lebed
Ama Aichi	Linn County, Kansas
Thuringia	Thuringia
Resident Evil Series	Resident Evil
UEFA Europa League	UEFA Europa League
Philip II Arena	Hands (Kumi Koda song)
William S. Taylor	William S. Taylor
Josephus Daniels	Josephus Daniels
Win or Die	You Win or You Die
Elbe River	Elbe
Nagano City	Nagano, Nagano
Manchester United FC	Manchester United F.C.
Guyana	Guyana
Campi Salentina	Campi Salentina
John Woodhouse ( 1st Earl of Kimberley)	John Wodehouse, 1st Earl of Kimberley
Barcays	The Bar-Kays
Royal Charger	Royal Charger
Chikushino City	Chikushino, Fukuoka
Koichiro Gemba	Kōichirō Genba
Tadamori Oshima	Tadamori Oshima
Heart of Midlothian FC	Heart of Midlothian F.C.
Kollupitiya	Kollupitiya
Pierro Sraffa	Piero Sraffa
Georgios II (King of Greece)	George II of Greece
Trincomalee District	Trincomalee District
Skrillex	Skrillex
Ayaka	Ayaka
Say Anything	Say Anything (X Japan song)
Alexandra von Hanover ( 1882-1963)	Princess Alexandra of Hanover (1882–1963)
Azerbaijan	Azerbaijan
I'm Your Angel	I'm Your Angel
The Avengers	Regret (New Order song)
Davie County (North Carolina)	Davie County, North Carolina
Peter Criss	Lewis County, Washington
Long Island	Long Island
Iowa	Iowa
Benjamin Williams Crowninshield	Benjamin Williams Crowninshield
Bay County (Florida)	Bay County, Florida
Melon Memorial Day	Melon Kinenbi
Gangwon FC	Gangwon FC
Heavy Stereo	Heavy Stereo
Grand Theft Auto V	Grand Theft Auto V
Diane Towler	Diane Towler
Peer Svinhew	Pehr Evind Svinhufvud
Apollo 11	Apollo 11
Swayne County (North Carolina)	Swain County, North Carolina
Khmer script	Khmer alphabet
Chester House	Chester House
Barbour County (West Virginia)	Barbour County, West Virginia
OpenVMS	OpenVMS
Initial D	Initial D
Frederick Spencer ( 4th Earl Spencer)	Frederick Spencer, 4th Earl Spencer
WWE	WWE
George Luson - Gore ( 1st Duke of Sutherland)	George Leveson-Gower, 1st Duke of Sutherland
Charles Canning 1st Earl Canning	Disclosure (band)
Alex James	Alex James (musician)
Stade BollaertDelelis	Orhan Pamuk
Nikolay Luzhin	Nikolai Luzin
UFC on Fox	Atascosa County, Texas
Alex Skolnick	Alex Skolnick
Intikhab	Luna Sea
Sawyer County (Wisconsin)	Sawyer County, Wisconsin
EIGHT (Do As Infinity album)	Eight (Do As Infinity album)
Lee Jae-yong	Lee Jae-yong
Sina	Sinitic languages
TO BE	To Be (song)
Buffalo County (South Dakota)	Buffalo County, South Dakota
Rodrigo y Gabriela	Rodrigo y Gabriela
Tricase	Tricase
James Harris ( 3rd Earl of Malmesbury)	James Harris, 3rd Earl of Malmesbury
Shahrada characters	Śāradā script
Booker T. & The MG 's	Booker T. & the M.G.'s
Ikeda City	Ikeda, Osaka
Balkh Province	Balkh Province
New York State	New York
Valkyria Chronicles	Valkyria Chronicles
Albanian Kingdom	Česlovas Juršėnas
Ronnie James Dio	Ronnie James Dio
Viva la Vida or Death and All His Friends	Weimar Republic
Serbia	Serbia
Stanford University	Stanford University
Porsche Carrera Cup	Porsche Carrera Cup
Denmark national football team	Denmark national football team
Tokuo Yamashita	Peter Sloterdijk
Jean-Marc Hérault	Jean-Marc Ayrault
Orban Victor	Viktor Orbán
James Monroe	James Monroe
Coshocton County (Ohio)	Coshocton County, Ohio
Newell's Old Boys	Newell's Old Boys
William J. Hardy	William J. Hardee
Pizzo Ferrato	Pizzoferrato
Passion (Hikaru Utada's song)	Passion (Utada Hikaru song)
Balochie	Balochi language
Noboru Takeshita	Noboru Takeshita
Honam High Speed Railway	Chuan Leekpai
Manx	Manx language
Willis Lamb	Willis Lamb
Keiyo Line	Keiyō Line
Pickens County (Georgia)	Pickens County, Georgia
Qajar	Qajar dynasty
Infinite (Stratovarius album)	Infinite (Stratovarius album)
Essiliga	Esiliiga
Adams County Idaho	Sacramento Kings
The Works ( album)	The Works (Queen album)
The Wonder Girls	The Wondergirls
Saint Petersburg	Saint Petersburg
Dionne Warwick	Dionne Warwick
Anthony Lake	Anthony Lake
Democrats of the Left	McDowell County, North Carolina
Edmund Andros	Edmund Andros
Concho County (Texas)	Concho County, Texas
Uralic	Uralic languages
Georg Luger	Georg Luger
Rice University	Rice University
Crimea	Crimea
World Apartment	World Apart
Kenji Sawada	Kenji Sawada
Jeremy Hunt ( politician)	Jeremy Hunt
Varadka	Jade North
Stephen Stills	Stephen Stills
Greg Phillinganes	Greg Phillinganes
College of William and Mary	College of William & Mary
Yong Jae Lee	Lee Yong-jae
Maria Teresa Grand Duchess of Luxembourg	Lanzhou
Boulder County (Colorado)	Boulder County, Colorado
Veruca Salt	Veruca Salt
Goregrind	Crispiano
Roll with it ( Oasis song)	Roll with It (Oasis song)
Jaco Pastorius	Jaco Pastorius
Rick Mears	Rick Mears
Nobel Prize in Physics	Nobel Prize in Physics
Serbian Orthodox Church	Serbian Orthodox Church
Karl Renner	Karl Renner
Arthur Balfour	Arthur Balfour
Cant Get You Out of My Head	Brantôme (horse)
Richie Sambora	Richie Sambora
Plymouth	Plymouth
Mauritania	Mauritania
Douglas County (Wisconsin)	Douglas County, Wisconsin
Mongolian	Mongolic languages
Cumberland County (New Jersey)	Cumberland County, New Jersey
Portland (Maine)	Portland, Maine
Kim Chi-woo	Kim Chi-woo
Gwen Stefani	Gwen Stefani
Battle of Cerro Gordo	Battle of Cerro Gordo
Republic of Buryatia	Buryatia
Edward Everett	Edward Everett
University of Pittsburgh	University of Pittsburgh
Hale County (Alabama)	Hale County, Alabama
Battle of Okinawa	Battle of Okinawa
Challedon	Socialist Autonomous Province of Kosovo
Emil Haha	Emil Hácha
San Joaquin County (California)	San Joaquin County, California
Paul Dirac	Paul Dirac
Helmont	Helmond
List of Presidents of Costa Rica	List of Presidents of Costa Rica
United Arab Emirates national football team	Oku Yasukata
Traveling Wilburys	Traveling Wilburys
Shizuoka City	Shizuoka, Shizuoka
Quenya	Quenya
MGM Records	MGM Records
Circuit de la Sarthe	Eternally (Utada Hikaru song)
Sassari	Sassari
STS-89	STS-89
Bundesrat of Germany	Jungang Line
Cuba	Cuba
Nina Mosel	Nina Mozer
press (song)	Press (song)
Takahiro Yokomichi	Takahiro Yokomichi
Logan County (Illinois)	Logan County, Illinois
Myron Scholes	Myron Scholes
Alexander Dallas ( Politician)	Alexander J. Dallas (statesman)
Puppis	Steamboat Willie
Northern Rhodesia	Northern Rhodesia
Belize	Belize
CAPSULE	Capsule (band)
East Java	East Java
Joel Roberts Poinsett	Joel Roberts Poinsett
Marlon Dickerson ( New Jersey politician)	Mahlon Dickerson
Hindoo	Nagara River
Franklin County (North Carolina)	Franklin County, North Carolina
Norwich City FC	Norwich City F.C.
Dynaformer	Dynaformer
Natsu no Yuuutsu	Sporting Clube de Portugal
Felix Guattari	Félix Guattari
Cygnus CRS OA-4	Cygnus CRS OA-4
Tom Daschle	Tom Daschle
Montenerodomo	Wolverhampton Wanderers F.C.
Foo Fighters	Foo Fighters
Eiffel	Eiffel (programming language)
LOVE IS THE MESSAGE	Love Is the Message
Udmurt	Udmurt language
Orlando	Orlando, Florida
Augustus Stanley	Augustus Owsley Stanley
Touch and Go Records	Touch and Go Records
Guam	Guam
Seattle Sounders FC	Seattle Sounders FC
Michael Foale	Cheltenham
Val de Loir	Expedition 44
Battle of Chapultepec	Battle of Chapultepec
Dirty Pretty Things	Dirty Pretty Things (band)
Belarusian language	Theodore G. Bilbo
Sunday Silence	Sunday Silence
Robert Jenkinson ( 2nd Earl of Liverpool)	Robert Jenkinson, 2nd Earl of Liverpool
Stadion Crvena Zvezda	Marakana Stadium
Francis (Pope)	Pope Francis
Borussia Dortmund	Borussia Dortmund
The Runaways	The Runaways
California	California
Heal the World	Heal the World
Guiyang	Guiyang
UEFA Champions League	UEFA Champions League
Gilmer County (West Virginia)	Gilmer County, West Virginia
Norodom Ranaridit	Norodom Ranariddh
Ciao	Nottingham
Micronesian Languages	Micronesian languages
Gainsborough (Racehorse)	Gainsborough (horse)
Japan-Soviet Border Dispute	Soviet–Japanese border conflicts
Hans Adam II	Hans-Adam II, Prince of Liechtenstein
Patriarchate of Constantinople	Ecumenical Patriarchate of Constantinople
Happy End	Happy End (band)
Tokyo Station	Tokyo Station
Scratch Acid	Scratch Acid
Eagle Eye Cherry	Eagle-Eye Cherry
Estadio Monumental Isidro Romero Calvo	Estadio Monumental Isidro Romero Carbo
FA Trophy	FA Trophy
Color Change!	Color Change!
Surrey (England)	Surrey
Patrick Leahy	Patrick Leahy
Tyler the Creator	Tyler, The Creator
General Electric	General Electric
Livetune	Livetune
Club Universidad Nacional	Club Universidad Nacional
Damon Albarn	Damon Albarn
Taunton	Taunton
Lowndes County (Alabama)	Lowndes County, Alabama
Todd Giles	Todd Gilles
Alfred Tarski	Alfred Tarski
Clay County (Minnesota)	Clay County, Minnesota
Wiltshire	Wiltshire
Indian Ocean raid	Altai Krai
Guy Aslin	Gai Assulin
Matta Louise ( Princess of Norway)	Princess Märtha Louise of Norway
Interstate 90	Interstate 90
Battle of Big Bethel	Battle of Big Bethel
Nagoya City Minato Soccer Stadium	Nagoya City Minato Soccer Stadium
Mario Monti	Mario Monti
William Shakespeare	William Shakespeare
Gaza	Pictor
Tipper Gore	Tipper Gore
Bret Anderson	Brett Anderson
Halkis	Chalcis
Pafnuti Chebyshev	Pafnuty Chebyshev
Hermit	Hermit (horse)
Seoul Station	Seoul Station
Isaac Hayes	Isaac Hayes
Felix Grandi	Felix Grundy
Battle of Mexico City	Battle for Mexico City
Black Tire Affair	Black Tie Affair
Faulkner County Arkansas	Mayumi Moriyama
Billy Joel	Billy Joel
Persian	Persian language
Kenosha County (Wisconsin)	Kenosha County, Wisconsin
SECOND STORY	Second Story
Ivo Sanader	Ivo Sanader
Pangasinan	Pangasinan
Shiritsu Ebisu Chugaku	Mercer County, Missouri
Nataluma	Natalma
Noor	Noor (horse)
Atoms for Peace	Atoms for Peace (band)
Outrage (2010 movie)	Outrage (2010 film)
Masa Saito	Masa Saito
Kepler (Probe)	Kepler (spacecraft)
Kuwait Premier League	Kuwaiti Premier League
Tommy Boy Records	Tommy Boy Records
Russian Ruble	Russian ruble
Hannah Arendt	Hannah Arendt
Hungary	Hungary
Andy Priaulx	Andy Priaulx
Toronto Blue Jays	Toronto Blue Jays
European Left Party	Party of the European Left
Warren County Missouri	Feeling Your UFO
Nintendo DSi	Nintendo DSi
Telugu characters	Telugu script
Ann Wilson	Ann Wilson
Jeffrey Amherst	Jeffery Amherst, 1st Baron Amherst
Don't shoot the pianist!	Don't Shoot Me I'm Only the Piano Player
Dalian One Football Club	Dalian Yifang F.C.
No Alam Shah	Noh Alam Shah
John Coates	John H. Coates
Abner Doubleday	Abner Doubleday
Webster County (Missouri)	Webster County, Missouri
Nathan Clifford	Nathan Clifford
Google+	Google+
Shinji Kobayashi	Shinji Kobayashi
Dikarb County (Tennessee)	DeKalb County, Tennessee
Sasebo City	Sasebo, Nagasaki
Mumtaz Mahal	Mumtaz Mahal
Alamance County (North Carolina)	Alamance County, North Carolina
Frederick Willem de Klerk	F. W. de Klerk
Stipe Preticosa	Stipe Pletikosa
Prince Gustaf Adolf Duke of Västerbotten	Joxe Azurmendi
Love across the ocean	Love Across the Ocean
Henry County (Illinois)	Henry County, Illinois
FC Zenit St. Petersburg	FC Zenit Saint Petersburg
Second Lady	Second Lady of the United States
Montgomery County (Missouri)	Montgomery County, Missouri
Aomori Aomori	Rock 'n' Roll Circus
Koji Yamase	Koji Yamase
Scorpio	Scorpius
Low Saxon	West Low German
Georgy Grechko	Georgy Grechko
Samuel Adams	Samuel Adams
Michael Ökerfeldt	Mikael Åkerfeldt
Arabian Gulf League	UAE Arabian Gulf League
Jeff Walker	Jeffrey Walker
Stefano Caruso	Stefano Caruso
Robbie Krieger	Robby Krieger
Kim Deal	Kim Deal
Arthur Miller	Arthur Miller
New York City Transit Authority	New York City Transit Authority
Robert Caldwell Wood	Robert Coldwell Wood
Marc Valiente	Marc Valiente
Hadoken !	Hadouken!
Rasymbanza	Pyxis
Super WONDERFUL!6	Chō Wonderful! 6
Shinzo Oya	Shinzō Ōya
Diana (Princess of Wales)	Diana, Princess of Wales
Mountain View	Mountain View, California
Tazewell County (Virginia)	Tazewell County, Virginia
Let's embrace love	We Can Work It Out
Indiana	Indiana
JavaScript	JavaScript
Laugartalsverl	Laugardalsvöllur
Vitoria Guimaraes	Vitória S.C.
Associação Atlética Ponte Preta	Earl Van Dorn
Mitsuharu Misawa	Mitsuharu Misawa
Fujieda City	Fujieda, Shizuoka
Calhoun County (Illinois)	Calhoun County, Illinois
One of These Days	Harrison County, Iowa
Traktur Saazi FC	Tractor Sazi F.C.
Nobuo Uematsu	Nobuo Uematsu
Trapeze	Trapeze (band)
John Crittenden	John J. Crittenden
Lake County Illinois	Herman Van Rompuy
Boston (England)	Boston, Lincolnshire
iPhone	IPhone
Botafogo FC (State of Sao Paulo)	Botafogo Futebol Clube (SP)
Bay of Bengal	Bay of Bengal
far away (Do As Infinity song)	Tōku Made
Stockholm county	Stockholm County
Peter III	Peter III of Russia
Roberto Adjara	Roberto Ayala
Muhammad Morsi	Mohamed Morsi
Smerian Records	Sumerian Records
Andorra	Andorra
Sun God (album)	All 'n All
LOST (1st season)	Lost (season 1)
Belarusian	Belarusian language
Perfect Kiss	The Perfect Kiss
GovernorGeneral of Australia	Leonid Kuchma
Blelim Jemaili	Blerim Džemaili
Alexander Wurz	Alexander Wurz
How To Dismantle An Atomic Bomb	How to Dismantle an Atomic Bomb
DAYS (FLOW song)	Days (Flow song)
Daniel Butterfield	Daniel Butterfield
Derbi	İlhan Mansız
Kouta Morimura	Kota Morimura
Masatoshi Mashima	Masatoshi Mashima
1st SS Panzer Division Leibstandarte SS Adolf Hitler	Roanoke County, Virginia
George Villiers ( 4th Earl of Clarendon)	George Villiers, 4th Earl of Clarendon
Pierluigi Bersani	Pier Luigi Bersani
Heracles Almelo	Elena of Montenegro
Ascoli Picchio FC 1898	Ascoli Picchio F.C. 1898
Namie Amuro	Namie Amuro
Apollo 17	Apollo 17
UFC 80	UFC 80
Lim Thong Hai	Lim Tong Hai
UFC 110	UFC 110
David Lloyd Johnston	David Johnston
Cass County (Michigan)	Cass County, Michigan
Constantinos II (King of Greece)	Constantine II of Greece
King Hatohiko Asaka	Prince Yasuhiko Asaka
Michèle AlliotMarie	Institute for Advanced Study
Ringo Starr	Ringo Starr
HOURGLASS	Hourglass (Fayray album)
Forrest County (Mississippi)	Forrest County, Mississippi
Stuart Pierce	Stuart Pearce
State of Sao Paulo	São Paulo (state)
John Young ( Astronaut)	John Young (astronaut)
Lafayette County (Arkansas)	Lafayette County, Arkansas
Lynchburg Hillcats	Lynchburg Hillcats
Arnaldo Forlani	Arnaldo Forlani
Konoe Chuteru	Tadateru Konoe
Nagoya Grampus Eight	Nagoya Grampus
Santana (band)	Santana (band)
Ninian Steven	Ninian Stephen
Democratic Party (Serbia)	Democratic Party (Serbia)
Peter Debye	Peter Debye
Swedish American	Swedish Americans
Tokyo Verdy 1969	Tokyo Verdy
Social Democratic Party (Japan 1996-)	Social Democratic Party (Japan)
Rasmus Lindgren	Rasmus Lindgren
Jamvin Batmunkh	Jambyn Batmönkh
Charles Stone	Charles Pomeroy Stone
Secret (Kumi Koda's Album)	Secret (Kumi Koda album)
Oghuz languages	Oghuz languages
Battle of Chickamauga	Battle of Chickamauga
Trần dynasty	Burning Rain
Jahangir	Jahangir
Soyuz TMA-5	Soyuz TMA-5
Henry Clay	Henry Clay
Charles Spencer ( 3rd Earl of Sunderland)	Charles Spencer, 3rd Earl of Sunderland
RC Strasbourg	RC Strasbourg Alsace
Valentina Matvienko	Valentina Matviyenko
MERMAID	Mermaid
Insular Celtic	Insular Celtic languages
Japan BS Broadcasting	Nippon BS Broadcasting
John Kerry	John Kerry
Mongolia	Mongolia
Its a Hard Life	Greek language
Badakhshan Province	Badakhshan Province
Polynesian (Racehorse)	Polynesian (horse)
Malcolm Fraser	Malcolm Fraser
Jesus Lizard	The Jesus Lizard
Angelika Kurilova	Anjelika Krylova
Miss A	Miss A
Joao Vieira	João Bernardo Vieira
Brentford FC	Brentford F.C.
Stormbird	Storm Bird
Hawaii	Hawaii
Benjamin Netanyahu	Benjamin Netanyahu
Emperor Taisho	Emperor Taishō
Stadion Maksimir	Stadion Maksimir
RAZZLE DAZZLE	Razzle Dazzle (album)
North East England	North East England
Daria Grybauskaite	Dalia Grybauskaitė
Inuktitut	Inuktitut
Mitt Romney	Mitt Romney
Cameroon	Cameroon
Baltimore	Baltimore
Meles Zenawi	Meles Zenawi
Peloponnese	Peloponnese (region)
Finnic languages	One Vision
Expo 2012	Hershel W. Gober
Northwestern Federal District	Northwestern Federal District
Borrowed Time	Cliff Richard
The Siren	The Siren (song)
Lorne County (West Virginia)	Roane County, West Virginia
Al Di Meola	Al Di Meola
Cape Colony	Cape Colony
Francis Osborne 5th Duke of Leeds	Afar language
Battle of Appomattox Court House	Battle of Appomattox Court House
Jiang Zemin	Jiang Zemin
Durham	Durham, England
Pender County (North Carolina)	Pender County, North Carolina
Tommy airline	Tommy Airline
Grand County (Colorado)	Grand County, Colorado
Ministry of Education, Culture, Sports, Science and Technology	Ministry of Education, Culture, Sports, Science and Technology
Soyuz 36	Soyuz 36
WTA Tour Championship	WTA Tour Championships
1.FC Kaiserslautern	1. FC Kaiserslautern
Jefferson County (Alabama)	Jefferson County, Alabama
South Sulawesi	South Sulawesi
Charles Cotesworth Pinckney	Charles Cotesworth Pinckney
Emperor Enyu	Emperor En'yū
Pareo is an emerald	Pareo wa Emerald
Soyuz 37	Soyuz 37
Fukushima Station (Fukushima Prefecture)	Fukushima Station (Fukushima)
Musashino City	Musashino, Tokyo
Aritomo Yamagata	Yamagata Aritomo
Green Day	Green Day
Wang Yang (football player)	Wang Yang (footballer, born 1989)
Vietnam Cup	Vietnamese Cup
Besiktas JK (Basketball)	Beşiktaş J.K. (men's basketball)
Recep Tayyip Erdogan	Recep Tayyip Erdoğan
Ishikari City	Ishikari, Hokkaido
Gabriel Garcia - Marquez	Gabriel García Márquez
Hideo Kodama	Hideo Kodama
Nat King Cole	Nat King Cole
Bloomstick	Broomstick (horse)
Ursula von der Leyen	Ursula von der Leyen
National Party (Spain)	People's Party (Spain)
Stafford County (Virginia)	Stafford County, Virginia
London Gatwick Airport	Gatwick Airport
Amherst University	Amherst College
New England Revolution	New England Revolution
Randy Brecker	Randy Brecker
Vladimir Steklov	Vladimir Steklov
Toshiba	Toshiba
Roxy Music	Roxy Music
Yukio Edano	Yukio Edano
Cellino San Marco	Cellino San Marco
Igor Spyriband	Igor Shpilband
AFC Champions League 2014	2014 AFC Champions League
Anatoly Lukyanov	Anatoly Lukyanov
Nîmes Olympiad	Nîmes Olympique
Golden Crown	A Golden Crown
Seven Days of War	Seven Days Battles
Masanori Sekiya	Masanori Sekiya
Octave Mirbeau	Octave Mirbeau
Chesterfield (England)	Chesterfield
William Pitt ( Small Pitt)	William Pitt the Younger
Chichewa	Chewa language
Pride Camry	Plaid Cymru
Persian Gulf Pro League	Persian Gulf Pro League
Ravi Shankar	Ravi Shankar
Brade Dibatz	Vlade Divac
Tiznow	Tiznow
Chikuhei Nakajima	Chikuhei Nakajima
Paul Feyerabend	Paul Feyerabend
X-Men	X-Men
Never Say Die	Never Say Die (horse)
Ruben Blommert	Ruben Blommaert
Donald Tusk	Donald Tusk
Akihiro Ohta	Akihiro Ota
UFC 38	UFC 38
Kobe City	Kobe
Command (Racehorse)	Commando (horse)
daijuru	Dayjur
Michelle Williams ( singer)	Michelle Williams (singer)
Cyrillic	Cyrillic script
Oier Olazábal Paredes	Oier Olazábal
Benton County (Washington)	Benton County, Washington
Football Association	The Football Association
Wakayama Prefecture	Wakayama Prefecture
Indra Saadhan Daud	Indra Sahdan Daud
Nobuoki Asada	Asada Nobuoki
Carrie Fisher	Carrie Fisher
Johann Wolfgang von Goethe	Johann Wolfgang von Goethe
DEF.DIVA	Def.Diva
David Arquette	David Arquette
John McGeork	John McGeoch
Michel Barnier	Michel Barnier
Inner London	Inner London
Ehime Prefecture	Ehime Prefecture
St.Petersburg (Florida)	St. Petersburg, Florida
Thiene	Thiene
Grace Kelly	Grace Kelly
Gideon Wells	Gideon Welles
Hugh Cairns ( 1st Earl of Cairns)	Hugh Cairns, 1st Earl Cairns
Carter County (Tennessee)	Carter County, Tennessee
Ginnifer Goodwin	Ginnifer Goodwin
Sheer Heart Attack	Sheer Heart Attack
Friedrich Duke of SchleswigHolsteinSonderburgGlücksburg	Luxembourg
Upheaval (Release the Beast into the Wild)	Give 'Em Enough Rope
Giraki	Gilaki language
Saunders County (Montana)	Sanders County, Montana
Heathan Chemistry	Heathen Chemistry
Carr County (Texas)	Kerr County, Texas
Yen Sari	Ieng Sary
THE ALFEE	The Alfee
Bristol County (Massachusetts)	Bristol County, Massachusetts
Gloria (U2 song)	Gloria (U2 song)
Seneca County (New York State)	Seneca County, New York
Korean	Korean language
Juan Castaño Quiros	Juanele
Marwari	Marwari language
Sam Cook	Sam Cooke
Silius	Kurt Zeitzler
Deerlodge County (Montana)	Deer Lodge County, Montana
Democratic Republic of the Congo	Democratic Republic of the Congo
Passion Story ( Donna Summer album)	She Works Hard for the Money (album)
Chelmsford	Chelmsford
Charles Townshend ( 2nd Viscount Townshend)	Charles Townshend, 2nd Viscount Townshend
Shenggouo	Morihiro Higashikuni
George Marshall	George Marshall
Korea Football Association	Korea Football Association
Franklin County (Tennessee)	Franklin County, Tennessee
Tauraj	Taurasi
ULTRA BLUE	Ultra Blue
Battlefield Hardline	Battlefield Hardline
Shinagawa Ward	Shinagawa
Arnie Fletcher	Ernie Fletcher
Umberto Eco	Umberto Eco
erosion ~ lose control ~	Shinshoku (Lose Control)
Ulanhu	Ulanhu
Jani Stefanovic	Jani Stefanovic
UFC 39	UFC 39
Henka Blacksmith	Henkka Seppälä
Chūō Tokyo	Michael Brecker
Joni Mitchell	Joni Mitchell
Salman bin Abdulaziz	Salman of Saudi Arabia
Battlefield (computer game)	Battlefield (series)
Hamilton County (Florida)	Hamilton County, Florida
Louis McLane	Rough'n Tumble
Delaware County (Iowa)	Delaware County, Iowa
IBooks	IBooks
Eduskunta	Parliament of Finland
Tachikawa City	Tachikawa
Reagan County Texas	Jump Square
Spirit dreams inside -another dream-	Spirit Dreams Inside (Another Dream)
Minami Takahashi	Minami Takahashi
Kim Yong Dae	Kim Yong-dae
Carter County (Montana)	Carter County, Montana
Pierce County (Wisconsin)	Pierce County, Wisconsin
Mexico City	Mexico City
Toyota TF103	Toyota TF103
Weekly Shonen Jump	Weekly Shōnen Jump
J R Jayewardene	Donald Regan
Queen Elizabeth Olympic Park	Queen Elizabeth Olympic Park
Aaron Law	Aaron Lowe
I am	I Am (Ayumi Hamasaki album)
Supercell	Supercell (band)
Le Cong Binh	Lê Công Vinh
Laurent Schwartz	Laurent Schwartz
basque national football team	Basque Country national football team
Nancy Sinatra	Nancy Sinatra
Tibeto-Burman	Tibeto-Burman languages
Michelle Obama	Michelle Obama
Beat It Tonight	Beat It
Christopher Hill	Christopher R. Hill
Carl Sagan	Carl Sagan
Lamezia Terme	Lamezia Terme
Norwegian Broadcasting Corporation	NRK
George Howard ( 6th Earl of Carlyle)	George Howard, 6th Earl of Carlisle
Halo	Acerno
Miyazaki City	Miyazaki, Miyazaki
Shrewsbury Town FC	Shrewsbury Town F.C.
Persepolis FC	Persepolis F.C.
Valar Morghulis	Corona Australis
Phillips County (Arkansas)	Phillips County, Arkansas
Saginaw County (Michigan)	Saginaw County, Michigan
Neosho County (Kansas)	Neosho County, Kansas
Jacob Thompson	Jacob Thompson
Estadio Centenario	Estadio Centenario
The Colour of My Love	Tercera División
Def Leppard	Def Leppard
Alexander Vandegrift	Alexander Vandegrift
Bosell	Bothell, Washington
Roasso Kumamoto	Roasso Kumamoto
Raymond Chandler	Raymond Chandler
Tien Giang Province	Tiền Giang Province
Frederick Stanley ( 16th Earl of Derby)	Frederick Stanley, 16th Earl of Derby
Cook County (Minnesota)	Cook County, Minnesota
Naotake Sato	Naotake Satō
Kenzumi Suematsu	Suematsu Kenchō
Alan Kay	Alan Kay
Samuel Dexter	Samuel Dexter
First Minister of Finance	First Lord of the Treasury
Crescent (GACKT's album)	Crescent (Gackt album)
UFC 172	UFC 172
Gabriel Marcel	Gabriel Marcel
Ken Tokura	Ken Tokura
Neil Armstrong	Neil Armstrong
Lower Austria	Lower Austria
Beautiful Life	What Is Life
Grand Hamad Stadium	Grand Hamad Stadium
Andre Iguodala	Andre Iguodala
Marco Fabbri	Marco Fabbri
SAKURA ~ Hanagasumi ~	Sakura Hanagasumi
Prince Takahito Mikasa	Takahito, Prince Mikasa
George (Duke of Cumberland)	Prince George of Denmark
Out of Our Heads	Out of Our Heads
Osage County (Kansas)	Osage County, Kansas
Hammersmith	Hammersmith
Augustus	Augustus
Blackmore's Night	Blackmore's Night
Dinwiddie County (Virginia)	Dinwiddie County, Virginia
New Zealand	New Zealand
Two Lea	Doug Aldrich
Makinohara City	Makinohara
Natural Woman ( Song)	(You Make Me Feel Like) A Natural Woman
Vasily Lazarev	Vasily Lazarev
Loretta Lynn	Loretta Lynn
Akiko Suzuki	Akiko Suzuki
Harding County (South Dakota)	Harding County, South Dakota
Welcome to Heaven	Tengoku e Yōkoso
Quinn Snyder	Quin Snyder
Franz II	Francis II, Holy Roman Emperor
Beijing Mass Transit Railway Operation Corporation Limited	Silver Spoon (manga)
NERD	N.E.R.D
Missouri	Missouri
Japanese Canadians	Japanese Canadians
Nathan Barnes	Nathan Burns
The Sound of Silence	Future World (Helloween song)
Asmir Begovic	Asmir Begović
K-POP	K-pop
FLOW	Flow (band)
Take a Bow ( Rihanna 's song)	Take a Bow (Rihanna song)
Bloody Sunday ( U2 song)	Sunday Bloody Sunday
Daniel Webster	Daniel Webster
Pixies	Pixies
Úrvalsdeild	William Wirt (Attorney General)
Army of the Cumberland	Army of the Cumberland
Al Kuwait SC	Kuwait SC
Colin McGuinn	Colin McGinn
Friedrich Ebert Jr	Eau Claire County, Wisconsin
Monroe County Ohio	The Afghan Whigs
Principality of Serbia (Modern)	Principality of Serbia
National Olympic Stadium	Big Horn County, Montana
Maresuke Nogi	Nogi Maresuke
Morgan's Raid	Morgan's Raid
Fredric Reinfeldt	Fredrik Reinfeldt
Kaiser Chiefs FC	Kaizer Chiefs F.C.
referral	Lyphard
Mario Series	Mario (franchise)
Lucy in the Sky with Diamonds	Lucy in the Sky with Diamonds
BEST OF SOUL	Best of Soul
Nagoya University	Nagoya University
Nikolai Gogol	Nikolai Gogol
Sir Hercules	Sir Hercules
JUMP NO.1	Jump No. 1
William Leahy	William D. Leahy
Falling in Reverse	Falling in Reverse
Masaaki Yanagishita	Masaaki Yanagishita
Bruce Lee	Bruce Lee
Pike County (Mississippi)	Pike County, Mississippi
Dutch	Dutch language
Chris Ess	Kris S.
James Hamilton ( 3rd Duke of Abercorn)	James Hamilton, 3rd Duke of Abercorn
Tiger Stadium	Tiger Stadium (Detroit)
Mother (John Lennon song)	Mother (John Lennon song)
Cerro Porteño	Cerro Porteño
FC Lucerne	FC Luzern
Dodgy	¡Dos!
Lazio	Lazio
Maithili	Maithili language
Ruby Lahoon	Ruby Laffoon
United States Federal Government	Federal government of the United States
She Works Hard for the Money	Lee Myung-bak
C language	C (programming language)
Algernon Percy ( 6th Duke of Northumberland)	Algernon Percy, 6th Duke of Northumberland
Gérard Larousse	Gérard Larrousse
	Yeom Ki-hun
William Phillips ( diplomat)	William Phillips (diplomat)
Benson County (North Dakota)	Benson County, North Dakota
International Baseball Federation	International Baseball Federation
German East Africa	German East Africa
Expedition 43	Lovell Rousseau
Ochiltree County (Texas)	Ochiltree County, Texas
Hanamaki City	Hanamaki, Iwate
Estadio Nacional ( Lima)	Estadio Nacional de Lima
Nationwide Arena	Nationwide Arena
Pike County (Illinois)	Pike County, Illinois
Bottinho County (North Dakota)	Bottineau County, North Dakota
Bactrian	Bactrian language
SHINE (album)	Shine (Luna Sea album)
Ichiro Matsui	Ichirō Matsui
Franklin Pierce	Franklin Pierce
Mari Kibiniemi	Mari Kiviniemi
Vissel Kobe	Vissel Kobe
Tottenham Hotspur FC	Tottenham Hotspur F.C.
Taiji Sawada	Taiji (musician)
Salice Salentino	Salice Salentino
Ainu	Ainu people
Norwegian	Norwegian language
Love Ai n't Here Anymore	Love Ain't Here Anymore
Neder-Beetwe	Neder-Betuwe
Muskegon County (Michigan)	Muskegon County, Michigan
Pisces	Pisces (constellation)
Blackpool	Blackpool
Matthias Kupiainen	Matias Kupiainen
Copa del Rey	Copa del Rey
Cradle of Filth	Cradle of Filth
Tell Me Your Wish	Perry County, Indiana
Houston County (Minnesota)	Houston County, Minnesota
Jari Kainrainen	Jari Kainulainen
John Rawls	John Rawls
Carife	Václav Havel
Relapse Records	Relapse Records
Roberta Flack	Roberta Flack
Jackson County (Tennessee)	Jackson County, Tennessee
Apollo 13	Apollo 13
Jaroslaw Kaczynski	Jarosław Kaczyński
Heroes and Villains (Song)	Heroes and Villains
William Hague	Seattle SuperSonics
Federation of Bosnia and Herzegovina	Federation of Bosnia and Herzegovina
Ain't To Proud To Begg	Ain't Too Proud to Beg
Pyxis	CSS (band)
Technique	Technique (album)
Pat Metheny	Pat Metheny
Franklin Peale	Franklin Peale
Gujo City	Gujō
Georges Sorel	Georges Sorel
The Tears	The Tears
University of California	University of California
Ananda Mahidol	Trust Your Love
Herman Li	Herman Li
Finland Social Democratic Party	Social Democratic Party of Finland
Henry Bruce 1st Baron Aberdare	William Perry
Max Born	Max Born
Lady Soul	Lady Soul
Saitama Prefecture	Saitama Prefecture
William Cavendish - Scott-Bentink ( 4th Duke of Portland)	William Bentinck, 4th Duke of Portland
Jean-Pierre Serre	Jean-Pierre Serre
El Prado	El Prado (horse)
Takeo Nishioka	Takeo Nishioka
Jeddah	Jeddah
Nawabs of Bengal and Murshidabad	Hitoshi Okamoto
True Face	True Faith (song)
European Freedom Alliance	European Free Alliance
Martine Obry	Martine Aubry
Modular Recordings	Modular Recordings
Gloucestershire	Gloucestershire
Chester County (Tennessee)	Chester County, Tennessee
Shake It Off	Shake It Off (Mariah Carey song)
Bronislaw Komorowski	Bronisław Komorowski
Transformers (Lou Reed album)	Transformer (album)
Milo Cerar	Miro Cerar
Macon County Tennessee	Kodama Gentarō
Tatsuya Tanizawa	Tatsuya Yazawa
Shibuya	Rock Show
Slowhand (album)	Slowhand
Ukigumo (Guitarist)	Ryosuke Nagaoka
Geylang International FC	Geylang International FC
EYES LOVE YOU	Eyes Love You
Chuo Line Rapid Service	Chūō Line (Rapid)
Night's Watch ( Game of Thrones)	Lord Snow
Hachioji City	Hachiōji, Tokyo
Volvo Cars	Volvo Cars
Clay County (Texas)	Clay County, Texas
Toshiki Kaifu	Toshiki Kaifu
Central Italian dialect	Central Italian
Elton John	Elton John
Salle Abruzzo	Kawagoe, Saitama
Satoshi Yamaguchi (Soccer player)	Satoshi Yamaguchi (footballer, born 1978)
Neville Brothers	The Neville Brothers
Mehmed the Conqueror	Hungary national football team
Monster Magnet	Monster Magnet
Masaki Terauchi	Terauchi Masatake
Charlottesville	Charlottesville, Virginia
Kim Jong-pil	Kim Jong-pil
Will Champion	Will Champion
Rated R	Drink It Down (L'Arc-en-Ciel song)
This is the One	This Is the One
Washington County Missouri	Sahrawi Arab Democratic Republic
LaCrosse (Wisconsin)	La Crosse, Wisconsin
Clayton Abrams	Creighton Abrams
Rise Against	Rise Against
Nawab of the Carnatic	Buncombe County, North Carolina
Li Jun	Yi Un
Italian national football team	Italy national football team
Haruki Murakami	Haruki Murakami
Abdou Diouf	Abdou Diouf
Indie folk	Expedition 3
John Campbell ( 2nd Marquess of Breedalbane)	John Campbell, 2nd Marquess of Breadalbane
Madeline Albright	Madeleine Albright
Cochise County (Arizona)	Cochise County, Arizona
Yuji Kimura	Yuji Kimura
Sankt Jakob Park	St. Jakob-Park
A Companion to Hell	Another One Bites the Dust
MARVELOUS	Marvelous (album)
Andrew Bonner Law	Bonar Law
Club African	Club Africain
J1 League	J1 League
John Cale	John Cale
JKT48	JKT48
Hancock County West Virginia	Crazy 4 U
Eternal King Kitashirakawa	Prince Nagahisa Kitashirakawa
Murray Rothbard	Murray Rothbard
Salle	Salle, Abruzzo
John Montague ( 4th Earl of Sandwich)	John Montagu, 4th Earl of Sandwich
Alenka Bratusek	Alenka Bratušek
Boz Scaggs	Boz Scaggs
Yen (Currency)	Japanese yen
Conservative People's Party	Wangsimni Station
Miguel de la Madrid Hurtado	Miguel de la Madrid
UFC 185	UFC 185
Man Without Righteousness	A Man Without Honor
Presence	Presence (album)
Chemung County (New York State)	Chemung County, New York
Slippery When Wet	Fugazi
Ava Lerner	Abba P. Lerner
HELLO ~ Paradise Kiss ~	Hello (Paradise Kiss)
Armed Forces of the Philippines	Galician language
Wichita Recordings	Wichita Recordings
Sami Aragi	Sami Allagui
Maaya Sakamoto	Maaya Sakamoto
Embryo	Embryo (Dir En Grey song)
John Doyle	John Doyle (drummer)
Aquarius	Aquarius (constellation)
Buddy Holly	Buddy Holly
Mariah Carey	Mariah Carey
Elizabeth Stewart	Elizabeth Stuart, Queen of Bohemia
Georges Clemenceau	Georges Clemenceau
Edward Brooke	Edward Brooke
Allen County (Kansas)	Allen County, Kansas
Big Audio Dynamite	Big Audio Dynamite
Breaker of Chains	Circuit de Monaco
Philip Charles Habib	Philip Habib
Williams FW22	Williams FW22
Otemachi Station (Tokyo)	Ōtemachi Station (Tokyo)
Stand Up (Mai Kuraki's song)	Stand Up (Mai Kuraki song)
Norwalk (Connecticut)	Norwalk, Connecticut
Itami Hyōgo	Kayah State
Stadium Australia	Stadium Australia
Mai Hagiwara (Hello! Project)	Mai Hagiwara
Alec Douglas - Hulme	Alec Douglas-Home
Martignano (Province of Lecce)	Martignano
Wichita County (Kansas)	Wichita County, Kansas
Ogle County (Illinois)	Ogle County, Illinois
Helsinki Olympic Stadium	Helsinki Olympic Stadium
Faint Kaori	Kasuka na Kaori
Song San	Son Sann
Andreus Kubilus	Andrius Kubilius
Diana Ross	Diana Ross
Italian Front (World War II)	Italian Campaign (World War II)
Nazi Party	LaMoure County, North Dakota
Pius XI (Pope)	Pope Pius XI
Jeb Bush	Jeb Bush
Fumiaki Ibuki	Bunmei Ibuki
Abdurrahim ElKeib	Jeonju World Cup Stadium
Carlouch I (King of Portugal)	Carlos I of Portugal
Jan Peter Balkenende	Jan Peter Balkenende
Pokémon	Joseph Fourier
Sindh	Sindh
Patrice Lauzon	Patrice Lauzon
Worcester County (Massachusetts)	Worcester County, Massachusetts
Vittorio Emanuele II	Victor Emmanuel II of Italy
Pavo	Pavo (constellation)
Emmanuel Levinas	Emmanuel Levinas
Hampton (Virginia)	Hampton, Virginia
Khabarovsk	Khabarovsk
Matsudo City	Matsudo
Michigan State University	Michigan State University
Pearl River County (Mississippi)	Pearl River County, Mississippi
Maccabi Haifa FC	Maccabi Haifa F.C.
Principality of Schleswig	Duchy of Schleswig
Sarah Palin	Sarah Palin
OASIS (Oasis album)	Definitely Maybe
Monaco	Monaco
AT&T Park	AT&T Park
Lipuari	Ripuarian language
Alice in Chains	Alice in Chains
Ryoukenza	Canes Venatici
George II (King of England)	George II of Great Britain
The Best of New Order	The Best of New Order
Gianfranco Fini	Gianfranco Fini
Kingdom of Great Britain	Kingdom of Great Britain
Ikimonogakari	Ikimono-gakari
Robert Selmer Berglund	Robert Bergland
Orsonia	Orsogna
Hand in hand- Teo Torriatte (Let Us Cling Together)	Teo Torriatte (Let Us Cling Together)
Paul Konchesky	Paul Konchesky
The Circus	The Circus (Take That album)
Catalonia	Catalonia
Owari Tokugawa Family	Owari branch
Hungarian	Hungarian language
Shinshiro Aichi	William Westmoreland
If I Believe	If I Believe
Madagascar	Madagascar
Please Please Me ( album)	Please Please Me
FC Seoul	FC Seoul
Dream Pop	Dream pop
FC BATE Borisov	FC BATE Borisov
Portuguese First Republic	First Portuguese Republic
Humayun	Humayun
The Stooges	The Stooges
Herbert Simon	Herbert A. Simon
Distance (Utada Hikaru album)	Distance (Utada Hikaru album)
Nearco	Nearco
Vanness Wu	Stade Geoffroy-Guichard
Henry L. Stimson	Airi Suzuki
Chino Moreno	Chino Moreno
Arthur St. Clair	Arthur St. Clair
Chicago Stadium	Chicago Stadium
Reading the Wind	Kazeyomi
Eden no Machi	Gusii language
David Lindley	David Lindley (musician)
Alleghany County Virginia	Al Unser
DFA Records	DFA Records
Hamburger SV	Hamburger SV
Charles Bolden	Charles Bolden
Forsyth County (Georgia)	Forsyth County, Georgia
Zimbabwe Rhodesia	Zimbabwe Rhodesia
Kyoto Sanga FC	Kyoto Sanga F.C.
Static-X	Static-X
Carpenters	The Carpenters
Cinder	Sinndar
Villa Santa Maria	Villa Santa Maria
Devon	Devon
Arturas Paulauskas	Artūras Paulauskas
Charles V Holy Roman Emperor	Gene Simmons
Europop	Europop
Fernando de la Rua	Fernando de la Rúa
Charles Pinckney	Charles Pinckney (governor)
freeform	Freeform (TV channel)
Punjabi language	Princess Margaret, Countess of Snowdon
Progressive Party (Greenland)	Siumut
Jawaharlal Nehru	Jawaharlal Nehru
Rangers FC	Rangers F.C.
Kannada characters	Kannada alphabet
GTO (Manga)	Great Teacher Onizuka
Tibetan script	Tibetan alphabet
Friedrich I (King of Prussia)	Frederick I of Prussia
Nadir Belhaj	Nadir Belhadj
Triangle	Power to the People (song)
CryENGINE	CryEngine
In Flames	In Flames
alisheba	Alysheba
Urdu	Urdu alphabet
Menominee County (Michigan)	Menominee County, Michigan
Simeon SaxeCoburgGotha	Donald Rumsfeld
Thomas Hitzlsperger	Thomas Hitzlsperger
Michal Karecki	Michał Kalecki
Battle of Chancellorsville	Battle of Chancellorsville
Blue Eyed Soul	Blue-eyed soul
Armenian Premier League	Armenian Premier League
Arma Mood	Almahmoud
Tak State City	Zhuozhou
Omar Rodriguez Lopez	Omar Rodríguez-López
New century love song	Shinseiki no Love Song
SPEED	Speed (Japanese band)
Siberian Federal District	Siberian Federal District
Latina Department	Province of Latina
Vagley Noble	Vaguely Noble
Caleb Blood Smith	Caleb Blood Smith
Cherry Blossoms in Sweet and Sour Spring	Amazuppai Haru ni Sakura Saku
Henry County (Missouri)	Henry County, Missouri
George Karl	George Karl
Leonid Havitz	Leonid Hurwicz
Wyndham County (Vermont)	Windham County, Vermont
Hebei China Happiness Football Club	Hebei China Fortune F.C.
Gerolamo Cardano	Gerolamo Cardano
Touch Me!	Touch Me!
William Eaton Chandler	William E. Chandler
Uzbek	Uzbek language
Joao Gilberto	João Gilberto
National Hockey League	National Hockey League
William Dennison ( Postmaster General)	William Dennison Jr.
sentence	Sentenced
Northern Ireland	Northern Ireland
UFC 158	UFC 158
Dedicated to the World	News of the World (album)
Sussex County (Delaware)	Sussex County, Delaware
Guillaume IV (Grand Duke of Luxembourg)	William IV, Grand Duke of Luxembourg
Solaai	Soraai
Detroit Tigers	Detroit Tigers
Chattanooga Campaign	Standard Liège
Tricky Stewart	Tricky Stewart
Syu (Guitarist)	Syu
Ionian Sea	Ionian Sea
High Chaparral	High Chaparral
Love Song of the Heart	Silly Love Songs
Geady	Ghedi
Shugo Chara Egg!	Shugo Chara Egg!
Counties of Scotland (Missouri)	Scotland County, Missouri
John Sheffield ( 1st Duke of Buckingham-Normanby)	John Sheffield, 1st Duke of Buckingham and Normanby
CA Osasuna	CA Osasuna
FK Sarajevo	FK Sarajevo
Joe Smith	Joe Smith (basketball)
Hitachiota City	Hitachiōta, Ibaraki
Shimonoseki City	Shimonoseki
Kingdom of Ireland	Kingdom of Ireland
FC Lokomotiv Moscow	FC Lokomotiv Moscow
MALICE MIZER	Malice Mizer
Everbank Field	EverBank Field
Far Eastern Federal District	Far Eastern Federal District
Bulacan	Bulacan
Nakhi people	J. Lawton Collins
Ai no Tame ni	Apollo 15
Bullock County Alabama	Popcorn (Arashi album)
Oliver Ellsworth	Oliver Ellsworth
Battle of Fort Donelson	Battle of Fort Donelson
Fayette County (Alabama)	Fayette County, Alabama
Archibald Primrose ( 5th Earl of Rosebery)	Archibald Primrose, 5th Earl of Rosebery
Wonderwall	Wonderwall (song)
IF Elfsbori	IF Elfsborg
Thom Yorke	Thom Yorke
Glow Stark	Graustark (horse)
My Bloody Valentine	My Bloody Valentine (band)
UFC 95	UFC 95
Wilhelm Frick	Japan Ground Self-Defense Force
Morrissey	Morrissey
Army of the Ohio	Bob Dylan's Greatest Hits Volume 3
Henry Sydney ( Earl Romney)	Henry Sydney, 1st Earl of Romney
By the Wind	Kaze o Ukete
Carlos Santana	Carlos Santana
Sternatia	Sternatia
Fender Mustang	Fender Mustang
Fuji Shizuoka	Auriga (constellation)
University of Hamburg	University of Hamburg
FC Copenhagen	F.C. Copenhagen
John Ashcroft	John Ashcroft
Ponytail and scrunchie	Ponytail to Shushu
Lenny Kravitz	Lenny Kravitz
Impaled Nazarene	Impaled Nazarene
Johnny Dumfries	John Crichton-Stuart, 7th Marquess of Bute
Thomas E. Bramlett	Thomas E. Bramlette
Ren'Py	Ren'Py
LOVE PSYCHEDELICO	Love Psychedelico
Spanish Senate	Senate of Spain
Gilbert Elliott - Murray-Kinnymound ( 1st Earl of Minto)	Gilbert Elliot-Murray-Kynynmound, 1st Earl of Minto
Yuri Andropov	Yuri Andropov
Sylvestium	Caelum
Nawaz Sharif	Nawaz Sharif
Plastic Tree	Plastic Tree
Cheryl FernandezVersini	Shahid Dastgerdi Stadium
Inter Mila	Eagles (band)
Led Zeppelin I	Led Zeppelin (album)
Death Metal	Death metal
Patrick County (Virginia)	Patrick County, Virginia
John Pope	John Pope (military officer)
Valar Dohaeris	Heaven & Hell (band)
Soyuz TM-20	Soyuz TM-20
Saint Vincent and the Grenadines	Saint Vincent and the Grenadines
Rochester (New York)	Rochester, New York
Byron Dorgan	Byron Dorgan
Kuwait City	Kuwait City
Indonesian Super League	Indonesia Super League
John Ajekum Kufo	John Kufuor
Tenelani	Tenerani
Castel Guidone	Castelguidone
Richard Howe	Richard Howe, 1st Earl Howe
Matt Cameron	Matt Cameron
Ei Ei ( Nothing Else I Can Say)	Eh, Eh (Nothing Else I Can Say)
wire (band)	Wire (band)
reach out	Reach Out (Take That song)
Scott Stapp	Scott Stapp
Ya ! Broad Street ( album)	Give My Regards to Broad Street
Macon County (Missouri)	Macon County, Missouri
Florida Championship Wrestling	Chelan County, Washington
Byung Seok Kim	Kim Byung-suk
Ronieri Gomez dos Santos	Ronieli Gomes dos Santos
Tsarist State of Russia	Tsardom of Russia
Egypt	Egypt
nuvorent	Nuvolento
Stephen Wilson	Steven Wilson
Ivory Coast	Ivory Coast
Yuto Sengoku	Yoshito Sengoku
Maria Jose del Bergio	Marie José of Belgium
Nepal	Nepal
Sagalahad	Sir Gallahad
Happiness Premonition	With a Little Luck
Custer County (Montana)	Custer County, Montana
Phoenix (Arizona)	Phoenix, Arizona
Tatsuo Murayama	Tatsuo Murayama
John McPhee	John McFee
Have a Heart	Just Have a Heart
Slovenia national football team	Slovenia national football team
Rapides Parish Louisiana	Princess Thyra of Denmark
Zack Wylde	Zakk Wylde
Permian	Permic languages
José Manuel Durán Barroso	José Manuel Barroso
The 45th Long Stay	Expedition 45
Chuvash language	Super Bowl
Monte Millet	Montemiletto
Cigarettes and Alcohol	Cigarettes & Alcohol
Dangerous (album)	Dangerous (Michael Jackson album)
Hyde County (South Dakota)	Hyde County, South Dakota
STS-102	STS-102
DUM SPIRO SPERO	Dum Spiro Spero (album)
Miami-Dade County ( Florida)	Miami-Dade County, Florida
Frozen (Soundtrack)	Frozen (soundtrack)
Juan Francisco Martinez Modesto	Nino (footballer)
Emperor Saimei	Empress Kōgyoku
Cass County Indiana	Polyrhythm (song)
Behind the Mask ( Michael Jackson song)	Behind the Mask (Michael Jackson song)
UZA (music)	Uza (song)
Ryomaden	Ryōmaden
Beautiful World ( Take That album)	Beautiful World (Take That album)
FC Khimki	FC Khimki
John Lydon	John Lydon
Chummarie Sainasorn	Choummaly Sayasone
President of the Lao People's Democratic Republic	President of Laos
Manila (Racehorse)	Manila (horse)
Eve of the Decisive Battle	The Prince of Winterfell
Sterling County (Texas)	Sterling County, Texas
Greek Civil War	Greek Civil War
Parc Olympique Lyonnais	Parc Olympique Lyonnais
Peru	Peru
Steve Kahn	Steve Keirn
Albuquerque	Albuquerque, New Mexico
Edgar Faure	Edgar Faure
Up Up Girls (provisional)	Up Up Girls (Kakko Kari)
Yuki City	Yūki, Ibaraki
I HAVE NEVER SEEN	I Have Never Seen
Always (Mai Kuraki's song)	Always (Mai Kuraki song)
Osamu Fujimura	Osamu Fujimura
Guy Stevens	Guy Stevens
HUMANIA	Humania (album)
Margaret Spellings	Margaret Spellings
Edward Cavendish ( 10th Duke of Devonshire)	Edward Cavendish, 10th Duke of Devonshire
Musical Moments	Japanese Peruvians
Nolan County (Texas)	Nolan County, Texas
Jonas Bjöhler	Jonas Björler
ZYX	ZYX
Basque	Basque language
Oregon County (Missouri)	Oregon County, Missouri
President (Switzerland)	President of the Swiss Confederation
Evian Thonon Gaillard FC	Evian Thonon Gaillard F.C.
Wishingwell	Wishing Well (horse)
Kim Il Sung	Kim Il-sung
Rachel Goswell	Rachel Goswell
Subterranean Homesick Blues	Subterranean Homesick Blues
Thomas Ilves	Toomas Hendrik Ilves
Roman Empire	Roman Empire
GX Rocket	GX (rocket)
Mikael Åkerfeldt	Top 14
Negaigoto	Ministry of Defense (Japan)
Zhang Ben	Chang Myon
Uppsala County	Uppsala County
Bronx	The Bronx
UFC 134	UFC 134
Gibson County (Tennessee)	Gibson County, Tennessee
Rick Danko	Rick Danko
Ōita Ōita	Timothy B. Schmit
journey (band)	Journey (band)
FC Utrecht	FC Utrecht
Barishano	Barisciano
Edwin Dembi ( politician)	Edwin Denby (politician)
My Dinh National Stadium	Mỹ Đình National Stadium
Williams F1	Williams Grand Prix Engineering
Mute Records	Mute Records
Hamamatsu City	Hamamatsu
Kennebec County (Maine)	Kennebec County, Maine
Two Swords	Two Swords (Game of Thrones)
Halland County	Halland County
Stark County (North Dakota)	Stark County, North Dakota
Woman (John Lennon song)	Woman (John Lennon song)
Astana	Astana
CR Vasco da Gama	CR Vasco da Gama
FLOW ANIME BEST	Anime Best
Fender Stratocaster	Fender Stratocaster
Fish (band)	Phish
Merry Christmas ( Mariah Carey album)	Merry Christmas (Mariah Carey album)
Tokotsugi Takejiro	Tokonami Takejirō
Frank Ocean	Frank Ocean
Jefferson County (New York State)	Jefferson County, New York
Eighth Hood	Ace Hood
Cincinnati	Cincinnati
John Mowbray ( 2nd Duke of Norfolk)	John de Mowbray, 2nd Duke of Norfolk
Mickey Dee	Mikkey Dee
Anna Lee Fisher	Anna Lee Fisher
Corsican	Corsican language
African Union	African Union
Paul Tillich	Paul Tillich
United Party of Ulster	Ulster Unionist Party
Northern Ireland National Football Team	Northern Ireland national football team
Fornax	Fornax
Tom Ridge	Tom Ridge
Chinese Communist Party	Communist Party of China
Codington County South Dakota	Te o Tatake
Overkill (Band)	Overkill (band)
BIRTHDAY (ClariS album)	Birthday (ClariS album)
Justice and Development Party	Justice and Development Party (Turkey)
Kingdom of Bavaria	Kingdom of Bavaria
Cheshire County (New Hampshire)	Cheshire County, New Hampshire
Oent Tudor	Owen Tudor (horse)
Destroyer	James Meade
Belarus	Belarus
Ian McLagan	Ian McLagan
Kassady Pope	Cassadee Pope
Mind Travel	Mind Travel
Bosnia and Herzegovina national football team	Bosnia and Herzegovina national football team
My Generation ( album)	My Generation (album)
Kushiro City	Kushiro, Hokkaido
Skiffle	Skiffle
Grip!	Grip!
Wilko Johnson	Wilko Johnson
François Valouin	François Baroin
Don't Look Back in Anger	Don't Look Back in Anger
Civil War	American Civil War
Billy Preston	Billy Preston
Ryuta Tasaki	Ryuta Tasaki
Naketesh County (Louisiana)	Natchitoches Parish, Louisiana
TNA	Total Nonstop Action Wrestling
Croatian Democratic Union	Croatian Democratic Union
Aaliyah	Aaliyah
Ibrahim Rugova	Ibrahim Rugova
Emperor Monmu	Emperor Monmu
Salt Lake City	Salt Lake City
Polo Grounds	Polo Grounds
Da Nang	Da Nang
Nikkō Tochigi	Scarlet Records
citation (racehorse)	Citation (horse)
Hellcat Records	Hellcat Records
Serbian Cup	Serbian Cup
Miguel Treviño Morales	Miguel Treviño Morales
Mickey Ekko	Mikky Ekko
Dean Malenko	Dean Malenko
Randy Rhoads	Randy Rhoads
Denmark First Division	Danish 1st Division
Simon B. Buckner	Simon Bolivar Buckner
Vladislaus II of Hungary	National Stadium (Thailand)
Akita City	Akita, Akita
Sporting Kansas City	Sporting Kansas City
Lout County (Colorado)	Routt County, Colorado
Madison County (Texas)	Madison County, Texas
Joseph Inslee Anderson	Joseph Anderson
Toms	TOM'S
Kansas	Kansas
FC Ural Sverdlovsk Oblast	FC Ural Sverdlovsk Oblast
Yoshiaki Manabe	Yoshiaki Manabe
Paul-Henri Tillie Dorbach	Baron d'Holbach
Guatemala	Guatemala
Kane Fukuda	Kanon Fukuda
Haywood County (Tennessee)	Haywood County, Tennessee
Esashi City	Esashi, Iwate
Prime Minister of Armenia	Prime Minister of Armenia
Andrew Fisher	Andrew Fisher
Latvian Soviet Socialist Republic	Latvian Soviet Socialist Republic
Japan Professional Soccer League	J.League
Shiver	Koji Kondo
Kokubara	Kokborok
Arctic Monkeys	Arctic Monkeys
Benji County (Michigan)	Benzie County, Michigan
Frideriki (Queen of Greece)	Frederica of Hanover
Howard H. Baker Jr.	Howard Baker
Tsutomu Hata	Hiroyuki Hosoda
Henry Howard ( 13th Duke of Norfolk)	Henry Howard, 13th Duke of Norfolk
Hypocrisy	List of heads of state of Gabon
Ante Pavelic	Ante Pavelić
Province of Milan	Province of Milan
Adriatic Sea	Adriatic Sea
Kim Sun Min	Kim Sun-min
Ohio County West Virginia	Patricio Aylwin
People don't change	On ne change pas (song)
James Hamilton ( 1st Duke of Abercorn)	James Hamilton, 1st Duke of Abercorn
Kim Jinkyu	Kim Jin-kyu
A League	A-League
Juan Isaac Cuenca Lopez	Isaac Cuenca
Be Here Now	Be Here Now (album)
Jay Sean	Jay Sean
Apollo 9	Apollo 9
CenturyLink Fields	CenturyLink Field
Tomomi Ogawa	Shining (Swedish band)
Love the world	Love the World
Edith Cresson	Édith Cresson
Norwegian First Division	Bath County, Virginia
Come Together	Come Together
Julia Obertas	Julia Obertas
Hampshire County (West Virginia)	Hampshire County, West Virginia
Hideki Nagai	Hideki Nagai
Free&Easy	Free & Easy (Ayumi Hamasaki song)
Simon Bradstreet	Simon Bradstreet
Tono City	Tōno, Iwate
San Mateo County	San Mateo County, California
Prime Minister of Australia	Prime Minister of Australia
Konyaspor	Konyaspor
Richard Mentor Johnson	Richard Mentor Johnson
John Spencer, 8th Earl Spencer	Rock the Casbah
Martin Brundle	Martin Brundle
Veterans Stadium	Veterans Stadium
Malfunction	Malfunkshun
Davidson County (North Carolina)	Davidson County, North Carolina
Dark Funeral	Dark Funeral
George Harrison	George Harrison
Carlisle (England)	Carlisle, Cumbria
Waltham Forest District	London Borough of Waltham Forest
UEFA EURO 2012	UEFA Euro 2012
Kenji Ueda	Kenji Ueda
Fontana Distribution	Fontana Distribution
Charles Howard ( 3rd Earl of Carlyle)	Charles Howard, 3rd Earl of Carlisle
Ohm (Racehorse)	Orme (horse)
Neil Jani	Neel Jani
Roger Glover	Roger Glover
James Irwin	James Irwin
Lot Morrill	Lot M. Morrill
Peterborough	Peterborough
The pillows	The Pillows
Malayo-Polynesian	Malayo-Polynesian languages
Marie José of Belgium	Geffen Records
David Petraeus	David Petraeus
Boredoms	Boredoms
Juan Carlos I ( King of Spain)	Juan Carlos I of Spain
Vaclav Klaus	Václav Klaus
LGV North Line	LGV Nord
Naruto City	Naruto, Tokushima
William Shatner	William Shatner
Teppen Tottande	Star Kingdom
RUN ☆RUN☆RUN	Run Run Run (High and Mighty Color song)
Czech First League	Valenti (song)
15th Army (Japanese Army)	Fifteenth Army (Japan)
Daniel Finch 2nd Earl of Nottingham	Charli XCX
Republic of Ireland football team	Republic of Ireland national football team
Kobe Steel Kobelco Steelers	Kobe Steel Kobelco Steelers
Ryan Omera	Ryan O'Meara
Old Latin	Old Latin
Chuji Machida	Machida Chūji
Bunnyang Woorachit	Bounnhang Vorachith
Joseph Stalin	Joseph Stalin
Satoshi Katayama	Tetsu Katayama
Ride (Band)	Ride (band)
Boca Juniors	Boca Juniors
Webster County Missouri	All of Tanpopo
Love never stops ~ Turn It Into Love ~	Turn It into Love
Wish I Had an Angel	Wish I Had an Angel
Cruz Azul	Cruz Azul
Sukhbaatar Batbold	Sükhbaataryn Batbold
Principality of Savoy	Duchy of Savoy
Minangkabau	Minangkabau language
Korea Baseball Commission	Korea Baseball Organization
Amtrak	Amtrak
Elements Part 1	Elements, Pt. 1
Frederick North	Frederick North, Lord North
Prime Minister of Poland	Prime Minister of Poland
Nara Nara	Andy McCoy
Jean-Louis Borlot	Jean-Louis Borloo
Rafael Correa	Rafael Correa
Edward Gray	Edward Grey, 1st Viscount Grey of Fallodon
Sid the Kid	Syd tha Kyd
Nakaku Nagoya	Billy Ray Cyrus
The Dirty Mac	The Dirty Mac
The 43rd Long Stay	Expedition 43
Carmine Appice	Carmine Appice
Lenzi Cabinet	Renzi Cabinet
Carpi FC	Carpi F.C. 1909
Kingdom of Albania (Modern)	Albanian Kingdom (1928–39)
John A. Logan	John A. Logan
Johann Karl XIV (King of Sweden)	Charles XIV John of Sweden
Galor National Stadium	National Football Stadium (Maldives)
Ivan Kaviedes	Iván Kaviedes
Werder Bremen	SV Werder Bremen
Princess Margaret of Connaught	Broome County, New York
Brindisi Province	Province of Brindisi
Yitzhak Rabin	Yitzhak Rabin
Viktor Khristenko	Viktor Khristenko
Penn Central Railroad	Penn Central Transportation Company
Tuscaloosa County (Alabama)	Tuscaloosa County, Alabama
Romance languages	Romance languages
Medi Nafti	Mehdi Nafti
Scream 3	Ikawa, Shizuoka
Caldwell County (Louisiana)	Caldwell Parish, Louisiana
HONEY (L'Arc ~ en ~ Ciel 's song)	Honey (L'Arc-en-Ciel song)
Within Temptation	Within Temptation
High German	High German languages
Navy SEALs	United States Navy SEALs
LISP	Lisp (programming language)
John Adams Dix	John Adams Dix
Austria National Football Team	Austria national football team
American League	American League
Metal Blade Records	Metal Blade Records
Thomas Robinson 2nd Baron Grantham	Jonathan Belcher
Amman International Stadium	Amman International Stadium
John S. McCain Sr.	John S. McCain Sr.
Guizhou	Guizhou
Sauber C20	Sauber C20
FC Midtjylland	William the Third (horse)
Lilac	Syringa vulgaris
Battle of Monmouth	Battle of Monmouth
Sebastian Buck	Sebastian Bach
Shiga Prefecture	Shiga Prefecture
Billy Sheehan	Billy Sheehan
Alisa Agafonova	Alisa Agafonova
Robert Cecil ( 1st Earl of Salisbury)	Robert Cecil, 1st Earl of Salisbury
Tohoku Shinkansen	Tōhoku Shinkansen
Henry Simons	Henry Calvert Simons
Antonio Seni	Antonio Segni
Kyōshinshō	Rust (programming language)
Fuji Heavy Industries	Fuji Heavy Industries
Dance Pop	Dance-pop
Song Qingling	Soong Ching-ling
Stormtroopers of Death	Stormtroopers of Death
Denmark Social Democratic Party	Social Democrats (Denmark)
Nicky Hopkins	Nicky Hopkins
Twilight Brick Road	Goodbye Yellow Brick Road
Roccavivara	Roccavivara
Apple A5	Apple A5
Ming dynasty	Stop Crying Your Heart Out
Chinese Football League B	China League Two
Lev Trotsky	Leon Trotsky
James Ramsay ( 1st Marquess of Dalhousie)	James Broun-Ramsay, 1st Marquess of Dalhousie
Hasanal Bolkiah National Stadium	Sultan Hassanal Bolkiah Stadium
Working Title Films	Working Title Films
Brisbane Roar FC	Brisbane Roar FC
Yowamushi Pedal	Yowamushi Pedal
AJ Auxerre	AJ Auxerre
Sabine County (Louisiana)	Sabine Parish, Louisiana
Oxfordshire	Oxfordshire
Alexi Laiho	Alexi Laiho
The 7 Shining Seas	Seven Seas of Rhye
Fujisawa City	Fujisawa, Kanagawa
Pokémon the Movie	First Battle of Bull Run
Syrian	Syriac language
Jacob Viner	Jacob Viner
Airsteriga	Austrian Football First League
Dark Tranquility	Dark Tranquillity
Mahoning County (Ohio)	Mahoning County, Ohio
Nijmegen	Nijmegen
Volga Federal District	Volga Federal District
Kathleen Sebelius	Kathleen Sebelius
Dunn County (Wisconsin)	Dunn County, Wisconsin
William Day	William R. Day
Zettai Zetsumei	Kauffman Stadium
Levy County (Florida)	Levy County, Florida
Romain Dumas	Romain Dumas
Galatina	Galatina
New Order	New Order
Friedrich Hayek	Friedrich Hayek
Gallicchio	Columbus, Georgia
Toyama Prefecture	Toyama Prefecture
Moshe Ben - Maymon	Maimonides
Waushala County (Wisconsin)	Waushara County, Wisconsin
Yamagata Yamagata	Hans Furler
Kurt Schuschnik	Kurt Schuschnigg
Akio Toyoda	Akio Toyoda
Sooner or Later	One of Us Must Know (Sooner or Later)
King County (Texas)	King County, Texas
Naohiro Ishikawa	Naohiro Ishikawa
Archer County (Texas)	Archer County, Texas
rock (music)	Rock music
Greek letters	Greek alphabet
Matsue City	Matsue
Yofusa Tokugawa	Tokugawa Yorifusa
Alicia de Borbone - Parma	Infanta Alicia, Duchess of Calabria
Fleshgod Apocalypse	Fleshgod Apocalypse
Democratic Republic of Vietnam	North Vietnam
Mar County (Montana)	Meagher County, Montana
Nyasaland	Nyasaland
Denny Lane	Denny Laine
Zeelandic	Zeelandic
Celta de Vigo	Celta de Vigo
Fano Adriano	Fano Adriano
Gael Danik	Gaël Danic
William Meredith	William M. Meredith
UFC 177	UFC 177
John Pershing	John J. Pershing
Riot V	Ocean County, New Jersey
The Walt Disney Company	The Walt Disney Company
Sō	Chet Atkins
United States Treasury Secretary	United States Secretary of the Treasury
John Hay	John Hay
Bengali	Bengali language
Bali characters	Balinese alphabet
Spanish Communist Party	Communist Party of Spain
FC Bunyodkor	FC Bunyodkor
Crystal Gale	Crystal Gayle
Ichiro Ito	Ichiro Ito
sharpen-up	Sharpen Up
Crosby , Stills, Nash & Young	Crosby, Stills, Nash & Young
Gee	Gee (Girls' Generation song)
Barbara Fusal - Poli	Barbara Fusar-Poli
Yorkshire and the Humber	Yorkshire and the Humber
Finnish	Finnish language
Eternal Vow	It's a Hard Life
Scream2	Scream 2
Randy Wittman	Somewhere I Belong
SOUL QUEST	Soul Quest
Robert Cecil ( 1st Viscount Cecil of Chelwood)	Robert Cecil, 1st Viscount Cecil of Chelwood
Livingston County (Missouri)	Livingston County, Missouri
Columbus Ohio	Weekly Young Magazine
JYJ	JYJ
William Taft	William Howard Taft
Tibetan	Standard Tibetan
São Bernardo Futebol Clube	Saddam Hussein
Daniel Erlandson	Daniel Erlandsson
Bath (England)	Bath, Somerset
Kagayaku Tsuki no Yō ni	Whisk Broom II
Busan iPark	Busan IPark
Kunio Hatoyama	Kunio Hatoyama
Hugh Swinton Legley	Hugh S. Legaré
Susumu Mochizuki	Avispa Fukuoka
Koji Tamaki	Kōji Tamaki
Alfredo Perez Rubalcaba	Alfredo Pérez Rubalcaba
Aisin Gioro	Kurenai (song)
Calvin Coolidge	Calvin Coolidge
Yoichi Doi	Yoichi Doi
Li Peng	Li Peng
War Admiral	War Admiral
Roadrunner Records	Roadrunner Records
RADWIMPS	Radwimps
SOS (Stratovarius song)	S.O.S. (Stratovarius song)
Flame	The Unforgettable Fire
DESTINY -The Lovers-	Destiny -The Lovers-
Jean Grand Duke of Luxembourg	Goregrind
HIGH and MIGHTY COLOR	High and Mighty Color
Genuine	Genuine (Fayray album)
Louise of Sweden	Tosu Stadium
Prince Edward Earl of Wessex	FC Spartak Moscow
United States Army	Confederate States Army
Alydar	Tech N9ne
Christine Lagarde	Christine Lagarde
Omni Coliseum	Omni Coliseum
Charlotte County (Virginia)	Charlotte County, Virginia
Republic of Dagestan	Dagestan
Akbar	Akbar
Tracy Smothers	Tracy Smothers
Thomas Payne	Thomas Paine
Avril Lavigne ( album)	Avril Lavigne (album)
Moments	Moments (Ayumi Hamasaki song)
RC Succession	RC Succession
Hizmajesty	His Majesty (horse)
Agnes Tachyon	Agnes Tachyon
Spencer Compton ( 1st Earl of Wilmington)	Spencer Compton, 1st Earl of Wilmington
Ryutaro Nagai	Ryūtarō Nagai
AROUND THE WORLD (Ami Suzuki's song)	Around the World (Ami Suzuki song)
Changchun Yatai Football Club	Changchun Yatai F.C.
Chicago Bulls	Chicago Bulls
Lee Ho Jung	Lee Ho-jung
Burning Airlines	Burning Airlines
Marcio Richardes de Andrade	Márcio Richardes
Brunei	Brunei
Yazoo	Yazoo (band)
Alfred Milner	Alfred Milner, 1st Viscount Milner
JAPONESQUE	Japonesque (album)
Frédéric Leclerc	Frédéric Leclercq
Abdullah II	Abdullah II of Jordan
Ou Main Line	Ōu Main Line
Ullaslaw II	Vladislaus II of Hungary
Klaus von Amsberg	Prince Claus of the Netherlands
Fiction Records	Fiction Records
Nogata City	Nōgata, Fukuoka
postmetal	Post-metal
Photograph of Memories	Photograph (Ringo Starr song)
Lexington (Racehorse)	Lexington (horse)
South Kingstown (Rhode Island)	South Kingstown, Rhode Island
Region of Matera	Province of Matera
Real Salt Lake	Real Salt Lake
Sheryl Crow ( album)	Sheryl Crow (album)
Khmer	Khmer language
Edo Castle	Edo Castle
BREAK OUT! (TVXQ's song)	Break Out! (Tohoshinki song)
Atlas V	Atlas V
New Democratic Party	New Democracy (Greece)
Wetzel County (West Virginia)	Wetzel County, West Virginia
Nishifunabashi Station	Nishi-Funabashi Station
Lahore	Lahore
Coptic characters	Coptic alphabet
Saint Simon	St. Simon (horse)
University of Lisbon	University of Lisbon
Tallahatchie County (Mississippi)	Tallahatchie County, Mississippi
Dino Casares	Dino Cazares
Alan Turing	Alan Turing
Xining	Xining
Roman-Syrian War	Roman–Seleucid War
Al Ahly Dubai	Al-Ahli Dubai F.C.
Melanie Chisholm	Melanie C
Nakako Tsuzuki	Nakako Tsuzuki
Gibson (musical instrument maker)	Gibson Guitar Corporation
Tigers of Pantin	Tygers of Pan Tang
List of Presidents of Senegal	Prime Minister of Denmark
FC Volga Nizhny Novgorod	FC Volga Nizhny Novgorod
Province of Palermo	Province of Palermo
Vinnie Paul	Vinnie Paul
Moriya Ibaraki	Yuba City, California
Cliff Williams	Cliff Williams
Shijiazhuang	Shijiazhuang
Hertford County North Carolina	Kawamura Kageaki
Eight Days a Week	Eight Days a Week
Judith Basin County (Montana)	Judith Basin County, Montana
Ultimo Dragon	Último Dragón
Soccer Thailand National Team	Thailand national football team
Hanover (Racehorse)	Hanover (horse)
Rovigo Province	Province of Rovigo
Marcos Venancio de Albuquerque	Ceará (footballer)
Kind of Magic	A Kind of Magic
Bayard (Racehorse)	Bayardo (horse)
Clare County (Michigan)	Clare County, Michigan
Carl Bartos	Karl Bartos
Maxima Soreguieta	Queen Máxima of the Netherlands
James Brown	James Brown
Notice Kanai Love To Know That I'm Suppressing Emotion Lesbian Love Continued Digits…	Todokanai Ai to Shitteita no ni Osaekirezu ni Aishitsuzuketa
Thailand	BBC News (TV channel)
Capouti	Capote (horse)
People's Commissariat for Internal Affairs	NKVD
Boys & Girls ( Ayumi Hamasaki's song)	Boys & Girls (Ayumi Hamasaki song)
Avicenna	Battle of Antietam
Urban Sea	Urban Sea
Alachua County (Florida)	Alachua County, Florida
Fusaichi Pegasus	Fusaichi Pegasus
Doris Leuthardt	Doris Leuthard
Jeff Ament	Jeff Ament
Atlantic City	Atlantic City, New Jersey
Clinch County (Georgia)	Clinch County, Georgia
Hans-Joachim Stack	Hans-Joachim Stuck
Roda JC Kerkrade	Koko ga Rhodes da, Koko de Tobe!
Aziz Ibragimov	Aziz Ibragimov
Kalian	Caerleon (horse)
Margaret Beckett	Margaret Beckett
Boom Boom Pow	Boom Boom Pow
Province of Verona	Province of Verona
Risako Sugaya	Risako Sugaya
Vala	Vala (programming language)
Fearless Record	Fearless Records
William Wilkins ( Secretary of War)	William Wilkins (U.S. politician)
John Sheffield 1st Duke of Buckingham and Normanby	Go Let It Out
jazz (album)	Jazz (Queen album)
Dodger Stadium	Dodger Stadium
Fluvana County (Virginia)	Fluvanna County, Virginia
The Third Battle of Chattanooga	Chattanooga Campaign
Judith Butler	Judith Butler
BIGBANG	Big Bang (South Korean band)
Franklin Parish Louisiana	2nd Division (Imperial Japanese Army)
Jacob Dolson Cox	Jacob Dolson Cox
Benningbrough	Beningbrough (horse)
Fred Thompson	Fred Thompson
Nightwish	Nightwish
Ki Sung Yong	Ki Sung-yueng
Black Sabbath	Black Sabbath
Casablanca Records	Casablanca Records
Kelis	Staten Island Railway
Oklahoma City Thunder	Oklahoma City Thunder
Jane Somerset	Jane Summersett
Manistee County (Michigan)	Manistee County, Michigan
Jackson5	The Jackson 5
Bessatsu Shōnen Magazine	Sukhothai Kingdom
2pack	Tupac Shakur
Kingdom of Scotland	Kingdom of Scotland
Hunter Hayes	Hunter Hayes
Clayton Keith Yyter	Clayton Keith Yeutter
16th Area Army (Japanese Army)	Japanese Sixteenth Area Army
Prince Edward County (Virginia)	Prince Edward County, Virginia
Highlands County (Florida)	Highlands County, Florida
List of heads of state of Cape Verde	Pope Alexander VIII
Portland (Oregon)	Portland, Oregon
Harlow	Harlow
Andrey Gromyko	Andrei Gromyko
Mazandaran	Mazanderani language
Walter Rothschild ( 2nd Baron Rothschild)	Walter Rothschild, 2nd Baron Rothschild
Centrist Union (Italy)	Union of the Centre (2002)
Gin Blossoms	Gin Blossoms
Mirek Topolaanek	Mirek Topolánek
Pesitera	Peshtera
Saudi Arabia	Saudi Arabia
Uzbekistan	Uzbekistan
Owyhee County (Idaho)	Owyhee County, Idaho
Saint Helena Ascension and Tristan da Cunha	Saint Helena, Ascension and Tristan da Cunha
Altomonte	Altomonte
London Borough of Lambeth	Walker County, Texas
Boston (Racehorse)	Boston (horse)
Hiroshima City	Hiroshima
Thingspeel	Singspiel (horse)
+1 (album)	+1 (Kaela Kimura album)
Soyuz TM-19	Soyuz TM-19
STS-75	STS-75
Nikita Khrushchev	Nikita Khrushchev
If I Let You Go	If I Let You Go
Nebojsha Radmanovich	Nebojša Radmanović
ANTHEM	Anthem (band)
Copa America	Copa América
Typhoon Generation -Typhoon Generation-	Typhoon Generation
Howard Devote	Howard Devoto
Demon Kakka	Yurameki
Yusuke Murakami	Yusuke Murakami
Traveling	Traveling (song)
Harri Holkeri	Harri Holkeri
High Flyer	Highflyer (horse)
John Bolton	John R. Bolton
Jackie Smith	Jacqui Smith
Satoshi Kojima	Satoshi Kojima
Boys Girls	Boys & Girls
Francis Nicholson	Francis Nicholson
DIFFERENT SENSE	Different Sense
Kagoshima City	Kagoshima
Preston North End FC	Preston North End F.C.
Toshiba Brave Lupus	Toshiba Brave Lupus
Ōta Tokyo	Bustino
Ceará	UEFA Euro 2016 qualifying Group B
Purva HNL	Croatian First Football League
Raleigh (North Carolina)	Raleigh, North Carolina
Karkaska County (Michigan)	Kalkaska County, Michigan
Koko ga Rhodes da Koko de Tobe	Maria Sergejeva
Coleman County (Texas)	Coleman County, Texas
Kent (England)	Kent
Mr.Big	Mr. Big (American band)
NHK General Television	NHK General TV
Smart Strike	Smart Strike
Six Feet Under ( band)	Six Feet Under (band)
Norah Jones	Norah Jones
Atlanta	Atlanta
Avril Lavigne	Avril Lavigne
Earl Lauer Butts	Earl Butz
Buffalo Springfield	Buffalo Springfield
Patrice Evra	Patrice Evra
William Lamb ( 2nd Viscount Melbourne)	William Lamb, 2nd Viscount Melbourne
Red Hat Enterprise Linux	Red Hat Enterprise Linux
Sirikit	Sirikit
Helmut Schmidt	Helmut Schmidt
Cham language	Sō (New Love New World)
Deportivo Cali	Deportivo Cali
Talk Talk	Talk Talk
Lawrence Lessig	Lawrence Lessig
Alejandro (Song)	Alejandro (song)
Altaic languages	Altaic languages
Oasis Dream	Oasis Dream
Mitsubishi Galant	Mitsubishi Galant
Steve Strange	Steve Strange
FC Pyunik Yerevan	FC Pyunik
Al Gharafa	Al-Gharafa Sports Club
Exeter Rhode Island	Kingdom of the Two Sicilies
Galicia	Galicia (Spain)
Communist Party of Germany	Franz Rosenzweig
The Cro - Magnons	The Cro-Magnons
Shes Out of My Life	Providence, Rhode Island
Soyuz-U	Soyuz-U
Deathlike Silence Productions	Deathlike Silence Productions
Putnam County Indiana	Reagan County, Texas
Maria Alexandrovna ( Empress of Russia)	Maria Alexandrovna (Marie of Hesse and by Rhine)
Kyouka Izumi	Kyōka Izumi
William Legge ( 1st Earl of Dartmouth)	William Legge, 1st Earl of Dartmouth
Burhanuddin Rabbani	Burhanuddin Rabbani
Srinakharin	Srinagarindra
UFC 53	UFC 53
Liberal Union Party (UK)	Liberal Unionist Party
Volturala Ilpina	Volturara Irpina
A Change of Seasons	A Change of Seasons
Future Shards	Mirai no Kakera
Benny Golson	Benny Golson
BEST & USA	Best & USA
Tierra (album)	Tierra (L'Arc-en-Ciel album)
Ben Brush	Ben Brush
Duval County (Florida)	Duval County, Florida
Jeonnam Dragons	Jeonnam Dragons
Christine Hirsch	Kristin Hersh
Fyodor Dostoevsky	Fyodor Dostoyevsky
Ashita e Kakeru Hashi	Azerbaijan Premier League
AA Punch Pretta	Associação Atlética Ponte Preta
Kathmandu	Kathmandu
British Airways	British Airways
Alfred Gusenbauer	Alfred Gusenbauer
North , Central America and Caribbean Football Federation	CONCACAF
International Olympic Committee	International Olympic Committee
William Miller	G. William Miller
Sosuke Uno	Sōsuke Uno
Fredrik Nordström	Fredrik Nordström
Capote	Stray Heart
Qashqai language	Kalamazoo, Michigan
Tony Tan	Tony Tan
Haitian American	Haitian Americans
George Boole	George Boole
ProSieben	ProSieben
Coffey County (Kansas)	Coffey County, Kansas
San Nicola Manfredi	San Nicola Manfredi
Putnam County (West Virginia)	Putnam County, West Virginia
Robert Stephen Ingersoll	Robert S. Ingersoll
Jim Ryan	Jim Ryun
Laurence Klein	Lawrence Klein
Warren (Michigan)	Warren, Michigan
Christian Democratic Union = Czechoslovak People's Party	Christian and Democratic Union – Czechoslovak People's Party
Kiss & Cry	Beautiful World (Utada Hikaru song)
The O2 Arena	Sardinia
FC Shinnik Yaroslavl	FC Shinnik Yaroslavl
Walker County (Georgia)	Walker County, Georgia
Panic at the Disco	Panic! at the Disco
Alexander Hamilton	Alexander Hamilton
Staten Island	Staten Island
Ventura (California)	Ventura, California
Takeo Hiranuma	Takeo Hiranuma
Soyuz T-9	Soyuz T-9
Make a secret	Make a Secret
Genisys	Terminator Genisys
Machiavellian	Machiavellian (horse)
Fouad Maasum	Fuad Masum
Bangladesh	Bangladesh
Reichi Nakaido	Understand
Ganyu Oseni	Ganiyu Oseni
Francisco Jemez Martín	Paco Jémez
Williams FW16	Williams FW16
UFC on Fuel TV	Pope Adrian V
Prime Minister of Israel	Prime Minister of Israel
Chalcis	Labour Party (Norway)
Sure (Every Little Thing song)	Sure (Every Little Thing song)
Namegata Ibaraki	Sergey Mironov
Greene County Missouri	Windows PowerShell
Shuri	Syuri
Pete Dunkert	Piet Dankert
Miracle (Kumi Koda's song)	Kiseki (Kumi Koda song)
Snow drop (Song of L'Arc ~ en ~ Ciel)	Snow Drop (L'Arc-en-Ciel song)
Vladimir Alexandrovich	Grand Duke Vladimir Alexandrovich of Russia
Lawrence County (Indiana)	Lawrence County, Indiana
Nijinsky (Racehorse)	Nijinsky (horse)
Straub Talbot	Strobe Talbott
Mellette County South Dakota	Mitsuhide Iwaki
Nashville Sound	Nashville sound
Get Back	Get Back
Southern Triangulum	Triangulum Australe
Scott Skiles	Scott Skiles
Santal	Santali language
Nishio City	Nishio, Aichi
Dutch Republic	Deputy Minister (horse)
Innocent Legion ( Game of Thrones)	And Now His Watch Is Ended
Think Twice	Think Twice (Celine Dion song)
Atletico Paranaense	Clube Atlético Paranaense
Frank Church	Frank Church
Kingdom of Iraq	Kingdom of Iraq
Home Secretary (United Kingdom)	Home Secretary
Leonor de Borbon	Leonor, Princess of Asturias
Etsujiro Uehara	Etsujirō Uehara
Back to the Future	Back to the Future
Ryuichi Kihara	Ryuichi Kihara
Wales	Wales
Old Uyghur	Old Uyghur language
Kyōiku	Amherst, Massachusetts
Pali	Pali
Friedrich Hoelderlin	Friedrich Hölderlin
Alexander Kwasniewski	Aleksander Kwaśniewski
Skeeta Davis	Skeeter Davis
Jordan League	Jordan Premier League
Trumble County (Ohio)	Trumbull County, Ohio
DEC Alpha	DEC Alpha
John Mayall	John Mayall
Lake County (Florida)	Lake County, Florida
Serle	Saski Baskonia
Calvert County (Maryland)	Calvert County, Maryland
Clinton County (Missouri)	Clinton County, Missouri
Elizabeth II	Elizabeth II
Bolognano	Bolognano
The Last to Know	The Last to Know
Potoooooooo	Serie B
Tucson	Tucson, Arizona
Gilby Clarke	Gilby Clarke
Badfinger	Badfinger
EIGHTH WORLD	Eighth World
Smooth Criminal	Smooth Criminal
Himeji City	Himeji, Hyōgo
Ramsey County North Dakota	Inner Mongolia
Rockwall County (Texas)	Rockwall County, Texas
Isabel do Brasil	Isabel, Princess Imperial of Brazil
North Vietnam	Province of Castellón
OS X Mountain Lion	OS X Mountain Lion
I am here for you	Kimi no Tame ni Boku ga Iru
Riccardo Liddell	Rickard Rydell
DVD	DVD
Suleiman I	Suleiman the Magnificent
Takako Doi	Takako Doi
East Germany	Craig Nicholls
M83 (band)	M83 (band)
Igor Denisov	Igor Denisov
Choctaw County (Mississippi)	Choctaw County, Mississippi
Thomas Rosser	Thomas L. Rosser
Prime Minister of Spain	Prime Minister of Spain
Barclays Center	Barclays Center
Columba	Jonathan Russell
Michael Stanne	Mikael Stanne
Midori (band)	Midori (band)
Adlai E. Stevenson	Adlai Stevenson I
Foolad Mobarake Sepahan FC	Sepahan F.C.
James Bryce	James Bryce, 1st Viscount Bryce
Edmund Muskie	Edmund Muskie
Gabriel de Bergic	Prince Gabriel of Belgium
Hans Modrow	Hans Modrow
Atsumaro Konoe	Konoe Atsumaro
Queens University Belfast	Queen's University Belfast
Hiroyuki Nishijima	Hiroyuki Nishijima
Steve Albini	Steve Albini
European Democratic Party	European Democratic Party
Dipendra of Nepal	Clay County, Tennessee
Perfume	Perfume (Japanese band)
Kyrgyzstan	Kyrgyzstan
Your Host	Tuvan language
lepcha characters	Lepcha alphabet
Montreal	Montreal
Mitsufumi Kanai	Takashi Kanai
Stay by my side	Stay by My Side
Cactus	Cactus (American band)
West Papua	West Papua (province)
hip-hop music	Hip hop music
One Up Ichigo Gyūnyū	Maroš Šefčovič
Tokitoshi Taketomi	Taketomi Tokitoshi
STS-122	STS-122
State of Friuli-Venezia Giulia	Friuli-Venezia Giulia
Russian National Football League	Russian Football National League
Koryomal	Koryo-mar
Georgian Soviet Socialist Republic	Georgian Soviet Socialist Republic
Leo Szilard	Leo Szilard
Abu Diaby	Abou Diaby
Karl I (Emperor of Austria)	Charles I of Austria
Diego Lopez Rodriguez	Diego López Rodríguez
I Ca n't Explain	I Can't Explain
William Maxwell Everts	William M. Evarts
Rock of Gibraltar	Rock of Gibraltar (horse)
John Connolly	John Connally
Frank Kellogg	Frank B. Kellogg
Taketora Ogata	Taketora Ogata
Margherita (Political Party)	Democracy is Freedom – The Daisy
Watching the Wheels	Watching the Wheels
Middlesbrough FC	Middlesbrough F.C.
electro	Electro (music)
Time Warner	Time Warner
Eternal Poetry	The Song Remains the Same (song)
Mudhoney	Derek Warwick
Roxanne	Roxanne (song)
Don't Go Away	Don't Go Away
Neverbend	Never Bend
Mercer County (West Virginia)	Mercer County, West Virginia
Jemtland County	Jämtland County
Atalanta BC	Atalanta B.C.
Chase the Chance	Chase the Chance
Heizo Takenaka	Heizō Takenaka
Angura (band)	Angra (band)
Napalm Death	Napalm Death
Maxim Trankov	Maxim Trankov
Talya	Tulyar
Ile de Bourbon	Ile de Bourbon
Tuscola County (Michigan)	Tuscola County, Michigan
Fergus County (Montana)	Fergus County, Montana
Dennis Rodman	Dennis Rodman
Henri II (King of France)	Henry II of France
Liechtenstein National Football Team	Liechtenstein national football team
Fairplay (Racehorse)	Fair Play (horse)
Giants Stadium	Giants Stadium
Shinroku Momose	Shinroku Momose
Stud Velodrome	Stade Vélodrome
Assassin Creed Series	Assassin's Creed
Yoshinobu Tokugawa	Tokugawa Yoshinobu
Carl Thunberg	Carl Peter Thunberg
Jimmy Eat World	Jimmy Eat World
Little Richard	Little Richard
New York Knicks	New York Knicks
Shamardal	Piece of Mind
Pivotal	Pivotal (horse)
Puerto Rico	Puerto Rico
This Boy	Tongan language
Adecorigaen	Norwegian First Division
Musket (Racehorse)	Musket (horse)
Okazaki City	Okazaki, Aichi
WEEK END	Week End (X Japan song)
Angelo	Angelo (band)
François Hollande	François Hollande
outcast	Outkast
Pittsburgh	Pittsburgh
Athens County (Ohio)	Athens County, Ohio
Buriram United FC	Buriram United F.C.
Province of Castile - La Mancha	Castilla-La Mancha
Northwestern University	Northwestern University
Army of Northern Virginia	Army of Northern Virginia
JESSICA (music)	Jessica (Dir En Grey song)
Luise von Hesse - Kassel	Louise of Hesse-Kassel
Sully County South Dakota	Aiichiro Fujiyama
Pierce County (Washington)	Pierce County, Washington
My Beloved Layla (album)	Layla and Other Assorted Love Songs
Game Boy Color	Game Boy Color
Bush Memorial Stadium	Busch Memorial Stadium
Thomas Osborne 1st Duke of Leeds	Wydad Casablanca
Alfred Terry	Alfred Terry
A Quick One	A Quick One
Run Devil Run	Mr. Taxi
Ormond	Ormonde (horse)
Frigent	Frigento
Swiss Liberal Democratic Party	FDP.The Liberals
Pavel I	Paul I of Russia
Alliance of Liberals and Democrats for Europe Group	Grant County, Washington
Adrian López Alvarez	Adrián López Álvarez
Hirosaki City	Hirosaki, Aomori
Dmitry Medvedev	Dmitry Medvedev
Goat Head Soup	Goats Head Soup
UFC 163	UFC 163
Christian Archibald Herter	Christian Herter
Sarajevo	Sarajevo
Animals	The Animals
Gibson SG	Gibson SG
Karyu	Karyu
Daisuke Sakata	Daisuke Sakata
Manhattan	Manhattan
Oita Prefecture	Ōita Prefecture
Joko Widodo	Joko Widodo
Time (Magazine)	Time (magazine)
STS-42	STS-42
Throckmorton County (Texas)	Throckmorton County, Texas
Salvador	Salvador, Bahia
Yamato Nadeshiko Shichihenge (Manga)	The Wallflower (manga)
Expedition 26	Santa Cruz Futebol Clube
Charles (Prince of Wales)	Charles, Prince of Wales
Morbid Angel	Morbid Angel
Vernon County (Wisconsin)	Vernon County, Wisconsin
George Spencer ( 2nd Earl Spencer)	George Spencer, 2nd Earl Spencer
Maria Theresa	Maria Theresa
Socialist People's Republic of Albania	People's Socialist Republic of Albania
Brent Ward	London Borough of Brent
Santiago de Compostela	Santiago de Compostela
Bosnia-Herzegovina Cup	Bosnia and Herzegovina Football Cup
Khalifa bin Zayed Al Nahyan	Khalifa bin Zayed Al Nahyan
Charles Prince of Wales	Delicious Way
University of Paris	University of Paris
Golden Valley County (Montana)	Golden Valley County, Montana
Huey Lewis & The News	Huey Lewis and the News
Louis Bonaparte	Louis Bonaparte
UEFA European Championship 1984	UEFA Euro 1984
recount	Reigh Count
Bertramy County (Minnesota)	Beltrami County, Minnesota
Omar Bradley	Omar Bradley
Pollutri	Kharosthi
Juha Sipira	Juha Sipilä
Oh Jangeun	Andrew Johnson
The 25th long-term stay	Expedition 25
Vigo	Red River Parish, Louisiana
Siberian Yupik	Central Siberian Yupik language
Kingdom of Naples	Kingdom of Naples
CA Liber Plate	Club Atlético River Plate
Ogemor County (Michigan)	Ogemaw County, Michigan
Richland County (Louisiana)	Richland Parish, Louisiana
Mari Kaieda	Banri Kaieda
Latin	Latin
James Barber	James Barbour
Innocent XI (Pope)	Pope Innocent XI
Kurdish	Kurdish languages
Cyril Neville	Cyril Neville
El Salvador	El Salvador
John A. McClernand	John Alexander McClernand
Flow Rider	Flo Rida
Stay Gold	Heart Station (song)
Broward County (Florida)	Broward County, Florida
Glenn Tipton	Glenn Tipton
Wild Hearts	The Wildhearts
Genoa CFC	Genoa C.F.C.
Okinawa Dialect	Okinawan language
Bossier County (Louisiana)	Bossier Parish, Louisiana
Adolf Hitler	Adolf Hitler
John Quincy Adams	John Quincy Adams
Dale County (Alabama)	Dale County, Alabama
Gomatsu Station	Osong Station
Charles-Maurice de Talleyrand - Perigord	Charles Maurice de Talleyrand-Périgord
The generous	The Generous
Guilty Crown	Guilty Crown
Woops!I Did It Again ( song)	Oops! I Did It Again (song)
Save Me	Save Me (Queen song)
Mohammad Ali Rajai	Mohammad-Ali Rajai
Objective-C	Objective-C
Wasatch County (Utah)	Wasatch County, Utah
Sumter County (Alabama)	Sumter County, Alabama
American Idiot ( song)	American Idiot (song)
Vladimir Putin	Vladimir Putin
Hilary Herbert	Hilary A. Herbert
3rd Ward, Kyoto Prefecture	Kyoto 3rd district
Rusyn	Rusyn language
Warwick (Rhode Island)	Warwick, Rhode Island
Microsoft Windows 8	Windows 8
Flower Bowl	Flower Bowl
Alfred North Whitehead	Alfred North Whitehead
Wilhelm I (King of Württemberg)	William I of Württemberg
Cearer SC	Ceará Sporting Club
Houston County Tennessee	Marcelo Mattos
Edward Seymour ( 1st Duke of Somerset)	Edward Seymour, 1st Duke of Somerset
Happy Rockefeller	Happy Rockefeller
Pius II (Pope)	Pope Pius II
Urbanus V (Pope)	Pope Urban V
Dōshite Kimi o Suki ni Natte Shimattandarō3F	Maurice Allais
Ryan Donk	Ryan Donk
Mika Nakashima	Mika Nakashima
Alexander Lebed	Yoo Young-jin
MacLeod River	McCloud River
Baltic Empire	Swedish Empire
REAL (L'Arc ~ en ~ Ciel album)	Real (L'Arc-en-Ciel album)
Seeking the Gold	Seeking The Gold
Spiritual Beggars	Spiritual Beggars
Pete Townshend	Pete Townshend
Uri Party	Uri Party
William Pinkney	Girls' Generation
Richard Coudenhove - Kalergi	Richard von Coudenhove-Kalergi
Stevie Nicks	Stevie Nicks
PlayStation Store	PlayStation Store
Carolyn Franklin	Carolyn Franklin
Principality of Transylvania	Principality of Transylvania (1570–1711)
saninro	Son-in-Law
French	French people
Makiko Tanaka	Makiko Tanaka
Mojave 3	Mojave 3
Saidanza	Ara (constellation)
Flowers in the Dirt	Flowers in the Dirt
Jonathan Guerreiro	Jonathan Guerreiro
Zalmay Khalilzad	Zalmay Khalilzad
Senate (France)	Senate (France)
Koriyama City	Kōriyama
renho	Renhō
FreeBSD	FreeBSD
UEFA European Championship 1988	UEFA Euro 1988
Dongyi Wu	Wu Den-yih
Do The A-side	Do the A-side
United Football League ( Philippines)	United Football League (Philippines)
Phoenix	Bono
Mexican Army	Mexican Armed Forces
Toyama City	Toyama, Toyama
Chatham County (North Carolina)	Chatham County, North Carolina
Neo Universe	Neo Universe
Goodbye to scarred days	Sayonara Kizu Darake no Hibi yo
Ichinomiya City	Ichinomiya, Aichi
BONNIE PINK	Bonnie Pink
Prefab Sprouts	Prefab Sprout
Osomatsu-kun	Osomatsu-kun
Karl XI (King of Sweden)	Charles XI of Sweden
Christiano da Matta	Cristiano da Matta
Bienville County (Louisiana)	Bienville Parish, Louisiana
Where Does My Heart Beat Now	Province of Sassari
Key Arena	KeyArena
Richard of Shrewsbury ( Duke of York)	Richard of Shrewsbury, Duke of York
Costa Rica	Costa Rica
Solaris	Solaris (operating system)
Hapoel Tel Aviv FC	Hapoel Tel Aviv F.C.
List of Pokémon (152-201)	List of Pokémon (152–201)
Girls Talk	Girl's Talk
2009 G20 Pittsburgh summit	Match II
Roswell L. Gilpatrick	Roswell Gilpatric
Edmunds County (South Dakota)	Edmunds County, South Dakota
UD Las Palmas	UD Las Palmas
Death (Band)	Death (metal band)
Frederick Muhlenberg	Frederick Muhlenberg
Bavarian-Austrian	Bavarian language
Like a star in the night	Like a Star in the Night
Eniwa City	Eniwa, Hokkaido
She's So Unusual	She's So Unusual
Mississippi County (Missouri)	Mississippi County, Missouri
Van Buren County (Arkansas)	Van Buren County, Arkansas
ABBA	ABBA
BMO field	BMO Field
Hieroglyphs	Egyptian hieroglyphs
Imabari City	Imabari, Ehime
Joan Robinson	Joan Robinson
Hu Jintao	Hu Jintao
Azerbaijani	Azerbaijani language
Colorado Springs	Colorado Springs, Colorado
Rodolfo Graziani	Rodolfo Graziani
Butler County (Kansas)	Butler County, Kansas
Linfield FC	Linfield F.C.
Sharice Pempengko	Charice Pempengco
TV Osaka	Television Osaka
El Grand Senor	El Gran Senor
Rock Sand	Houston County, Tennessee
Kamikawa General Promotion Bureau	Kamikawa Subprefecture
Peppin County (Wisconsin)	Pepin County, Wisconsin
Kyoji Yamamoto	Kyoji Yamamoto
First Mariner Arena	Royal Farms Arena
Victoria von Baden	Victoria of Baden
Minoru Yanagida	Minoru Yanagida
LOST	Lost (TV series)
Elizaveta (Emperor of Russia)	Elizabeth of Russia
Die (musician)	Die (musician)
Andre Breton	André Breton
Wilhelm II (Emperor of Germany)	Wilhelm II, German Emperor
Mikazuki Taizo	Taizō Mikazuki
Tokyo Jihen	Real Sociedad
Taiga (Wrapper)	Tyga
Nabataean script	Nabataean alphabet
Vyacheslav Molotov	Vyacheslav Molotov
John Stewart ( 3rd Earl of Bute)	John Stuart, 3rd Earl of Bute
Pitbull (wrapper)	Pitbull (rapper)
PlayStation (game machine)	PlayStation (console)
Anjo City	Anjō
Jasper County (Texas)	Jasper County, Texas
Beijing Chinese Football Club	Beijing Renhe F.C.
Somerset County (Maine)	Somerset County, Maine
Sports (Tokyo Incidents Album)	Sports (Tokyo Jihen album)
Victor Hope ( 2nd Marquess of Linlithgow)	Victor Hope, 2nd Marquess of Linlithgow
Winter fall	Winter Fall
Petingo	Petingo
Pratiba Patil	Pratibha Patil
Bois Roussel	FC Hoverla Uzhhorod
Gyu-ha Choi	Choi Kyu-hah
Henan	Henan
Russia	Russia
Killing Me Softly	Ozomatli
Fist of the North Star	Fist of the North Star
Swain County North Carolina	Andris Bērziņš (Latvian President)
Caldwell County (Missouri)	Caldwell County, Missouri
Lothair Demezier	Lothar de Maizière
Escape (MISIA song)	Escape (Misia song)
Johor Darul Taqzim II FC	Johor Darul Ta'zim II F.C.
UFC 72	UFC 72
Royal Chocolate Flush	Royal Chocolate Flush
The GreensEuropean Free Alliance	Steven N'Zonzi
Eminem	Eminem
Electronic	Electronic (band)
Washington County New York	Sweetness (Misia song)
Basque Chileans	Basque Chilean
City of Bankstown	City of Bankstown
Jacob Zuma	Jacob Zuma
Togon Temur	Toghon Temür
USFC (Rio de Janeiro State)	America Football Club (RJ)
San Augustine County (Texas)	San Augustine County, Texas
Kashima Antlers	Kashima Antlers
Block Party	Bloc Party
Meagher County Montana	Billie Joe Armstrong
Equipoise	Equipoise (horse)
See you tomorrow	Sore dewa, Mata Ashita
Popular Action Party	People's Action Party
Chaffee County (Colorado)	Chaffee County, Colorado
Lawrence County (Tennessee)	Lawrence County, Tennessee
Sogdian script	Sogdian alphabet
Fluminense FC	Fluminense FC
His Sparrow	High Sparrow
Nick Simper	Nick Simper
Takayama City	Takayama, Gifu
Crawford County (Missouri)	Crawford County, Missouri
John Russell ( 4th Duke of Bedford)	John Russell, 4th Duke of Bedford
Pyongyang City Sports Team	Pyongyang City Sports Club
Mullaittivu District	Mullaitivu District
Naofumi Tatsumi	Tatsumi Naofumi
Jeremy Abbott	Jeremy Abbott
Alanno	Native Americans in the United States
SEASONS (Ayumi Hamasaki's music)	Seasons (Ayumi Hamasaki song)
Aphrodite (album)	Aphrodite (album)
Cyprus First Division	Cypriot First Division
Peter Tägtgren	Iakoba Italeli
Soyuz TMA-2	Soyuz TMA-2
Ikuto Hidaka	Ikuto Hidaka
Los Angeles Galaxy	LA Galaxy
Gong (Band)	Gong (band)
Joe Biden	Joe Biden
Proximus League	Belgian Second Division
Ian Pace	Ian Paice
Tomorrow Party of Japan	Benetton B198
K K Downing	Multics
Night Rage	Nightrage
Abdullahim Al - Qib	Abdurrahim El-Keib
University of Leeds	University of Leeds
Helsingborg	Helsingborg
Astrud Gilberto	Astrud Gilberto
Victory (Jacksons album)	Victory (The Jacksons album)
Willem III (King of the Netherlands)	William III of the Netherlands
Feint (Linkin Park song)	Faint (song)
Gregory Mankiw	Greg Mankiw
Changzhou	Changzhou
Southern Expeditionary Army Groupv	Nice
Exeter	Exeter
Citizens	John Wesley Harding (album)
Hana to Yume	Hana to Yume
To your town	Kimi no Machi Made
Kunkakee County (Illinois)	Kankakee County, Illinois
Lefwija SC	Lekhwiya SC
Mitchell County (North Carolina)	Mitchell County, North Carolina
Sargent County (North Dakota)	Sargent County, North Dakota
Fan Club (album)	Fanclub (album)
Amblin Entertainment	Amblin Entertainment
Lancaster (Pennsylvania)	Lancaster, Pennsylvania
Grasshopper Club Zurich	Grasshopper Club Zürich
Haru Sonoda	Kazuharu Sonoda
Kitashirakawanomiya Naruhisa	Prince Naruhisa Kitashirakawa
Capricorn	Capricornus
Somebody to Love	Hideo Ōshima
BBC	Grover Cleveland
Theminstrel	The Minstrel
Nureyev	Nureyev (horse)
Muammar Al - Qaddafi	Muammar Gaddafi
Tijuana Cartel	Tijuana Cartel
Nobuko , Princess Tomohito	Princess Tomohito of Mikasa
Jesus and Mary Chain	The Jesus and Mary Chain
Albert Gonzales	Alberto Gonzales
Soyuz-U2	Soyuz-U2
Dmitry Shepilov	Dmitri Shepilov
Rose of Versailles	The Rose of Versailles
New Approach	New Approach
Watford	Watford
Frostbite (game engine)	Frostbite (game engine)
jet (band)	Jet (band)
Gansu	Gansu
Sam Brownback	Sam Brownback
United Aircraft Manufacturing Company	United Aircraft Corporation
Yesu	Jesu
Whiteside County (Illinois)	Whiteside County, Illinois
New York Yankees	New York Yankees
Slipknot	Slipknot (band)
Stefan Lovven	Stefan Löfven
Junsu	Kim Junsu
Funeral Mist	Funeral Mist
Stephany GriffithJones	Sudan
Benjamin Harrison	Benjamin Harrison
Obituary	Obituary (band)
FC Astra	FC Astra Giurgiu
Lucky Love ( album)	Kylie (album)
Yanosuke Iwasaki	Iwasaki Yanosuke
Flo Rida	Richard Yates (novelist)
Drake (Entertainer)	Drake (rapper)
Mitchell County (Texas)	Mitchell County, Texas
Light up your heart (album)	The Doors (album)
Mladen Ivanich	Mladen Ivanić
Reason (software)	Reason (software)
Campionato Brasileiro Serie B	Campeonato Brasileiro Série B
Ōkami Kakushi	Catch Me (TVXQ song)
SLY	Sly (band)
Ghostbusters	Ghostbusters
New Guinea Island	New Guinea
Mozambique Liberation Front	FRELIMO
Kingfisher	Common kingfisher
Shigenobu Okuma	Ōkuma Shigenobu
MISIA REMIX 2000 LITTLE TOKYO	Misia Remix 2000 Little Tokyo
Lamoille County (Vermont)	Lamoille County, Vermont
Magnoliaceae	Magnoliaceae
Derby County FC	Derby County F.C.
Itami City	Itami, Hyōgo
George Badger	George Edmund Badger
Grand County (Utah)	Grand County, Utah
Munetaka Higuchi	Munetaka Higuchi
Natalja Zabijako	Jersey County, Illinois
Robert Wyatt	Robert Wyatt
Austrian Empire	Austrian Empire
Atessa	Atessa
Trym Torson	Chiptune
John Paul II ( Pope)	Pope John Paul II
Scent of Roses	Stop and Smell the Roses
William Hay ( 18th Earl of Errol)	William Hay, 18th Earl of Erroll
Jack Bruce	Jack Bruce
Yusuke Kondo	Yusuke Kondo
Giuseppe Sarragat	Giuseppe Saragat
Shimbashi Station	Shimbashi Station
Robert Daniel Murphy	Robert Daniel Murphy
George Clinton	George Clinton (vice president)
Hayley Williams	Hayley Williams
Premier Liga	Premier League of Bosnia and Herzegovina
United States Department of State	United States Department of State
Chicago Fire	Chicago Fire Soccer Club
Pampanga Province	Pampanga
Timurid Empire	John Adams
Suicidal Tendencies	Suicidal Tendencies
Western Greece	Western Greece
Jungang Line	Columba (constellation)
8th long-term stay	Expedition 8
San Francisco Giants	San Francisco Giants
Perm Krai	Perm Krai
University of Rochester	University of Rochester
Tehran	Tehran
Russian	Russians
Tsukihime (game)	Tsukihime
Windows Phone	Windows Phone
Expedition 7	Claiborne County, Mississippi
Malcolm McLaren	Malcolm McLaren
Old Italian script	Old Italic script
Yoshitaka Shindo	Yoshitaka Shindō
Caleb Cushing	Caleb Cushing
Cheongryangri Station	Cheongnyangni Station
William Russell Grace	William Russell Grace
IOS (Apple)	IOS
NEVER GONNA GIVE YOU UP	Never Gonna Give You Up (Mai Kuraki song)
Cavalier County (North Dakota)	Cavalier County, North Dakota
Laurence Fournier Baudry	Laurence Fournier Beaudry
Coosa County (Alabama)	Coosa County, Alabama
Friedrich August III ( King of Saxony)	Frederick Augustus III of Saxony
Fragile (Junko Onishi's album)	Fragile (Junko Onishi album)
Terry Stotts	Terry Stotts
Rhythm and Blues	Rhythm and blues
Province of Brescia	Province of Brescia
Haitian	Haitian Creole
Rev Beach	Reb Beach
Zoot Sims	Zoot Sims
Williams FW25	Williams FW25
Pak Bongju	Pak Pong-ju
THE MARROW OF A BONE	The Marrow of a Bone
Sam Bernardo do Campo	São Bernardo do Campo
AFM records	AFM Records
Tadanari Lee	Tadanari Lee
Shasta County (California)	Shasta County, California
Hardin County (Tennessee)	Hardin County, Tennessee
Maria (Queen of Romania)	Marie of Romania
Thank you Kangeki Amestorm	Kansha Kangeki Ame Arashi
Persimmon	Persimmon (horse)
Frederick Howard ( 5th Earl of Carlyle)	Frederick Howard, 5th Earl of Carlisle
Metallica (album)	Metallica (album)
Matilde Dudekem Dako	Queen Mathilde of Belgium
South Ossetia	South Ossetia
Aviva Stadium	Aviva Stadium
Grand Duchess Xenia Alexandrovna of Russia	Leader of the House of Commons
Montefusco	Montefusco
Electropop	Electropop
timeform	Timeform
Yokohama F. Marinos	Yokohama F. Marinos
Pork County (Wisconsin)	Polk County, Wisconsin
Cygnus	Cygnus (constellation)
Viktor Yanukovych	Viktor Yanukovych
Dayak	Dayak people
Giorgio Napolitano	Giorgio Napolitano
Volksparkstadion	Volksparkstadion
Essex County (Vermont)	Essex County, Vermont
Waxie	Waxy (horse)
DJ Premier	DJ Premier
Cheap Trick at Budokan	Cheap Trick at Budokan
Mark Ronson	Mark Ronson
Public Enemy Number One	Public Enemy No. 1 (Megadeth song)
Linat Farkutdinov	Rinat Farkhoutdinov
Doncaster (Racehorse)	Doncaster (horse)
Chowan County (North Carolina)	Chowan County, North Carolina
Bernard I Duke of BrunswickLüneburg	Ohio County, West Virginia
Doctor John	Dr. John
STAR (Mika Nakashima album)	Star (Mika Nakashima album)
apple (album)	Ringo (album)
Italic	Italic languages
Bennington County Vermont	London SS
traffic (band)	Traffic (band)
Hugh Scott	Hugh Scott
West Sumatra	West Sumatra
Flower Travellin ' Band	Flower Travellin' Band
Fumio Kyūma	Hail To Reason
Catherine (Duchess of Cambridge)	Catherine, Duchess of Cambridge
That girl disappeared	She's Out of My Life
Unicoy County (Tennessee)	Unicoi County, Tennessee
Montgomery County Indiana	Edward Bates
City Light Stadium	Sheryl Crow
Memphis (Tennessee)	Memphis, Tennessee
BEST (Mika Nakashima album)	Best (Mika Nakashima album)
Quebec	Quebec
ESPN2	ESPN2
Adventurers (Do As Infinity song)	Bōkenshatachi
Oakland (California)	Oakland, California
Donovan	Donovan
Ibaraki Prefecture	Ibaraki Prefecture
AC Nagano Parceiro	AC Nagano Parceiro
Maria Teresa ( Grand Duchess of Luxembourg)	Maria Teresa, Grand Duchess of Luxembourg
Philippe de Belgic ( Count of Flanders)	Prince Philippe, Count of Flanders
SURREAL	Surreal (song)
Candy feat.Mr. Blistah	Candy (Kumi Koda song)
Simon & Garfunkel	Simon & Garfunkel
William James	William James
State of Rio Grande do Sul	Rio Grande do Sul
FC Barcelona	FC Barcelona
Battle of Belmont	Battle of Belmont
Microsoft Windows 10	Windows 10
Yoshinori Shirakawa	Yoshinori Shirakawa
Liberal Democratic Party (Germany)	Free Democratic Party (Germany)
3 (band)	3 (1980s band)
Oceana County (Michigan)	Oceana County, Michigan
Bob Rock	Bob Rock
Waka Flocka Flame	Waka Flocka Flame
SA (Ami Suzuki's Album)	SA (album)
If It Makes You Happy	If It Makes You Happy
Respect (Otis Redding song)	Respect (song)
Hebrew letters	Hebrew alphabet
Pale Highway	In Color (album)
Dreamin ' of You ( Celine Dion song)	Dreamin' of You (Celine Dion song)
Avengers Assemble ( Soundtrack)	The Avengers (soundtrack)
Soyuz 18a	Soyuz 7K-T No.39
Conquistador Cielo	Conquistador Cielo
Ayrton Dos Santos Ferras	Aílton Ferraz
Dukedom of Holstein	Duchy of Holstein
Vigilius (Pope)	Pope Vigilius
Shutout (Racehorse)	Shut Out (horse)
All Japan F3 Championship	All-Japan Formula Three Championship
Amintre Fanfani	Amintore Fanfani
Woodson County (Kansas)	Woodson County, Kansas
Technical Death Metal	Technical death metal
Cavell County (West Virginia)	Cabell County, West Virginia
East Timor	East Timor
Lewis County (Tennessee)	Lewis County, Tennessee
Columbus Crew Stadium	Mapfre Stadium
Siege of Petersburg	Catahoula Parish, Louisiana
Cornelius	Known Fact
Banolo Mella	Bagnolo Mella
Change the World ( Wynonna Judd song)	Change the World
Nantucket	Nantucket
Slavoy Zizek	Slavoj Žižek
Expedition 13	Charles Gordon-Lennox, 6th Duke of Richmond
Thomas Metcalf	Thomas Metcalfe (Kentucky)
Serbian Purva Liga	Serbian First League
Guangzhou Evergrande Taobao Football Club	Guangzhou Evergrande Taobao F.C.
George Schultz	George P. Shultz
Volleyball	Volleyball
Pestirence	Pestilence (band)
William Paulet ( 1st Marquess of Winchester)	William Paulet, 1st Marquess of Winchester
Miesque	Miesque
Toshinobu Kubota	Toshinobu Kubota
Henry VI (King of England)	Henry VI of England
With all my love	Arittake no Ai de
Willem-Alexander (King of the Netherlands)	Willem-Alexander of the Netherlands
Haim Herzog	Chaim Herzog
CF Pachuca	C.F. Pachuca
Paul Weller	Paul Weller
Bendor	Bend Or
Masahiko Takamura	Masahiko Kōmura
Kingdom of Yugoslavia	Kingdom of Yugoslavia
Glascock County (Texas)	Glasscock County, Texas
Guangdong	Guangdong
Richland County (South Carolina)	Richland County, South Carolina
Sullivan County (Missouri)	Sullivan County, Missouri
Dundee United FC	Dundee United F.C.
Musca	Empire of Brazil
Liverpool	Liverpool
Riccardo Lopez Felipe	Ricardo (footballer, born 1971)
be my guest	Be My Guest (horse)
Danny Pugh	Danny Pugh
Erina Mano	Erina Mano
Nazli Nasir	Nazri Nasir
Berryz Mansion 9th Floor	Berryz Mansion 9kai
BBC Parliament	BBC Parliament
DIVE	Dive
Dark Ronald	Dark Ronald
Chris Sherlock	Chris Sharrock
Imad Al Hosani	Amad Al-Hosni
Marion County (Alabama)	Marion County, Alabama
Italian Army	Italian Army
One Heart ( Song)	One Heart (song)
Ivan Bich	Ivan Bich
Hakubun Shimomura	Nightmare (Japanese band)
Pat Metheny Group	Pat Metheny Group
Quang Ngai Province	Quảng Ngãi Province
Benewa County (Idaho)	Benewah County, Idaho
Dpkg	Dpkg
William Gopalawa	William Gopallawa
Steve Winwood	Steve Winwood
Epic Records Japan	Sony Records
Saint-Martin (West Indies)	Collectivity of Saint Martin
Columbia County New York	Israeli Labor Party
Two Hearts Beat as One	Two Hearts Beat as One
Morgan County (West Virginia)	Morgan County, West Virginia
Institutional Revolutionary Party	Institutional Revolutionary Party
Jacques Chirac	Jacques Chirac
Washburn County (Wisconsin)	Washburn County, Wisconsin
Spain National Football Team	Spain national football team
Battle of Williamsburg	Battle of Williamsburg
Tarja Halonen	Tarja Halonen
Mason County West Virginia	Like a Prayer (album)
Akita Prefecture	Akita Prefecture
Sinister Gates	Synyster Gates
Densetsu no Shōjo	Anthology 1
New Orleans Pelicans	New Orleans Pelicans
Highway of Remembrance 61	Highway 61 Revisited
Hunan Express Line	Honam High Speed Railway
Lord Daemon	Demon Kakka
Nimrod (album)	Nimrod (album)
Nelson County (Virginia)	Nelson County, Virginia
DIABOLOS	Diabolos (Gackt album)
Slint	Slint
Wilhelmina (Dutch Queen)	Wilhelmina of the Netherlands
Kane County (Utah)	Kane County, Utah
with a kind heart	Koisuru Hitomi wa Utsukushii
Beep	Maximum the Hormone
CSX Transportation	CSX Transportation
Sauber C14	Sauber C14
Harry S. Truman	Harry S. Truman
She's A Woman	She's a Woman
Tobay	Torbay
Bavarian language	Carol II of Romania
Separtura	Sepultura
Grainger County (Tennessee)	Grainger County, Tennessee
Shimada Shizuoka	Topper Headon
Jean (Grand Duke of Luxembourg)	Jean, Grand Duke of Luxembourg
Osmanlıspor	Warp (record label)
M (Music by Ayumi Hamasaki)	M (song)
Lafayette County (Mississippi)	Lafayette County, Mississippi
South Asian Football Federation	South Asian Football Federation
UFC 75	UFC 75
NEXT LEVEL (Ayumi Hamasaki's album)	Next Level (Ayumi Hamasaki album)
Ampus	The Amps
University of Maryland, College Park	University of Maryland, College Park
Yoshiro Hayashi	Yoshiro Hayashi (politician)
The Jam	The Jam
Alter Bridge	Alter Bridge
Michael Keaton	Michael Keaton
Sofia (Queen of Greece)	Sophia of Prussia
Washington County (Ohio)	Washington County, Ohio
Kenny Loggins	Kenny Loggins
Granville Lewson - Gore ( 2nd Earl Granville)	Granville Leveson-Gower, 2nd Earl Granville
Archie Bell & The Drells	Archie Bell & the Drells
Slavonic	Slavic languages
1st Marine Division (U.S. Army)	1st Marine Division (United States)
John Lennon Plastic Ono Band	2014 Winter Olympics
Steve Clifford	Steve Clifford
Nino	Hayato Ikeda
Long Away	Long Away
The Great Castle of Harren ( Game of Thrones)	The Ghost of Harrenhal
Hartwall Arena	Hartwall Arena
Miwa	Miwa (singer)
Vyacheslav Trubnikov	Vyacheslav Trubnikov
Janet Rankin	Jeannette Rankin
Najjat Valor - Belkasem	Najat Vallaud-Belkacem
John Young Mason	John Y. Mason
International Monetary Fund	International Monetary Fund
Hans Zimmer	Hans Zimmer
Edge of Sanity	Edge of Sanity
Odense BK	Odense Boldklub
Serino	Serino
John Buchanan Floyd	John B. Floyd
Yoshio Sakurauchi	Yoshio Sakurauchi
Clark Clifford	Clark Clifford
Ferrol	New Jersey
Pixar Animation Studios	Pixar
Google App Engine	Google App Engine
Jet Pilot	Jet Pilot
Alben William Barkley	New Kent County, Virginia
Assumption County (Louisiana)	Assumption Parish, Louisiana
Albanian	Albanian language
KAN	Kan (musician)
Monza	Monza
Nicholas I	Nicholas I of Russia
Sino-Tibetan	Sino-Tibetan languages
Montgomery County (Alabama)	Montgomery County, Alabama
Emily Samuelson	Emily Samuelson
Mikhail Fratkov	Mikhail Fradkov
The Kovenant	Ehud Barak
Philipp Scheidemann	Philipp Scheidemann
HIDE YOUR FACE	Hide Your Face
Ceremonial Oath	Ceremonial Oath
Aozora Pedal	Aozora Pedal
Clinton County (Michigan)	Clinton County, Michigan
Scottish Premiership	Scottish Premiership
Hendry County (Florida)	Hendry County, Florida
Take That	Take That
New York Dolls	New York Dolls
Theatrical	Theatrical (horse)
EC Bahia	Esporte Clube Bahia
Hewlett-Packard	Hewlett-Packard
Brazos County (Texas)	Brazos County, Texas
Luther Vandross	Luther Vandross
Matino	1st Division (Imperial Japanese Army)
Tiffany Vice	Tiffany Vise
Akira Taue	Toni Braxton
Soseki Natsume	Natsume Sōseki
Red Star FC93	Red Star F.C.
Ernst Mach	Ernst Mach
Labor Party (UK)	Labour Party (UK)
Yuyuki Hamaguchi	Osachi Hamaguchi
Generation X (band)	Generation X (band)
Awesome Again	Awesome Again
Monmouth County (New Jersey)	Monmouth County, New Jersey
What I can do for you (GACKT's song)	Kimi no Tame ni Dekiru Koto
Meteor Rocket	Ryūsei Rocket
AlAhli Dubai FC	Min Chinese
Geneva County (Alabama)	Geneva County, Alabama
Peter Gustav Dirichlet	Peter Gustav Lejeune Dirichlet
Zentaro Kosaka	Zentaro Kosaka
Spanish Socialist Labor Party	Spanish Socialist Workers' Party
Estadio Nacional Julio Martínez Prádanos	Belfast
XTC (band)	XTC
Holmes County (Ohio)	Holmes County, Ohio
Italian Democratic Socialist Party	Italian Democratic Socialist Party
Taurus Rocket	Minotaur-C
Amharic	Amharic
First Love (Hikaru Utada's Album)	First Love (Utada Hikaru album)
Faramond	Pharamond II
Good Girl Gone Bad	Good Girl Gone Bad
Sporting de Gijón	Sporting de Gijón
Bali	Bari
Johnny Buckland	Jonny Buckland
Emperor Genmei	Empress Genmei
Rhythm zone	Rhythm Zone
Alfred Duke of SaxeCoburg and Gotha	Baroque (Junko Onishi album)
Ministry of Finance (Japan)	Ministry of Finance (Japan)
CAN'T BUY MY LOVE	Can't Buy My Love
Minority (song)	Minority (Green Day song)
Worrelik	War Relic
Andrew Jackson	Andrew Jackson
Fender (musical instrument maker)	Fender Musical Instruments Corporation
Libertarian Party (USA)	Libertarian Party (United States)
George Zweig	George Zweig
Social Democratic Party of Lithuaniavv	Kinokawa, Wakayama
Germanics	Germanicus
