Palestinian Territory, Occupied			Palestinian territories
Ali Ardashir Larijani			Ali Larijani
Yemeni Armed Forces			Republic of Yemen Armed Forces
Lee Myung Bak			Lee Myung-bak
Kim Jong-Il			Kim Jong-il
Sheikh Hasina Wajed			Sheikh Hasina
North Atlantic Treaty Organization			NATO
Mikhail Saakashvili			Mikheil Saakashvili
Joseph Robinette Biden			Joe Biden
Anatolian Agency			Anadolu Agency
Bharatiya Janata			Bharatiya Janata Party
Francois Fillon			François Fillon
Mohammed Salem Basindwa			Mohammed Basindawa
L.K. Advani			L. K. Advani
Vitaly Ivanovich Churkin			Vitaly Churkin
Benedict XVI			Pope Benedict XVI
Israeli Defense Forces			Israel Defense Forces
Kim Jong-Un			Kim Jong-un
Nabil el-Araby			Nabil Elaraby
Yousaf Raza Gilani			Yousaf Raza Gillani
Pakistan People's Party			Pakistan Peoples Party
Mohammad Najib Abdul Razak			Najib Razak
Emperor Akihito			Akihito
Jayalalithaa			J. Jayalalithaa
Mohammad-Reza Rahimi			Mohammad Reza Rahimi
Sergey Viktorovich Lavrov			Sergey Lavrov
Shavkat Mirziyayev			Shavkat Mirziyoyev
Omurbek Babanov			Ömürbek Babanov
Central Bank of the Islamic Republic of Iran			Central Bank of Iran
John Paul II			Pope John Paul II
Chaudhry Nisar Ali Khan			Chaudhary Nisar Ali Khan
Abdelkader Taleb Oumar			Abdelkader Taleb Omar
Muammar al-Qaddafi			Muammar Gaddafi
Al Haq			Al-Haq
Nuri al-Maliki			Nouri al-Maliki
Tariq Al-Hashimi			Tariq al-Hashimi
Transitional Federal Government			Transitional federal government, Republic of Somalia
Ranil Wickremasinghe			Ranil Wickremesinghe
Kim Hwang Sik			Kim Hwang-sik
Indian Administered Kashmir			Kashmir
Exxon Mobil			ExxonMobil
Chen Shui Bian			Chen Shui-bian
Maghreb Arabe Presse			Maghreb Arabe Press
General Association of Korean Residents in Japan			Chongryon
Viktor Orban			Viktor Orbán
Doctors Without Borders			Médecins Sans Frontières
Su Chia-chyuan			Su Jia-chyuan
Abd al-Rab Mansur al-Hadi			Abdrabbuh Mansur Hadi
Grand National Party			Liberty Korea Party
Coalition for Democratic Unity			Democratic Unity Roundtable
Ban Ki Moon			Ban Ki-moon
Saud bin Faisal bin Abdul-Aziz			Saud bin Faisal bin Abdulaziz Al Saud
Xinhua			Xinhua News Agency
Imedi TV			Imedi Media Holding
Isaias Afewerki			Isaias Afwerki
Efrain Alegre			Efraín Alegre
Angel Aguirre Rivero			Ángel Aguirre Rivero
Kengo Wa Dondo			Léon Kengo wa Dondo
Akali Dal			Shiromani Akali Dal
Trade Union Congress			Trades Union Congress
Alain Juppe			Alain Juppé
Sergei Borisovich Ivanov			Sergei Ivanov
Iranian Parliament			Islamic Consultative Assembly
Salva Kiir			Salva Kiir Mayardit
Yayi Boni			Thomas Boni Yayi
Desiré Delano Bouterse			Dési Bouterse
Bala Abdulkadir Mohammed			Bala Mohammed
Charity Kaluki Ngilu			Charity Ngilu
Hizb-e Islami			Hezbi Islami
Jordan Times			The Jordan Times
Palaniappan Chidambaram			P. Chidambaram
Michel Joseph Martelly			Michel Martelly
Ellen Johnson-Sirleaf			Ellen Johnson Sirleaf
Babatunde Raji Fashola			Babatunde Fashola
Suleiman Franjieh			Suleiman Frangieh
Daily Trust			Media Trust
Ibrahim Badamasi Babangida			Ibrahim Babangida
Republican People's Party			Republican People's Party (Turkey)
William ole Ntimama			William Ole Ntimama
Terry Davis			Terry A. Davis
Executive Office of the President			Executive Office of the President of the United States
ANC Youth League			African National Congress Youth League
Ronald Muwenda Mutebi II			Muwenda Mutebi II of Buganda
Gambia			The Gambia
Non Partisan Solidarity Union			Non-Partisan Solidarity Union
World Food Program			World Food Programme
Armed Forces of the Republic of Armenia			Armed Forces of Armenia
Beverley J. Oda			Bev Oda
Riad Salameh			Riad Salamé
Tanigaki Sadakazu			Sadakazu Tanigaki
Prayuth Chan-ocha			Prayut Chan-o-cha
Abdul Kalam			A. P. J. Abdul Kalam
Cote d'Ivoire			Ivory Coast
Ashfaq Pervez Kayani			Ashfaq Parvez Kayani
Party of Free Life of Kurdistan			Kurdistan Free Life Party
Alejandro Poiré			Alejandro Poiré Romero
Jakarta Post			The Jakarta Post
Sir David Richards			David Richards, Baron Richards of Herstmonceux
Hassan al-Turabi			Hassan Al-Turabi
Kim Yong Nam			Kim Yong-nam
Dimitris Christofias			Demetris Christofias
Dervis Eroglu			Derviş Eroğlu
Ekmeleddin Ihsanoglu			Ekmeleddin İhsanoğlu
Emomalii Rahmon			Emomali Rahmon
Paulo de Sacadura Cabral Portas			Paulo Portas
Bronislaw Komorowski			Bronisław Komorowski
Taslima Nasreen			Taslima Nasrin
Jose Maria Figueres Olsen			José María Figueres
Abdullah bin Abdulaziz al-Saud			Abdullah of Saudi Arabia
Umkhonto we Sizwe			UMkhonto we Sizwe
Eric Besson			Éric Besson
Kundy Pahiama			Kundi Paihama
Jose Eduardo Dos Santos			José Eduardo dos Santos
Sergey Stanishev			Sergei Stanishev
Felipe Calderon			Felipe Calderón
Valerie Amos			Valerie Amos, Baroness Amos
Middle East News Agency			MENA (news)
Gholamali Haddad Adel			Gholam-Ali Haddad-Adel
Jacob Gedleyihlekisa Zuma			Jacob Zuma
Patrice Emery Trovoada			Patrice Trovoada
Anders Breivik			Anders Behring Breivik
Mariano Rajoy Brey			Mariano Rajoy
Juan Carlos I			Juan Carlos I of Spain
Bülent Arinç			Bülent Arınç
Sheikh Hamad bin Khalifa al-Thani			Hamad bin Khalifa Al Thani
Alexei Leonidovich Kudrin			Alexei Kudrin
Muqtada Al-Sadr			Muqtada al-Sadr
Saadeddine El Othmani			Saadeddine Othmani
Ashraf Ghani Ahmadzai			Ashraf Ghani
Carlos Gomes Junior			Carlos Gomes Júnior
International Commission Against Impunity in Guatemala			International Commission against Impunity in Guatemala
Al Wefaq National Islamic Society			Al Wefaq
Vicente Fox Quesada			Vicente Fox
Porfirio Lobo			Porfirio Lobo Sosa
Kim Jong-Nam			Kim Jong-nam
United Nations Children's Fund			UNICEF
Nelson Rolihlahla Mandela			Nelson Mandela
Democratic Republic of Congo			Democratic Republic of the Congo
S.M. Krishna			S. M. Krishna
Kembo Dugish Campbell Mohadi			Kembo Mohadi
Jean-Jacques Demafouth			Jean-Jacques Démafouth
International Federation of Human Rights			International Federation for Human Rights
Chaudhry Shujaat Hussain			Shujaat Hussain
Petroperu			Petroperú
OR Tambo International Airport			O. R. Tambo International Airport
High Commission for Refugees			United Nations High Commissioner for Refugees
José Manuel Durão Barroso			José Manuel Barroso
Danilo Turk			Danilo Türk
Department of State			United States Department of State
Victorian Supreme Court			Supreme Court of Victoria
Mostafa Mohammad Najjar			Mostafa Mohammad-Najjar
Malaysian People's Party			Parti Rakyat Malaysia
Boris Tadic			Boris Tadić
al-Qaeda in the Islamic Maghreb			Al-Qaeda in the Islamic Maghreb
Hafiz Mohammad Saeed			Hafiz Saeed
Revolutionary Guards			Islamic Revolutionary Guard Corps
Shahbaz Sharif			Shehbaz Sharif
Mikulas Dzurinda			Mikuláš Dzurinda
Slovak Democratic and Christian Union			Slovak Democratic and Christian Union – Democratic Party
Martin E. Dempsey			Martin Dempsey
Abdiweli Mohamed Ali			Abdiweli Gaas
Bachana Akhalaia			Bacho Akhalaia
Djibouti National Army			Djiboutian Army
Rabiu Musa Kwankwaso			Rabiu Kwankwaso
Mobinil			Orange Egypt
Panhellenic Socialist Movement			PASOK
Josefina Vazquez Mota			Josefina Vázquez Mota
Encana			Ovintiv
Environmental Protection Agency			United States Environmental Protection Agency
Senate Appropriations Committee			United States Senate Committee on Appropriations
Barbara A. Mikulski			Barbara Mikulski
Mallam Isa Yuguda			Isa Yuguda
ANGOP			Angola Press News Agency
Babangida Aliyu			Mu'azu Babangida Aliyu
Olympia J. Snowe			Olympia Snowe
Karim Masimov			Karim Massimov
Christian Democrat Party of Chile			Christian Democratic Party (Chile)
National United Front for Democracy Against Dictatorship			United Front for Democracy Against Dictatorship
Anna Maria Bligh			Anna Bligh
Aminu Tambuwal			Aminu Waziri Tambuwal
Saif al-Islam al-Qaddafi			Saif al-Islam Gaddafi
Titus Corlatean			Titus Corlățean
Susan Elizabeth Rice			Susan Rice
Ivo Josipovic			Ivo Josipović
Navy Seals			United States Navy SEALs
Jose Sarney			José Sarney
Ali al-Dabbagh			Ali Aldabbagh
Mobile Company of Iran			Mobile Telecommunication Company of Iran
Chibuike Rotimi Amaechi			Rotimi Amaechi
Muslimin Sema			Mus Sema
Huanqiu Shibao			Global Times
Nazrul Islam			Kazi Nazrul Islam
Mostafa Ahmadi Roshan			Mostafa Ahmadi-Roshan
Gennady Andreyevich Zyuganov			Gennady Zyuganov
Norov Altankhuyag			Norovyn Altankhuyag
K.P. Singh			Kushal Pal Singh
Marc Isaiah Grossman			Marc Grossman
Filip Vujanovic			Filip Vujanović
Milan Rocen			Milan Roćen
Mark Malloch Brown			Mark Malloch Brown, Baron Malloch-Brown
Radoslaw Sikorski			Radosław Sikorski
Chinese Communist Party			Communist Party of China
Edward Michael Balls			Ed Balls
New Vision			New Vision (newspaper)
Terje Roed Larsen			Terje Rød-Larsen
Sayeeda Hussain Warsi			Sayeeda Warsi, Baroness Warsi
National Civil Police			National Civil Police of El Salvador
Thabo Mvuyelwa Mbeki			Thabo Mbeki
Joaquin Lavin			Joaquín Lavín
Democratic United Party			Democratic Party (South Korea, 2011)
Gloria Macapagal-Arroyo			Gloria Macapagal Arroyo
Lee Teng Hui			Lee Teng-hui
Organization for Security and Cooperation in Europe			Organization for Security and Co-operation in Europe
Branimir Glavas			Branimir Glavaš
Okada Katsuya			Katsuya Okada
Irsen Küçük			İrsen Küçük
Milo Djukanovic			Milo Đukanović
Vasif Talybov			Vasif Talibov
Mujiv Sabbihi Hataman			Mujiv Hataman
Slavko Linic			Slavko Linić
Viktor Alekseyevich Zubkov			Viktor Zubkov
José Antonio Meade Kuribreña			José Antonio Meade
Catalin Predoiu			Cătălin Predoiu
Ibrahim Shehu Shema			Ibrahim Shema
Nguyen Phu Trong			Nguyễn Phú Trọng
Paul Berenger			Paul Bérenger
Nkosazana Dlamini Zuma			Nkosazana Dlamini-Zuma
Julian Paul Assange			Julian Assange
Truong Tan Sang			Trương Tấn Sang
Czeslaw Kiszczak			Czesław Kiszczak
Beti Kamya			Beti Kamya-Turwomwe
Sonangol			Sonangol Group
Massoud Barzani			Masoud Barzani
Nonaligned Movement			Non-Aligned Movement
Yevgeny Maksimovich Primakov			Yevgeny Primakov
Otto Perez Molina			Otto Pérez Molina
Chaudhry Ahmed Mukhtar			Ahmad Mukhtar
Genaro Garcia Luna			Genaro García Luna
88 Generation Students			88 Generation Students Group
Al Quds al Arabi			Al-Quds Al-Arabi
Daniel Lipsic			Daniel Lipšic
Ján Figel			Ján Figeľ
European Community			European Communities
Mohammad Mohaqiq			Muhammad Mohaqiq
Rauf Denktas			Rauf Denktaş
Sheikh Saif Bin Zayed Al Nahyan			Saif bin Zayed Al Nahyan
Australia Greens			Australian Greens
Andres Pastrana Arango			Andrés Pastrana Arango
Han Myung Sook			Han Myeong-sook
Qabus ibn Sa`id			Qaboos bin Said
Sankei			Sankei Shimbun
Cable News Network			CNN
Besir Atalay			Beşir Atalay
Court of Cassation			Court of cassation
Samson Kagengo Ongeri			Sam Ongeri
Jamaat-ud-Dawa			Lashkar-e-Taiba
Sheikh Ahmed bin Saeed Al Maktoum			Ahmed bin Saeed Al Maktoum
Samajwadi Janata Party			Samajwadi Janata Party (Rashtriya)
Fernando Armindo Lugo Méndez			Fernando Lugo
Michael Andrew Gove			Michael Gove
Internal Macedonian Revolutionary Organization - Democratic Party for Macedonian National Unity			VMRO-DPMNE
Republic of South Ossetia			South Ossetia
Grigory Alexeyevich Yavlinsky			Grigory Yavlinsky
Bangladesh Student League			Bangladesh Chhatra League
Laurent Kabila			Laurent-Désiré Kabila
Tenzin Gyatso			14th Dalai Lama
Jose Luis Rodriguez Zapatero			José Luis Rodríguez Zapatero
Faure Gnassingbe			Faure Gnassingbé
Nguyen Thien Nhan			Nguyễn Thiện Nhân
Gary Faye Locke			Gary Locke
Yang Hyong Sop			Yang Hyong-sop
Vincent C. Siew			Vincent Siew
Ján Kubis			Ján Kubiš
Vladimir Volfovich Zhirinovsky			Vladimir Zhirinovsky
Theodore Ahamefule Orji			Theodore Orji
Olafur Ragnar Grimsson			Ólafur Ragnar Grímsson
Ejup Ganic			Ejup Ganić
Erelu Olusola Obada			Olusola Obada
Queen Beatrix			Beatrix of the Netherlands
Ioan Mircea Pascu			Ioan Mircea Pașcu
Mikhail Sergeyevich Gorbachev			Mikhail Gorbachev
Boiko Borisov			Boyko Borisov
Robert E. Rubin			Robert Rubin
Grigory Borisovich Karasin			Grigory Karasin
Ivan Gasparovic			Ivan Gašparovič
Ricardo Alarcón de Quesada			Ricardo Alarcón
Joseph Benedict "Joe" Hockey			Joe Hockey
Jason C. Hu			Jason Hu
Chun Doo Hwan			Chun Doo-hwan
Erap Estrada			Joseph Estrada
Jerry John Rawlings			Jerry Rawlings
New Komeito Party			Komeito
Hawa Abdulrahman Ghasia			Hawa Ghasia
Aloizio Mercadante			Aloízio Mercadante
Choe Yong Rim			Choe Yong-rim
Daniel Bruce Poneman			Daniel Poneman
Lindiwe Nonceba Sisulu			Lindiwe Sisulu
National Bank of Eritrea			Bank of Eritrea
Martin Torrijos			Martín Torrijos
Jorge Arguello			Jorge Argüello
Bahamas			The Bahamas
USAID			United States Agency for International Development
GRU			GRU (G.U.)
Edward Ngoyai Lowassa			Edward Lowassa
Party of the Revolution			Chama Cha Mapinduzi
Kan Naoto			Naoto Kan
Slovak Information Service			Slovenská informačná služba
Chang Po Ya			Chang Po-ya
Kenya Commercial Bank			KCB Bank Kenya Limited
Faiza Abu Naga			Faiza Abou el-Naga
Alison Manani Magaya			Alison Magaya
Organization for Economic Cooperation and Development			OECD
Ibrahim Agboola Gambari			Ibrahim Gambari
Giulio Terzi			Giulio Terzi di Sant'Agata
Phung Quang Thanh			Phùng Quang Thanh
Elizardo Sanchez			Elizardo Sánchez
Nana Addo Dankwa Akufo-Addo			Nana Akufo-Addo
Tawakel Karman			Tawakkol Karman
Uhuru Muigai Kenyatta			Uhuru Kenyatta
Nguyen Van Ly			Thadeus Nguyễn Văn Lý
Jejomar Binay, Jr.			Jejomar Binay Jr.
Maria Eugenia Vidal			María Eugenia Vidal
Carlos Alberto Lopes			Carlos Lopes
Pedro Antonio Marín			Manuel Marulanda
Segolene Royal			Ségolène Royal
Manuel Fraga Iribarne			Manuel Fraga
Ro Tu Chol			Ro Tu-chol
Ronald K. Noble			Ronald Noble
Rashid Meredov			Raşit Meredow
M.K. Narayanan			M. K. Narayanan
E.S.L. Narasimhan			E. S. L. Narasimhan
Ramzan Akhmadovich Kadyrov			Ramzan Kadyrov
Rwandan Defence Forces			Rwanda Defence Force
Freundel Jerome Stuart			Freundel Stuart
Boris Efimovich Nemtsov			Boris Nemtsov
Dmitry Olegovich Rogozin			Dmitry Rogozin
Friends Of The Earth			Friends of the Earth
Doku Khamatovich Umarov			Dokka Umarov
New Centre			The Centrists
Tony Tan Keng Yam			Tony Tan
Irina Khalip			Iryna Khalip
Syed Ashraful Islam			Sayed Ashraful Islam
Statoil			Equinor
Park Tae Joon			Park Tae-joon
Olabode Ibiyinka George			Bode George
American University in Cairo			The American University in Cairo
ITAR TASS			TASS
Arun K. Singh			Arun Kumar Singh
Andrey Vorobyov			Andrey Yuryevich Vorobyov
Domestic Policy Council			United States Domestic Policy Council
Yunus-Bek Yevkurov			Yunus-bek Yevkurov
Ronald Kirk			Ron Kirk
Francisco Labastida Ochoa			Francisco Labastida
M.P. Singh			Mahendra Pal Singh
UN General Assembly			United Nations General Assembly
Umar Farooq			Umar
Jeffrey Thamsanqa Radebe			Jeff Radebe
Wall Street Journal			The Wall Street Journal
Jerusalem Post			The Jerusalem Post
Izvestiya			Izvestia
Tuilaepa Sailele Malielegaoi			Tuilaepa Aiono Sailele Malielegaoi
Pakistan administered Kashmir			Kashmir
National Election Committee			National Election Committee of Cambodia
Felipe Larraín			Felipe Larraín Bascuñán
Balarabe Musa			Abdulkadir Balarabe Musa
Vijay Nambiar			Vijay K. Nambiar
Iranian Oil Company			National Iranian Oil Company
Prasad Rao			K. V. P. Rao
Alvaro Uribe Velez			Álvaro Uribe
Kim Daejung			Kim Dae-jung
National Democratic Institute for International Affairs			National Democratic Institute
Libya TV			Libya Al Ahrar TV
Ananda			Ānanda
Obiageli Ezekwesili			Oby Ezekwesili
Adrian Nastase			Adrian Năstase
Achmad Sukarno			Sukarno
Letsie III			Letsie III of Lesotho
John Chang			Chiang Hsiao-yen
Aliyu Akwe Doma			Aliyu Doma
Nebojsa Radmanovic			Nebojša Radmanović
Sean R. Parnell			Sean Parnell
Sergey Yevgenyevich Naryshkin			Sergey Naryshkin
South West Africa People's Organization			SWAPO
University of Swaziland			University of Eswatini
Anwar as-Sadat			Anwar Sadat
Secretariat of Communications and Transportation			Secretariat of Communications and Transportation (Mexico)
Times of India			The Times of India
Mizengo Kayanza Peter Pinda			Mizengo Pinda
The Royal Bank of Scotland Group			Royal Bank of Scotland Group
Timor-Leste			East Timor
Richard G. Lugar			Richard Lugar
Robert B. Zoellick			Robert Zoellick
Jyllands Posten			Jyllands-Posten
Otunba Gbenga Daniel			Gbenga Daniel
Vadim Vladimirovich Brovtsev			Vadim Brovtsev
Jim Wallace			Jim Wallace, Baron Wallace of Tankerness
Saad al-Katatni			Saad El-Katatni
Ignatious Chombo			Ignatius Chombo
International Labor Organization			International Labour Organization
Rafiq Hariri			Rafic Hariri
Vladislav Yuryevich Surkov			Vladislav Surkov
Bank of Brazil			Banco do Brasil
Eric Woerth			Éric Woerth
Henry Chimunthu Banda			Chimunthu Banda
CARE International			CARE (relief agency)
Belisario Betancur Cuartas			Belisario Betancur
Riyad al-Malki			Riyad al-Maliki
Eric H. Holder			Eric Holder
Amara Konneh			Amara Mohamed Konneh
Military Intelligence Service			Military Intelligence Service (United States)
Armando Rios Piter			Armando Ríos Piter
Haqqani Network			Haqqani network
La Francophonie			Organisation internationale de la Francophonie
Cardinal Health Inc.			Cardinal Health
Hishamuddin Hussein			Hishammuddin Hussein
Ansar al-Sunnah			Jamaat Ansar al-Sunna
Sowetan			The Sowetan
Bernard Kamillius Membe			Bernard Membe
Georgi Purvanov			Georgi Parvanov
Ayesha al-Gaddafi			Ayesha Gaddafi
Karunanidhi			M. Karunanidhi
Mariano Ferreyra			Murder of Mariano Ferreyra
Tigran Sarkisyan			Tigran Sargsyan
Pravind Kumar Jugnauth			Pravind Jugnauth
Salim Hoss			Selim Hoss
Swami Agnivesh			Agnivesh
Khairat El-Shater			Khairat el-Shater
U.S. Republican Party			Republican Party (United States)
Finnish Broadcasting Company			Yle
Genaro Gongora Pimentel			Genaro David Góngora
Hassan Shah-Safi			Hassan Shahsafi
Sheikh Ali Salman			Ali Salman
Sushil Kumar			Sushil Kumar (wrestler)
Philip H. Gordon			Philip Gordon
David Bakradze			Davit Bakradze
Shamsudeen Usman			Shamsuddeen Usman
Kasymzhomart Tokayev			Kassym-Jomart Tokayev
Lenin Moreno			Lenín Moreno
Nestor Kirchner			Néstor Kirchner
Mihai-Razvan Ungureanu			Mihai Răzvan Ungureanu
Russian Foreign Intelligence Service			Foreign Intelligence Service (Russia)
Mehdi Karrubi			Mehdi Karroubi
Juan Carlos Mendoza			Juan Carlos Mendoza García
Andrew David Lansley			Andrew Lansley
Sergey Kuzhugetovich Shoygu			Sergey Shoygu
Department of Commerce			United States Department of Commerce
Mohamed Waheed Hassan			Mohammed Waheed Hassan
Al Qaeda in the Arabian Peninsula			Al-Qaeda in the Arabian Peninsula
Vladimir Meciar			Vladimír Mečiar
Filipe Jacinto Nhussi			Filipe Nyusi
Hussein Ali Mwinyi			Hussein Mwinyi
Emad Eddine Abdel-Ghaffour			Emad Abdel Ghaffour
Anatoliy Eduardovich Serdyukov			Anatoliy Serdyukov
Ahmed Mohamed Silanyo			Ahmed Mohamed Mohamoud
Organization of African Unity			Organisation of African Unity
Turkish Army			Turkish Land Forces
Marta Teresa Smith de Vasconcelos Suplicy			Marta Suplicy
Peter Shanel Agovaka			Peter Shannel Agovaka
DPWH			Department of Public Works and Highways
Baurzhan Mukhamedzhanov			Bauyrzhan Mukhamedzhanov
Antonio Paulo Kassoma			Paulo Kassoma
Security Council of the Russian Federation			Security Council of Russia
Vincent Cable			Vince Cable
Minority Rights Group			Minority Rights Group International
Alexander Vladimirovich Konovalov			Aleksandr Konovalov (politician, born 1968)
Farooq H. Naek			Farooq Naek
Stefan Harabin			Štefan Harabin
Greek Parliament			Hellenic Parliament
Samuel Zbogar			Samuel Žbogar
Alliance for Justice and Democracy/Movement for Renewal			Alliance for Justice and Democracy%2FMovement for Renewal
Tomas Yarrington			Tomás Yarrington
Slobodan Milosevic			Slobodan Milošević
Anatoliy Mohyliov			Anatolii Mohyliov
Ansar ash-Shari'a			Al-Qaeda in the Arabian Peninsula
Anwar Al-Awlaki			Anwar al-Awlaki
Yasir Arafat			Yasser Arafat
Ingrid Betancourt Pulecio			Íngrid Betancourt
United Iraqi Alliance			National Iraqi Alliance
Wycliffe Musalia Mudavadi			Musalia Mudavadi
Daniel Arap Moi			Daniel arap Moi
Korean Workers Party			Workers' Party of Korea
Tamil Tigers			Liberation Tigers of Tamil Eelam
FEMEN			Femen
Laura Inés Pollán Toledo			Laura Pollán
Eduard Kokoyty			Eduard Kokoity
Sergey Vladilenovich Kiriyenko			Sergey Kiriyenko
Lulama Marytheresa Xingwana			Lulama Xingwana
Luis Carlos Restrepo			Luis Carlos Restrepo Ramírez
Manuel Domingos Vicente			Manuel Vicente
Mahmoud Saleh			Mahmoud Hassan Saleh
Alliance for the Republic-Yakaar			Alliance for the Republic (Senegal)
Lal Krishna Advani			L. K. Advani
Timothy Dolan			Timothy M. Dolan
Decebal Traian Remes			Decebal Traian Remeș
Zoran Djindjic			Zoran Đinđić
World Organization Against Torture			World Organisation Against Torture
Ahmed el-Tayeb			Ahmad al-Tayyeb
Vojislav Kostunica			Vojislav Koštunica
Gaidis Berzins			Gaidis Bērziņš
Interparliamentary Union			Inter-Parliamentary Union
Marcos Valério Fernandes de Souza			Marcos Valério
Milos Zeman			Miloš Zeman
Danbaba Danfulani Suntai			Danbaba Suntai
Park Chung Hee			Park Chung-hee
Alexander Vasilyevich Bortnikov			Alexander Bortnikov
U.S. Forces Korea			United States Forces Korea
Benjamin William Mkapa			Benjamin Mkapa
Bangko Sentral			Bangko Sentral ng Pilipinas
Bola Ahmed Tinubu			Bola Tinubu
Zlatko Lagumdzija			Zlatko Lagumdžija
Irakli Ghudushauri-Shiolashvili			Ilia II of Georgia
Chatib Basri			Muhamad Chatib Basri
Dusan Caplovic			Dušan Čaplovič
Nguyen Thi Kim Ngan			Nguyễn Thị Kim Ngân
Sam Rainsy Party			Candlelight Party
Hadi Al-Amiri			Hadi al-Amiri
Hoang Trung Hai			Hoàng Trung Hải
National Security and Defense Council			National Security and Defense Council of Ukraine
Thongloun Sisoulit			Thongloun Sisoulith
Syarhey Sidorski			Sergei Sidorsky
Hocine Ait Ahmed			Hocine Aït Ahmed
Sheikh Mukhtar Robow			Mukhtar Robow
Martina Dalic			Martina Dalić
Ivan Miklos			Ivan Mikloš
John Dramani Mahama			John Mahama
Saudi National Guard			Saudi Arabian National Guard
Joker Paz Arroyo			Joker Arroyo
Swiss Federal Council			Federal Council (Switzerland)
Sergiy Tigipko			Serhiy Tihipko
Sunday Times			The Sunday Times
A.B. Bardhan			Ardhendu Bhushan Bardhan
Nikolay Vasilyevich Fyodorov			Nikolay Fyodorov (politician)
Carmen M. Martinez			Carmen Maria Martinez
Martin Sabbatella			Martín Sabbatella
Thiha Thura Tin Aung Myint Oo			Tin Aung Myint Oo
Sebastião Afonso Viana Macedo Neves			Tião Viana
Eric Solheim			Erik Solheim
Verizon			Verizon Communications
Dahou Ould Kablia			Daho Ould Kablia
Emirates Telecommunications Corporation			Etisalat
The Cape Times			Cape Times
Gibran Bassil			Gebran Bassil
National Assembly of Angola			National Assembly (Angola)
Vuong Dinh Hue			Vương Đình Huệ
U.S. Pacific Fleet			United States Pacific Fleet
Richard C. Shelby			Richard Shelby
G7			Group of Seven
Cnooc Limited			China National Offshore Oil Corporation
Daily Graphic			The Daily Graphic
Andras Simor			András Simor
Joao Miranda			João Bernardo de Miranda
Bantubonke Harrington Holomisa			Bantu Holomisa
CPPCC National Committee			Chinese People's Political Consultative Conference
Abdiqasim Salad Hassan			Abdiqasim Salad
Abu Bakar Bashir			Abu Bakar Ba'asyir
Joseph Sinde Warioba			Joseph Warioba
Macao			Macau
Swami Ramdev			Ramdev
José Pimentel			José Barroso Pimentel
Kenichiro Sasae			Kenichirō Sasae
Charles Ndaxu Namoloh			Charles Namoloh
Wolfgang Priklopil			Natascha Kampusch
Nikolay Mladenov			Nickolay Mladenov
Ingrid Roxana Baldetti Elias			Roxana Baldetti
World Wildlife Fund			World Wide Fund for Nature
Norton Schwartz			Norton A. Schwartz
Maha Chakri Sirindhorn			Sirindhorn
Manuchehr Mottaki			Manouchehr Mottaki
Nagorno-Karabakh Republic			Republic of Artsakh
France Telecom			Orange S.A.
Shanghai Cooperation Organization			Shanghai Cooperation Organisation
Charles Mwando Nsimba			Charles Mwando Simba
Syed Naveed Qamar			Naveed Qamar
Lee Hoi Chang			Lee Hoi-chang
Canadian Red Cross Society			Canadian Red Cross
Boris Abramovich Berezovsky			Boris Berezovsky (businessman)
Syrian Liberation Army			Idlib Martyrs' Brigade
Dani Yatom			Danny Yatom
Zalmay Mamozy Khalilzad			Zalmay Khalilzad
Front for Patriotic Resistance in Ituri			Patriotic Resistance Front of Ituri
Kgalema Petrus Motlanthe			Kgalema Motlanthe
Mikhail Borisovich Khodorkovsky			Mikhail Khodorkovsky
Eduardo Alfredo Fellner			Eduardo Fellner
Patriotic Movement of Cote d'Ivoire			Patriotic Movement of Côte d'Ivoire
Jan Muhammad Jamali			Jan Mohammad Jamali
Federico Mayor			Federico Mayor Zaragoza
Devinder Singh			Davinder Singh (field hockey)
Pinnacle Airlines			Endeavor Air
Webster Kotiwani Shamu			Webster Shamu
Kadré Désiré Ouedraogo			Kadré Désiré Ouédraogo
Republican Force			Fuerza Republicana
Philémon Yunji Yang			Philémon Yang
Faustin Archange Touadera			Faustin-Archange Touadéra
Anna Maria Cancellieri			Annamaria Cancellieri
Henri Konan Bedie			Henri Konan Bédié
Bangladesh Communist Party			Communist Party of Bangladesh
Maharashtrawadi Gomantak			Maharashtrawadi Gomantak Party
V. Prabhakaran			Velupillai Prabhakaran
Himalayan Times			The Himalayan Times
Dominique De Villepin			Dominique de Villepin
United States Pacific Command			United States Indo-Pacific Command
Jomo Gbomo			Henry Okah
Tehrik-i-Taliban			Tehrik-i-Taliban Pakistan
Marcelo Bezerra Crivella			Marcelo Crivella
Geir H. Haarde			Geir Haarde
Conocophillips			ConocoPhillips
Irena Degutiene			Irena Degutienė
Humanist Party			Humanist International
Nigeria Customs Service			Nigerian Customs Service
Ford Motor			Ford Motor Company
Cesar Gaviria Trujillo			César Gaviria
Alberto Cárdenas Jiménez			Alberto Cárdenas
United Civil Party			United Civic Party of Belarus
Ronald Nash			Ronald H. Nash
Jung Hong-won			Chung Hong-won
Milan Panic			Milan Panić
Senate Foreign Relations Committee			United States Senate Committee on Foreign Relations
Yogyakarta Special Region			Special Region of Yogyakarta
Victor Gbeho			James Victor Gbeho
Paquito Ochoa, Jr.			Paquito Ochoa Jr.
Francois Mitterrand			François Mitterrand
Turkish Industrialists' and Businessmen's Association			Turkish Industry and Business Association
Mauricio Cárdenas			Mauricio Cárdenas Santamaría
Bank of Sudan			Central Bank of Sudan
Lawrence H. Summers			Lawrence Summers
Brookings Institute			Brookings Institution
Luis Miguel Castilla			Miguel Castilla
Benigno R. Fitial			Benigno Fitial
Abdul Karim al-Iryani			Abd Al-Karim Al-Iryani
Tabare Vazquez			Tabaré Vázquez
Chui Sai On			Fernando Chui
Islami Chhatra Shibir			Bangladesh Islami Chhatra Shibir
Sulejman Tihic			Sulejman Tihić
Dragan Covic			Dragan Čović
Ram Paswan			Ram Vilas Paswan
Roh Moo Hyun			Roh Moo-hyun
Coalition of the Radical Left			Syriza
Chung Un Chan			Chung Un-chan
al-Aqsa Martyrs' Brigades			Al-Aqsa Martyrs' Brigades
De Beers Group			De Beers
Garry Kimovich Kasparov			Garry Kasparov
Kyung-wha Kang			Kang Kyung-wha
Paurine Mpariwa			Paurina Mpariwa
Ahmad Chalabi			Ahmed Chalabi
Gustavo Perez			Gustavo Pérez
Baath Party			Ba'ath Party
Keit Pentus			Keit Pentus-Rosimannus
Carlos Eduardo de Sousa Braga			Eduardo Braga
Disney			The Walt Disney Company
Otton Solis Fallas			Ottón Solís
Mikhail Mikhailovich Kasyanov			Mikhail Kasyanov
Willy Lam			Willy Wo-Lap Lam
Víctor Quispe Palomino			Comrade José
Thomas Joseph Ridge			Tom Ridge
Horacio Rodriguez Larreta			Horacio Rodríguez Larreta
Blairo Borges Maggi			Blairo Maggi
Luis Alberto Heber			Luis Alberto Héber
Kim Yong Chun			Kim Yong-chun
The Daily Mirror			Daily Mirror
Jorge Visbal			Jorge Visbal Martelo
Robert Douglas Nicholson			Rob Nicholson
José Ángel Córdova Villalobos			José Ángel Córdova
Thokozani Khupe			Thokozani Khuphe
African Development Fund			African Development Bank
Daniel Fernando Filmus			Daniel Filmus
Liberty Institute			First Liberty Institute
Nicholas Hugh Minchin			Nick Minchin
Juan Manuel Oliva Ramírez			Juan Manuel Oliva
Manuel Chaves González			Manuel Chaves (politician)
Hizb ut Tahrir			Hizb ut-Tahrir
Prachanda			Pushpa Kamal Dahal
Pope Shenouda III			Pope Shenouda III of Alexandria
Hipolito Mejia			Hipólito Mejía
Baba Suwe			Babatunde Omidina
Ferdinand Marcos, Jr.			Bongbong Marcos
Democratic Union of Hungarians in Romania			Democratic Alliance of Hungarians in Romania
Samdech Chea Sim			Chea Sim
Uganda Police Force			Uganda National Police
Danjuma Goje			Mohammed Danjuma Goje
Alhaji Minkailu Mansaray			Minkailu Mansaray
Sri Mulyani Indrawati			Sri Mulyani
Jabhat al-Nusra			Al-Nusra Front
Luisa Ortega			Luisa Ortega Díaz
Movement of Nigeriens for Justice			Niger Movement for Justice
Pagan Amum Okech			Pagan Amum
Harare International Airport			Robert Gabriel Mugabe International Airport
Sushil Kumar Shinde			Sushilkumar Shinde
Philippos Sachinidis			Filippos Sachinidis
Gaudensia Kabaka			Gaudentia Kabaka
Algerian People's National Army			Algerian People's National Armed Forces
Tigrayan People's Liberation Front			Tigray People's Liberation Front
Mara Salvatrucha			MS-13
Ross Stores Inc.			Ross Stores
Standard Chartered Bank			Standard Chartered
Economic and Monetary Community of Central Africa			Economic Community of Central African States
Dimitry Shashkin			Dimitri Shashkini
Cristovam Ricardo Cavalcanti Buarque			Cristovam Buarque
Hazem El-Beblawi			Hazem El Beblawi
South Sudan Legislative Assembly			National Legislative Assembly (South Sudan)
Ngöbe Buglé			Ngäbe-Buglé Comarca
Hewlett-packard			Hewlett-Packard
Carter F. Ham			Carter Ham
Kuwaiti Navy			Kuwait Naval Force
Panlop Pinmanee			Pallop Pinmanee
Federation Council of Russia			Federation Council (Russia)
Padraig Flynn			Pádraig Flynn
Fiji Labor Party			Fiji Labour Party
Anglogold Ashanti			AngloGold Ashanti
Jonathan Mance			Jonathan Mance, Baron Mance
Fessehaye Yohannes			Fesshaye Yohannes
Sorin Frunzaverde			Sorin Frunzăverde
Jetblue			JetBlue
Ansar-e-Hezbollah			Ansar-e Hezbollah
Nehru University			Jawaharlal Nehru University
Robert Menendez			Bob Menendez
Xavier Luc Duval			Xavier-Luc Duval
African Medical and Research Foundation			Amref Health Africa
Sir Anerood Jugnauth			Anerood Jugnauth
Viviana Diaz			Viviana Díaz
Donald J. Johnston			Don Johnston
Ranko Krivokapic			Ranko Krivokapić
V.K. Saraswat			V. K. Saraswat
Government of Singapore Investment Corporation			GIC Private Limited
Raul Gonzalez			Raúl (footballer)
Miguel De La Madrid			Miguel de la Madrid
Francis J. Ricciardone			Francis J. Ricciardone Jr.
Democratic Turnhalle Alliance			Popular Democratic Movement
Shin Corp			Intouch Holdings
Sang-Hyun Song			Song Sang-hyun
Teva Pharmaceutical			Teva Pharmaceutical Industries
Saudi Basic Industries Corporation			SABIC
Stipe Mesic			Stjepan Mesić
Constantine Chiwenga			Constantino Chiwenga
Trinidad and Tobago Express			Trinidad Express Newspapers
Iurie Leanca			Iurie Leancă
State Oil Company of Azerbaijan Republic			SOCAR
Miroslav Lajcak			Miroslav Lajčák
Eduardo Villanueva			Eddie Villanueva
Pattani United Liberation Organization			Patani United Liberation Organisation
La Línea			La Línea de la Concepción
Milan Kucan			Milan Kučan
Oxfam International			Oxfam
Yusuf Mohammed Siad			Yusuf Indhacade
J.S. Verma			J. S. Verma
National Diet of Japan			National Diet
Lech Kaczynski			Lech Kaczyński
Medtronic Inc.			Medtronic
Enrique Ricardo Lewandowski			Ricardo Lewandowski
U.S. Forces Japan			United States Forces Japan
Hubert Alexander Ingraham			Hubert Ingraham
Federal Electricity Commission			Comisión Federal de Electricidad
Jóhanna Sigurdardóttir			Jóhanna Sigurðardóttir
Tomas Borge			Tomás Borge
BHP Billiton			BHP
Chang Song Taek			Jang Song-thaek
Valeriy Ivashchenko			Valeriy Ivaschenko
Lionel Frost Bowen			Lionel Bowen
Vladimir Igorevich Kozhin			Vladimir Kozhin
Le Hong Anh			Lê Hồng Anh
International Freedom of Expression Exchange			IFEX (organization)
James M. Inhofe			Jim Inhofe
Swaziland Youth Congress			People's United Democratic Movement
Robert Ace Barbers			Ace Barbers
Enrique Valentín Iglesias García			Enrique V. Iglesias
Abdul'ahat Abdulrixit			Ablet Abdureshit
Sihanouk			Norodom Sihanouk
Mehmet Agar			Mehmet Ağar
Nyamdorj			Tsendiin Nyamdorj
Oracle Corp			Oracle Corporation
Mehmet Simsek			Mehmet Şimşek
HINA			Croatian News Agency
Alexander Khetaguri			Aleksandre Khetaguri
Cesar Ham			César Ham
National Security Intelligence Service			National Intelligence Service (Kenya)
Nasser Al-Kidwa			Nasser al-Qudwa
Diego Fernandez de Cevallos			Diego Fernández de Cevallos
Josip Manolic			Josip Manolić
Nancy J. Powell			Nancy Jo Powell
Andrew Mark Cuomo			Andrew Cuomo
Sprint Nextel			Sprint Corporation
United Nigeria Peoples Party			United Nigeria People's Party
République solidaire			United Republic
Ismat Abbasov			Ismat Abasov
Jorge Serrano Elias			Jorge Serrano Elías
Ahmad Bukhari			Ahmed Bukhari
Ralph Gonzalez Recto			Ralph Recto
K.C. Pant			K. C. Pant
United Nations Educational, Scientific and Cultural Organization			UNESCO
Mario Aburto Martinez			Mario Aburto Martínez
Nguyen Minh Triet			Nguyễn Minh Triết
Kim Yong Il			Kim Yong-il
Tanzania Electric Supply Company Limited			TANESCO
Mathurin Coffi Nago			Mathurin Nago
Ahmed Qureia			Ahmed Qurei
Crown Prince Haakon			Haakon, Crown Prince of Norway
J.J. Singh			J. J. Singh
Tanzania Investment Bank			TIB Development Bank
Gerald Otieno Kajwang			Otieno Kajwang
Yohei Kono			Yōhei Kōno
Ahmed Mohammed Makarfi			Ahmed Makarfi
Nasdaq OMX			Nasdaq, Inc.
Constitutional Court of the Slovak Republic			Constitutional Court of Slovakia
Awn Shawkat Al-Khasawneh			Awn Al-Khasawneh
Carlos Saul Menem			Carlos Menem
Mary Karoro Okurut			Mary Karooro Okurut
Al Massae			Al-Massae
Valery Giscard d'Estaing			Valéry Giscard d'Estaing
Alan Garcia			Alan García
Valeriy Khoroshkovsky			Valeriy Khoroshkovskyi
Mohammad Zia-ul-Haq			Muhammad Zia-ul-Haq
Czech Television			Česká televize
FLEC			Front for the Liberation of the Enclave of Cabinda
Student Islamic Movement of India			Students Islamic Movement of India
Orascom Construction Industries			Orascom Construction
Turkish Navy			Turkish Naval Forces
South African Municipal Workers Union			South African Municipal Workers' Union
Otto Guevara Guth			Otto Guevara
Chen Chien-Jen			Chen Chien-jen
Mladen Ivanic			Mladen Ivanić
Miguel Zubiri			Juan Miguel Zubiri
Theophilus Yakubu Danjuma			Theophilus Danjuma
Frank Mulholland			Frank Mulholland, Lord Mulholland
Perarivalan			A. G. Perarivalan
The Daily Nation			Daily Nation
Astrazeneca			AstraZeneca
Basil Pesambili Mramba			Basil Mramba
La Nacion			La Nación
Consultative Assembly of Oman			Consultative Assembly (Oman)
Boris Vyacheslavovich Gryzlov			Boris Gryzlov
Sarabjeet Singh			Sarabjit Singh
Islamic Salvation Army			Islamic Salvation Front
National Indian Foundation			Fundação Nacional do Índio
Syed Ghous Ali Shah			Ghous Ali Shah
Flying Tiger			Flying Tigers
Salauddin			Abdulla Kurd
Eduardo Matarazzo Suplicy			Eduardo Suplicy
Carl XVI Gustaf			Carl XVI Gustaf of Sweden
Soeharto			Suharto
ACT Party			ACT New Zealand
Abdelkarim Zebidi			Abdelkarim Zbidi
Corina Creţu			Corina Crețu
Odein Ajumogobia			Henry Odein Ajumogobia
Queen Sofia of Spain			Queen Sofía of Spain
José Antonio Gómez			José Antonio Gómez Urrutia
Daily Sangram			The Daily Sangram
Economic and Social Commission for Asia and the Pacific			United Nations Economic and Social Commission for Asia and the Pacific
Senate Intelligence Committee			United States Senate Select Committee on Intelligence
Massoud Ali Mohammadi			Assassination of Masoud Alimohammadi
