SaintJosephdeColeraine	SaintJosephdeColeraine Quebec
Self Portrait	Self Portrait
Alliance of liberals and democrats for Europe	Alliance of Liberals and Democrats for Europe Party
Wallon	Walloon language
Android	Android
Part II	Part II
Civic choice for Italy	Civic Choice
Tommy Jakobsen	Tommy Jakobsen
Expedition 46	Expedition 46
Sugababes	Sugababes
Abel Goumba	Abel Goumba
I Feel for You	I Feel for You
All Hope Is Gone	All Hope Is Gone
Hans Hoogervorst	Hans Hoogervorst
List of Central African Heads of State	List of heads of state of the Central African Republic
Aleh Antonenka	Oleg Antonenko
Grue	Grus
APOEL Nicosie	APOEL FC
SaintFrédéric	SaintFrédéric Quebec
Euskal Herria Bildu	EH Bildu
Country rock	Country rock
Federal President	President of Germany
Dragon Ball	Dragon Ball
Muhammad Ali Jinnah	Muhammad Ali Jinnah
Mircea Geoană	Mircea Geoană
Rugby Calvisano	Rugby Calvisano
Owl City	Owl City
Antonio Inoki	Antonio Inoki
Scots	Scots language
Pennsylvania State University	Pennsylvania State University
MörikenWildegg	MörikenWildegg
Darkthrone	Darkthrone
Mame Madior Boye	Mame Madior Boye
Pearl Jam	Pearl Jam
Northern Mariana Islands	Northern Mariana Islands
Arrondissement de SaintDenis	Arrondissement of SaintDenis SeineSaintDenis
LacMinistuk	LacMinistuk Quebec
Doin It Right	Doin It Right
Yasuo Fukuda	Yasuo Fukuda
Where Is My Mind3F	Where Is My Mind3F
George Harrison	George Harrison
Brock Adams	Brock Adams
Pop psychédélique	Psychedelic pop
Oudenarde	Oudenaarde
June 2012 Greek legislative elections	Greek legislative election June 2012
A Question of Lust	A Question of Lust
Manuel Deodoro da Fonseca	Deodoro da Fonseca
Front pour la victorie	Front for Victory
Charles Rogier	Charles Rogier
Laurent de GouvionSaintCyr	Laurent de Gouvion SaintCyr
Halmstad	Halmstad
SainteFlorence	SainteFlorence Quebec
Mike McConnell	John Michael McConnell
Ignace de Loyola	Ignatius of Loyola
HC Lev Prague	HC Lev Praha
Russians	Russians
Party Sequence	Party Sequence
Gaspard Fauteux	Gaspard Fauteux
Kóstas Karamanlís	Kostas Karamanlis
Roberto Bellarosa	Roberto Bellarosa
Point de suture	Point de suture
Mary McAleese	Mary McAleese
Henning Christophersen	Henning Christophersen
Greece Football Championship 20132014	201314 Superleague Greece
Royaumes francs	Francia
Le Mans	Le Mans
JeanLouis Roux	JeanLouis Roux
England team football hopes	England national under21 football team
Frank Klepacki	Frank Klepacki
Bailliage of Guernsey	Guernsey
Michel Foucault	Michel Foucault
Gare de Nittedal	Nittedal Station
Reincarnated	Reincarnated
Macedonia football team	Macedonia national football team
Anke Fuchs	Anke Fuchs
Durbuy	Durbuy
Shōichi Nakagawa	Shōichi Nakagawa
Rex Brown	Rex Brown
TheoBen Gurirab	TheoBen Gurirab
Juho Kusti Paasikivi	Juho Kusti Paasikivi
Pô	Po
Barry OFarrell	Barry OFarrell
MarieBéatrice de Modène	Archduchess Maria Beatrix of AustriaEste
Agence universitaire de la Francophonie	Agence universitaire de la Francophonie
Fluminense Football Club	Fluminense FC
MarieBarbara de Portugal	Barbara of Portugal
Coupe des clubs champions europeans 19561957	195657 European Cup
George Prevost	George Prévost
Garage rock	Garage rock
Étienne Macdonald	Jacques MacDonald
Roots rock	Roots rock
Batgirl	Batgirl
SaintStanislas	SaintStanislas Mauricie Quebec
Midwest rap	Midwest hip hop
STS90	STS90
SaintMichel	SaintMichel Quebec
FC Barcelona B	FC Barcelona B
Martin Růžička	Martin Růžička
Akihito	Akihito
Chiang Chingkuo	Chiang Chingkuo
IshratulIbad Khan	Ishratul Ibad
Panayótis Kouroumblís	Panagiotis Kouroumblis
This Is the Last Time	This Is the Last Time
Assens	Assens Switzerland
Valeri Korzoune	Valery Korzun
Thrashcore	Thrashcore
Norman E Thagard	Norman Thagard
Clermont Foot 63	Clermont Foot
Thomas Bangalter	Thomas Bangalter
Kingdom of Bohemia	Kingdom of Bohemia
Baudouin	Baudouin of Belgium
AntoineLabelle	AntoineLabelle Regional County Municipality
Granges	Grenchen
Cry of Achilles	Cry of Achilles
Popular Movement	Peoples Movement
Coventry City Football Club	Coventry City FC
The Last Time	The Last Time
Reuss	Reuss
Brian Lawton	Brian Lawton
MarieIsabelle of Spain	María Isabella of Spain
Ramsay MacDonald	Ramsay MacDonald
Ligue nationale de hockey	National Hockey League
Martin Garrix	Martin Garrix
Mexican War of Independence	Mexican War of Independence
Black Cherry	Black Cherry
Vanha Munkkiniemi	Vanha Munkkiniemi
University of Nebraska at Lincoln	University of NebraskaLincoln
A Momentary Lapse of Reason	A Momentary Lapse of Reason
This Picture	This Picture
MTV Unplugged	MTV Unplugged
Pet Sounds	Pet Sounds
Nicaragua	Nicaragua
Pierre Werner	Pierre Werner
Leopold II of Toscane	Leopold II Grand Duke of Tuscany
Kashiwa Reysol	Kashiwa Reysol
Socialist Party of Albania	Socialist Party of Albania
Robert Curbeam	Robert Curbeam
Senate	Senate of the Parliament of the Czech Republic
José Miaja	José Miaja
The Lazy Song	The Lazy Song
Arash	Arash
Willy Brandt	Willy Brandt
Herbie Hancock	Herbie Hancock
José Sócrates	José Sócrates
Bob Kane	Bob Kane
University of New York	New York University
Victor Hugo de Azevedo Coutinho	Victor Hugo de Azevedo Coutinho
Coupe de la Ligue francaise de football 20052006	200506 Coupe de la Ligue
Nino Bourdjanadze	Nino Burjanadze
The Crusaders	The Crusaders
Oh Land	Oh Land
Erotica	Erotica
Moshe Katsav	Moshe Katsav
Prism	Prism
PoitouCharentes	PoitouCharentes
Pierre III dAragon	Peter III of Aragon
Tarō Asō	Tarō Asō
Gary Locke	Gary Locke
CarolineAuguste de Bavière	Caroline Augusta of Bavaria
Amenhotep III	Amenhotep III
Mikkeli	Mikkeli
Christian Democratic Union of Germany	Christian Democratic Union of Germany
JacquesNicolas BillaudVarenne	Jacques Nicolas BillaudVarenne
Étienne Maurice Gérard	Étienne Maurice Gérard
Animals	Animals
Viktor Yanoukovych	Viktor Yanukovych
Adam Svoboda	Adam Svoboda
Francisco Franco	Francisco Franco
Afghan War	SovietAfghan War
HansPeter Friedrich	HansPeter Friedrich
Enema of the State	Enema of the State
Hustlin	Hustlin
Real Love	Real Love
HC Pardubice	HC Pardubice
Reload	Reload
I Feel You	I Feel You
Ohio	Ohio River
LanguedocRoussillonMidiPyrénées	LanguedocRoussillonMidiPyrénées
Epica	Epica
Salerno	Salerno
Bing Crosby	Bing Crosby
Syriac	Syriac language
Antoine de Bourbon	Antoine of Navarre
Shaquille ONeal	Shaquille ONeal
Tom Verlaine	Tom Verlaine
JosephAlfred Mousseau	JosephAlfred Mousseau
Viktor Fasth	Viktor Fasth
Postdisco	Postdisco
Roman Herzog	Roman Herzog
Le Lombard	Le Lombard
SaintLiboire	SaintLiboire Quebec
Montreux	Montreux
Sony Computer Entertainment	Sony Computer Entertainment
I Cant Explain	I Cant Explain
44	44
University of Kansas	University of Kansas
Club Atlético River Plate	Club Atlético River Plate
Hägglingen	Hägglingen
Ryan Tedder	Ryan Tedder
Dušan Petrović	Dušan Petrović
Saison 8 de XFiles	The XFiles
Angel	Angel
Dorval	Dorval
Édouard Mortier	Édouard Mortier duc de Trévise
Hannah Montana 2	Hannah Montana 2
Wen Jiabao	Wen Jiabao
Gottlob Frege	Gottlob Frege
Jozua François Naudé	Jozua François Naudé
Jacques Santer	Jacques Santer
Dark Horse Comics	Dark Horse Comics
Franz Ferdinand	Franz Ferdinand
Michel Aoun	Michel Aoun
Justice League of America	Justice League
	
Anthrax	Anthrax
Rada	Verkhovna Rada
Bob Carr	Bob Carr
Under the Mistletoe	Under the Mistletoe
Wojtek Wolski	Wojtek Wolski
Fringe	Fringe
Esteghlal Tehran Football Club	Esteghlal FC
West Ryder Pauper Lunatic Asylum	West Ryder Pauper Lunatic Asylum
Nakhla	Nakhla Algeria
NotreDamedesPrairies	NotreDamedesPrairies Quebec
Jean Lannes	Jean Lannes
Victory	Victory
Carabiniers à cheval	CarabiniersàCheval
Károly Grósz	Károly Grósz
Shannon	Shannon Quebec
President of Mongolia	President of Mongolia
Tatsuo Kawabata	Tatsuo Kawabata
All My Life	All My Life
Assembly of the Republic	Assembly of the Republic
Orelsan	Orelsan
Leeds United Football Club	Leeds United FC
Vincent Massey	Vincent Massey
Hong Kong	Hong Kong
John Northcott	John Northcott
Only a Northern Song	Only a Northern Song
HC Bílí Tygři Liberec	HC Bílí Tygři Liberec
Uzbekistan	Uzbekistan
Microscope	Microscopium
Stan	Stan
André Bettencourt	André Bettencourt
Denis Coderre	Denis Coderre
Ghana	Ghana
Simon  Schuster	Simon  Schuster
Martin Johnson	Martin Johnson
Leo Tindemans	Leo Tindemans
Roberto Venturini	Roberto Venturini
Ride	Ride
Dinosaur Jr	Dinosaur Jr
SaintDidace	SaintDidace Quebec
Team of Morocco olympic of football	Morocco national under23 football team
Sandis Ozoliņš	Sandis Ozoliņš
Im Down	Im Down
Denis Diderot	Denis Diderot
03 Bonnie  Clyde	03 Bonnie  Clyde
Kurt Waldheim	Kurt Waldheim
Lose Yourself to Dance	Lose Yourself to Dance
Orléans	Orléans
Boris Gulko	Boris Gulko
SainteGenevièvedeBatiscan	SainteGenevièvedeBatiscan Quebec
Myles Kennedy	Myles Kennedy
Music	Music
Falkirk Football Club	Falkirk FC
Lyon olympique universitaire	Lyon OU
García Hurtado de Mendoza	García Hurtado de Mendoza 5th Marquis of Cañete
Włodzimierz Cimoszewicz	Włodzimierz Cimoszewicz
Every Breath You Take	Every Breath You Take
Kingdom of Congress	Congress Poland
Marie Anne Victoire dEspagne	Mariana Victoria of Spain
Carlo Scognamiglio	Carlo Scognamiglio
We Can Work It Out	We Can Work It Out
Albert Grey	Albert Grey 4th Earl Grey
STS80	STS80
Spit It Out	Spit It Out
Bleu noir	Bleu Noir
Oliver Palotai	Oliver Palotai
Guèze	Geez language
AIK Fotboll	AIK Fotboll
Mexico football team	Mexico national football team
Sibir Novosibirsk	HC Sibir Novosibirsk
Bliss	Bliss
Girl	Girl
Jack Kemp	Jack Kemp
One of These Days	One of These Days
Michael Rupp	Michael Rupp
Thomas D Jones	Thomas David Jones
FIFA Clubs World Cup	FIFA Club World Cup
SainteAnnedelaRochelle	SainteAnnedelaRochelle Quebec
DITC	Diggin in the Crates Crew
La Conception	La Conception Quebec
Drain You	Drain You
Alexander Stubb	Alexander Stubb
Gujarat	Gujarat
Maybe Im Amazed	Maybe Im Amazed
Davy Jones	Davy Jones
Georges Ier de Saxe	George King of Saxony
Allen Toussaint	Allen Toussaint
PFC Lokomotiv Plovdiv	PFC Lokomotiv Plovdiv
Atlas	Atlas
Music	Music
Feel My Mind	Feel My Mind
Charles Fitzpatrick	Charles Fitzpatrick
University of Saskatchewan	University of Saskatchewan
Starfire	Starfire
William Jervois	William Jervois
Queen of HipPop	Queen of HipPop
Frederick C Weyand	Frederick C Weyand
Frederic III	Frederick III Holy Roman Emperor
George Forbes	George Forbes
Samoa	Samoa
BP	BP
The Diplomats	The Diplomats
Kingdom of Prussia	Kingdom of Prussia
Lemieux	Lemieux Quebec
German empire	German Empire
Little 15	Little 15
Francesco Cossiga	Francesco Cossiga
JeandeDieu Soult	JeandeDieu Soult
Noise pop	Noise pop
Fernando de la Rúa	Fernando de la Rúa
Midnight Memories	Midnight Memories
Les Robots	I Robot
Nile Rodgers	Nile Rodgers
Reise Reise	Reise Reise
Room 12	Chambre 12
John Torchetti	John Torchetti
Apollo 8	Apollo 8
Gare de BordeauxSaintJean	Gare de BordeauxSaintJean
Xbox Live	Xbox Live
Southern Lord Records	Southern Lord Records
G William Miller	G William Miller
Óscar Carmona	Óscar Carmona
Jakarta	Jakarta
Ligue des champions de la CAF	CAF Champions League
Canton de Neuchâtel	Canton of Neuchâtel
Ottoman Dynasty	Ottoman dynasty
John Churchill	John Churchill 1st Duke of Marlborough
Pontiac Montana	Pontiac Montana
Chamber of Deputies of Argentina	Argentine Chamber of Deputies
AlsaceChampagneArdenneLorraine	AlsaceChampagneArdenneLorraine
StonehamandTewkesbury	StonehametTewkesbury
Lahti	Lahti
Udo Dirkschneider	Udo Dirkschneider
Mercier	Mercier
GrandesPiles	GrandesPiles Quebec
Yang Shangkun	Yang Shangkun
Yenisei	Yenisei River
Da Funk	Da Funk
Polish United Workers Party	Polish United Workers Party
The Cure	The Cure
Everlast	Everlast
Organization of the people of SouthWest Africa	SWAPO
Long Tall Sally	Long Tall Sally
Chuck Berry	Chuck Berry
Government Ciorbea	Ciorbea I Cabinet
New Center	New Centre
Li Yuanhong	Li Yuanhong
LanguedocRoussillon	LanguedocRoussillon
Vinnie Paz	Vinnie Paz
Takeo Fukuda	Takeo Fukuda
White Room	White Room
The Miracle	The Miracle
SeineSaintDenis	SeineSaintDenis
Justin Williams	Justin Williams
Murcia	Murcia
Limousin	Limousin
Jon Tester	Jon Tester
Desi Bouterse	Dési Bouterse
Robyn	Robyn
Finland football team	Finland national football team
Fighting Saints du Minnesota	Minnesota Fighting Saints
HansChristoph Seebohm	HansChristoph Seebohm
Circle Bruges KSV	Cercle Brugge KSV
To Lose My Life	To Lose My Life
Racing de Santander	Racing de Santander
NewCaledonia	New Caledonia
Horace Porter	Horace Porter
Cupe de la Ligue anglaise de football 20142015	201415 Football League Cup
Jalal Talabani	Jalal Talabani
Placebo	Placebo
Laila Freivalds	Laila Freivalds
Renaud Donnedieu de Vabres	Renaud Donnedieu de Vabres
Karl Rove	Karl Rove
Mario Marois	Mario Marois
SaintCléophas	SaintCléophas Quebec
Chevrolet S10 Blazer	Chevrolet S10 Blazer
Bakir Izetbegović	Bakir Izetbegović
Cleveland	Cleveland Quebec
Samuel Schmid	Samuel Schmid
Bordeaux Metropolis	Bordeaux Métropole
Princeton University	Princeton University
Osijek	Osijek
Britpop	Britpop
Second Republic of Hungary	Second Hungarian Republic
Taddea Visconti	Taddea Visconti
SummerSlam	SummerSlam
Hungary	Hungary
Love and Honey	Love  Honey
Caesar A Rodney	Caesar Augustus Rodney
Portugal football team under 17 years	Portugal national under17 football team
Forel	Forel Vaud
Uruguay football team	Uruguay national football team
Congo belge	Belgian Congo
United Soccer League	United Soccer League
Rob Dougan	Rob Dougan
Cest chic	Cest Chic
Championnat dAlgérie de football D2 20142015	201415 Algerian Ligue Professionnelle 2
Disclosure	Disclosure
Ferdinand I of Aragon	Ferdinand I of Aragon
Jeanne Ire la Folle	Joanna of Castile
Diácono João Luiz Pozzobon	Diácono João Luiz Pozzobon
Turnhout	Turnhout
Othmarsingen	Othmarsingen
Lech Kaczyński	Lech Kaczyński
Harri Holkeri	Harri Holkeri
Likud	Likud
LacErnest	LacErnest Quebec
NotreDamedelaSalette	NotreDamedelaSalette Quebec
Alex Turner	Alex Turner
Maracana Stadium	Maracanã Stadium
The Sweet Escape	The Sweet Escape
LMFAO	LMFAO
Igor Sergeyev	Igor Sergeyev
Foxy Brown	Foxy Brown
Yukio Hatoyama	Yukio Hatoyama
Timothy Pickering	Timothy Pickering
Union sportive arlequins perpignanais	USA Perpignan
Big Thing	Big Thing
Silver Side Up	Silver Side Up
Angela Merkel	Angela Merkel
Rap God	Rap God
Virden	Virden Manitoba
Alcalá de Henares	Alcalá de Henares
Burbank	Burbank California
Sa Zhenbing	Sa Zhenbing
Craig Ramsay	Craig Ramsay
Stanley Cavell	Stanley Cavell
Uppsala	Uppsala
Valentin Lebedev	Valentin Lebedev
Pakistan	Pakistan
Viktor Afanassiev	Viktor Afanasyev
Seven Nation Army	Seven Nation Army
Volbeat	Volbeat
Eastern Finland	Eastern Finland Province
Hyper Music Feeling Good	Hyper Music Feeling Good
Atifete Jahjaga	Atifete Jahjaga
Dallas Eakins	Dallas Eakins
Bilbao	Bilbao
Chevelure de Bérénice	Coma Berenices
Thomas Gore Browne	Thomas Gore Browne
ErnestAuguste de Hanovre	Prince Ernest Augustus 3rd Duke of Cumberland and Teviotdale
Rachid Karame	Rashid Karami
Law and justice	Law and Justice
Tornado	Storm
Cronay	Cronay
Creedence Clearwater Revival	Creedence Clearwater Revival
Les Appalaches	Les Appalaches Regional County Municipality
FC BielBienne	FC BielBienne
Manchester United Football Club	Manchester United FC
Turner Broadcasting System	Turner Broadcasting System
AlMasry Club	AlMasry SC
Jules Dufaure	Jules Armand Dufaure
Constance de Hauteville	Constance Queen of Sicily
Tucson	Tucson Arizona
Marguerite de Lorraine	Marguerite of Lorraine
Marie de Brabant	Marie of Brabant Queen of France
Charles de Broqueville	Charles de Broqueville
Antonio Segni	Antonio Segni
Boys Noize	Boys Noize
Jerry Finn	Jerry Finn
Oscar Temaru	Oscar Temaru
Marian Lupu	Marian Lupu
Kim Jongun	Kim Jongun
Emanuele Pirro	Emanuele Pirro
Joe Clark	Joe Clark
My Band	My Band
Expedition 31	Expedition 31
Venstre	Venstre
George Meade	George Meade
Goldfrapp	Goldfrapp
Chambly	Chambly
Purple Rain	Purple Rain
Lost	Lost
Charles Hillman Brough	Charles Hillman Brough
Missundaztood	Missundaztood
São Paulo Futebol Clube	São Paulo FC
Rhine	Rhine
Brunswick Records	Brunswick Records
Allan McNish	Allan McNish
Dorade	Dorado
University of Leipzig	Leipzig University
Devils of New Jersey	New Jersey Devils
Yolande de Hongrie	Violant of Hungary
MaryAnne ofAustria	Maria Anna of Austria
Jaroslav Špaček	Jaroslav Špaček
Nicolas de Cues	Nicholas of Cusa
XMen	XMen
