Al Ahly Sporting Club	Al Ahly SC
Notre-Dame-de-Grâce (provincial district)	Notre-Dame-de-Grâce (provincial electoral district)
Tajikistan	Tajikistan
Ivan Kostov	Ivan Kostov
State of Hyderabad	Hyderabad State
Chris Slade	Chris Slade
Yngwie Malmsteen	Yngwie Malmsteen
Brandenburg	Brandenburg
São João (Santa Maria)	São João, Santa Maria
Jadranka Kosor	Jadranka Kosor
Arequipa Region	Arequipa Region
Mohombi	Mohombi
Vitali Vishnevski	Vitaly Vishnevskiy
William D. Mitchell	William D. Mitchell
Saint Mirren Football Club	St Mirren F.C.
Scuderia Italia	BMS Scuderia Italia
Slovenian democratic party	Slovenian Democratic Party
United Kingdom of the Netherlands	United Kingdom of the Netherlands
Métropole Rouen Normandie	Métropole Rouen Normandie
Lazare Kaganovitch	Lazar Kaganovich
Electronica	Electronica
Michael López-Alegría	Michael López-Alegría
Kurt Georg Kiesinger	Kurt Georg Kiesinger
Philippe-Guillaume de Wittelsbach-Neubourg	Philip William, Elector Palatine
Butthole Surfers	Butthole Surfers
André Flahaut	André Flahaut
Union des associations europeennes de football	UEFA
Morihiro Hosokawa	Morihiro Hosokawa
Blanche d'Artois	Blanche of Artois
Shake the Disease	Shake the Disease
Benedict Arnold	Benedict Arnold
Red Wings of the Adirondack	Adirondack Red Wings
Soviet Socialist Republic of Lithuania	Lithuanian Soviet Socialist Republic
STS-115	STS-115
T-Pain	T-Pain
Sam Smith	Sam Smith (singer)
Everton Football Club	Everton F.C.
The Cars	The Cars
Stephen Harper	Stephen Harper
Saint-Antonin (Quebec)	Saint-Antonin, Quebec
Ray Whitney	Ray Whitney (ice hockey)
Dominique Perben	Dominique Perben
Livorno	Livorno
Love and War (album de Tamar Braxton)	Love and War (Tamar Braxton album)
Lullaby (song)	Lullaby (The Cure song)
Piedmont	Piedmont
Cocteau Twins	Cocteau Twins
Roar (song)	Roar (song)
Bill Ward (musician)	Bill Ward (musician)
György Lázár	György Lázár
Pantera	Pantera
One More Time (son de Daft Punk)	One More Time (Daft Punk song)
Ludwig Wittgenstein	Ludwig Wittgenstein
Give It Away	Give It Away (Red Hot Chili Peppers song)
Otto Graf Lambsdorff	Otto Graf Lambsdorff
Raekwon	Raekwon
Ayrton Senna	Ayrton Senna
Moiry (Vaud)	Moiry, Switzerland
Afonso Augusto Moreira Pena	Afonso Pena
The Four Tops	Four Tops
Hans Bethe	Hans Bethe
University of Pennsylvania	University of Pennsylvania
Archdiocese de Paris	Roman Catholic Archdiocese of Paris
I Was Made for Lovin' You	I Was Made for Lovin' You
Stephen K. Robinson	Stephen Robinson
List of Sovereigns of Spain	List of Spanish monarchs
Fleetwood Mac	Fleetwood Mac
Francis-Joseph I of Austria	Franz Joseph I of Austria
Juicy	Juicy (The Notorious B.I.G. song)
Pain Is So Close to Pleasure	Pain Is So Close to Pleasure
Kamehameha II	Kamehameha II
Cruzeiro Esporte Clube	Cruzeiro Esporte Clube
Kriens	Kriens
Me Plus One	Me Plus One
All That I Need Is To Be Loved	All That I Need Is to Be Loved
Grunge	Grunge
Grand Hustle Records	Grand Hustle Records
Bernard Montgomery	Bernard Montgomery
Sainte-Sophie-de-Lévrard	Sainte-Sophie-de-Lévrard, Quebec
She's Out of My Life	She's Out of My Life
Ernest Hemingway	Ernest Hemingway
Mons	Mons
Marguerite de France (1553-1615)	Margaret of Valois
Blonde on Blonde	Blonde on Blonde
Santa Flora	Santa Flora, Santa Maria
BBC One	BBC One
Dai Nana Shō Utsukushikutte Gomen ne	Dai Nana Shō 'Utsukushikutte Gomen ne'
Never+land	Neverland (Misono album)
Mozambique	Mozambique
Grand-duchy of Saxony-Weimar-Eisenach	Grand Duchy of Saxe-Weimar-Eisenach
Christian-Social Union in Bavaria	Christian Social Union in Bavaria
Parish of Denmark	Denmark Parish, New Brunswick
To Pimp a Butterfly	To Pimp a Butterfly
Sporting Clube de Portugal	Sporting Clube de Portugal
Reason to Live	Reason to Live
Focus (producer)	Focus…
Heart of Midlothian Football Club	Heart of Midlothian F.C.
Will Holland	Will Holland
The Beginning (album des Black Eyed Peas)	The Beginning (The Black Eyed Peas album)
Enrico Fermi	Enrico Fermi
Andreï Skabelka	Andrei Skabelka
Bill Richardson	Bill Richardson
Richie Havens	Richie Havens
Porto Alegre	Porto Alegre
Vlad Filat	Vlad Filat
Once (album)	Once (Nightwish album)
The Name of the Game	The Name of the Game (ABBA song)
Prince of Liechtenstein	Monarchy of Liechtenstein
Sliema Wanderers Football Club	Sliema Wanderers F.C.
Barons d'Oklahoma City	Oklahoma City Barons
U2	U2
Faroe Islands	Faroe Islands
Nissan Teana	Nissan Teana
Woodland Hills	Woodland Hills, Los Angeles
António Ginestal Machado	António Ginestal Machado
Adrian Năstase	Adrian Năstase
William Lamb	William Lamb, 2nd Viscount Melbourne
Have a Cigar	Have a Cigar
Papua-New-Guinea	Papua New Guinea
Sean Price	Sean Price
Tunisia olympic football team	Tunisia national under-23 football team
The Alchemist (producer)	The Alchemist (musician)
First House of the States General	Senate (Netherlands)
Sigirino	Sigirino
Holy-Family (Quebec)	Sainte-Famille, Quebec
Association Football Club Bournemouth	A.F.C. Bournemouth
Marco Hausiku	Marco Hausiku
Olli Rehn	Olli Rehn
Franklin Richards	Franklin Richards
Vice-president of the government (Spain)	Deputy Prime Minister of Spain
Klaus Meine	Klaus Meine
Christian democratic party (Switzerland)	Christian Democratic People's Party of Switzerland
Beni Ounif	Béni Ounif
Missy Elliott	Missy Elliott
FK Rostov	FC Rostov
Benedetto Croce	Benedetto Croce
Garreth Carvell	Garreth Carvell
A Hazy Shade of Winter	A Hazy Shade of Winter
Public Enemy	Public Enemy (music group)
Championnat de Belgique de football D2	Belgian Second Division
Seven and the Ragged Tiger	Seven and the Ragged Tiger
Behind Blue Eyes	Behind Blue Eyes
France 3	France 3
Li Keqiang	Li Keqiang
Jon Tester	Jon Tester
Vladimir Kovalionok	Vladimir Kovalyonok
PSA Peugeot Citroën	PSA Peugeot Citroën
Elisabeth of Habsburg	Elizabeth of Austria (1436–1505)
Tourcoing	Tourcoing
Mariah Carey (album)	Mariah Carey (album)
Joe Biden	Joe Biden
Konstantin Barouline	Konstantin Barulin
Michael Eisner	Michael Eisner
Javanese	Javanese language
Juha Lind	Juha Lind
Nintendo DS	Nintendo DS
Holiday (song from Green Day)	Holiday (Green Day song)
Kasabian	Kasabian
Something in Your Mouth	Something in Your Mouth
Hamilton Bulldogs	Hamilton Bulldogs (AHL)
Božidar Đelić	Božidar Đelić
Nevermore	Nevermore
Albirex Niigata	Albirex Niigata
Mongolian people party	Mongolian People's Party
Thabo Mbeki	Thabo Mbeki
Lac-Moncouche	Lac-Moncouche, Quebec
Shawinigan	Shawinigan
Democratic centrist international	Centrist Democrat International
Joey Tempest	Joey Tempest
Grindcore	Grindcore
Outremont	Outremont, Quebec
Julie Cooper-Nichol	Julie Cooper (The O.C.)
City Niinistö	Ville Niinistö
The Fame	The Fame
Frölunda HC	Frölunda HC
Juan Pablo Montoya	Juan Pablo Montoya
Niels Bohr	Niels Bohr
Újpest Football Club	Újpest FC
Tim McIlrath	Tim McIlrath
Janet Reno	Janet Reno
Justice (group)	Justice (band)
A Winter's Tale	A Winter's Tale (Queen song)
Nate Dogg	Nate Dogg
Thus be I	Ainsi soit je
Lake Ontario	Lake Ontario
Bird of paradise (constellation)	Apus
Proof (rapper)	Proof (rapper)
If Today Was Your Last Day	If Today Was Your Last Day
Perl (language)	Perl
Hägglingen	Hägglingen
Rainbow (group)	Rainbow (rock band)
For You (album de Selena Gomez)	For You (Selena Gomez album)
Pierre Ier le Grand	Peter the Great
Caen	Caen
Harder to Breathe	Harder to Breathe
Assembly of the representatives of the people	Assembly of the Representatives of the People
England team football hopes	England national under-21 football team
Dance Remixes	Dance Remixes
Apollo 15	Apollo 15
All Killer, No Filler	All Killer, No Filler
Torku Konyaspor	Konyaspor
Carlos Spencer	Carlos Spencer
Ligne du Nordland	Nordland Line
John Ellis Martineau	John Ellis Martineau
Ramon John Hnatyshyn	Ray Hnatyshyn
New Hampshire	New Hampshire
The Cranberries	The Cranberries
Volvo S80	Volvo S80
Saint-Anselme	Saint-Anselme, Quebec
Sweden-Norway	Union between Sweden and Norway
Thomas Paine	Thomas Paine
Alt Empordà	Alt Empordà
Dynasty Vasa	House of Vasa
RAK Records	Rak Records
The Sound of Silence	The Sound of Silence
John Campbell (9th duke of Argyll)	John Campbell, 9th Duke of Argyll
Georges Darmois	Georges Darmois
Friz Freleng	Friz Freleng
Idriss Déby	Idriss Déby
George Waterhouse	George Waterhouse (politician)
Brent Sutter	Brent Sutter
Vitali Yeremeyev	Vitali Yeremeyev
Robert Napier (1er baron Napier de Magdala)	Robert Napier, 1st Baron Napier of Magdala
Gouvernement Habib Essid	Essid Cabinet
Levi Lincoln	Levi Lincoln, Sr.
Girls Against Boys	Girls Against Boys
Metarfa	Metarfa
Wake Me Up! (Avicii song)	Wake Me Up (Avicii song)
Dusty Springfield	Dusty Springfield
Rob Schremp	Rob Schremp
Dwight D. Eisenhower	Dwight D. Eisenhower
German Democratic Republic	East Germany
Adele	Adele
President of the people republic of China	President of the People's Republic of China
Aleksandr Radulov	Alexander Radulov
Bouvier (constellation)	Boötes
TNA Turning Point	TNA Turning Point
Beady Eye	Beady Eye
Mihai Ghimpu	Mihai Ghimpu
Felsberg (Graubünden)	Felsberg, Switzerland
Wallon	Walloon language
Activision	Activision
Minutes to Midnight	Minutes to Midnight (album)
Francisco de Paula Rodrigues Alves	Francisco de Paula Rodrigues Alves
Season 9 of South Park	South Park (season 9)
All the Right Reasons	All the Right Reasons
Journey (group)	Journey (band)
Harri Holkeri	Harri Holkeri
Monster (Lady Gaga song)	Monster (Lady Gaga song)
Fredy Fautrel	Fredy Fautrel
Bologna	Bologna
Fresh (song of Kool and the Gang)	Fresh (Kool & the Gang song)
Dangerous and Moving	Dangerous and Moving
Come On Over (song of Shania Twain)	Come On Over (Shania Twain song)
Apollo 17	Apollo 17
Globe (group)	Globe (band)
V. J. Sukselainen	V. J. Sukselainen
Scott Douglas Altman	Scott Altman
Powerman 5000	Powerman 5000
Democratic Socialist Party of Montenegro	Democratic Party of Socialists of Montenegro
Worcester County (Massachusetts)	Worcester County, Massachusetts
Paavo Lipponen	Paavo Lipponen
Asian Dub Foundation	Asian Dub Foundation
Hungry Like the Wolf	Hungry Like the Wolf
Saint-Moïse	Saint-Moïse, Quebec
Slovak legislative elections of 2012	Slovak parliamentary election, 2012
President of Singapore	President of Singapore
Championnat du Brésil de football D2	Campeonato Brasileiro Série B
Béchara el-Khoury	Bechara El Khoury
DJ Khaled	DJ Khaled
Brad Schlegel	Brad Schlegel
Copa Sudamericana	Copa Sudamericana
John Barry (composer)	John Barry (composer)
Conservative Party of Canada	Conservative Party of Canada
Do You Want	Voulez-Vous
Occupation of Germany after the Second World War	Allied-occupied Germany
Valdemar de Danemark	Prince Valdemar of Denmark
Etelä-Haaga	Etelä-Haaga
Florent Pagny	Florent Pagny
New-Caledonia	New Caledonia
Godmanchester	Godmanchester, Quebec
Jan de Klerk	Johannes de Klerk
Michael Spindelegger	Michael Spindelegger
France	France
Riku Helenius	Riku Helenius
Viktor Afanassiev	Viktor Afanasyev (cosmonaut)
Hjalmar Branting	Hjalmar Branting
Jules Grévy	Jules Grévy
Breaking the Law	Breaking the Law
Horst Seehofer	Horst Seehofer
Sherman Oaks	Sherman Oaks, Los Angeles
HYDRA	Hydra (comics)
Raymond Barre	Raymond Barre
European football championship 2012	UEFA Euro 2012
Cap-Santé	Cap-Santé
Nicolaas Pierson	Nicolaas Pierson
Jean-Paul Sartre	Jean-Paul Sartre
Midnight (song)	Midnight (Coldplay song)
Death metal	Death metal
League of Communists of Yugoslavia	League of Communists of Yugoslavia
Laurier-Dorion	Laurier-Dorion
Francisco Javier Venegas	Francisco Javier Venegas
Jonathon Blum	Jonathon Blum
Action democratique du Québec	Action démocratique du Québec
Frank Miller	Frank Miller (comics)
Cornelius Castoriadis	Cornelius Castoriadis
UK Government	Government of the United Kingdom
Roland Michener	Roland Michener
Jacques Toubon	Jacques Toubon
RedOne	RedOne
Ahmed Friaâ	Ahmed Friaa
Mylène Farmer	Mylène Farmer
Peugeot 307	Peugeot 307
Selhurst Park	Selhurst Park
Kadima	Kadima
Université rhénane Frédéric-Guillaume de Bonn	University of Bonn
My Hero (song)	My Hero (Foo Fighters song)
Parish of Southesk	Southesk Parish, New Brunswick
Mikhail Kassianov	Mikhail Kasyanov
Stefan Löfven	Stefan Löfven
Jean-Pierre Jabouille	Jean-Pierre Jabouille
Sion (Valais)	Sion, Switzerland
Iowa	Iowa
Another Brick in the Wall	Another Brick in the Wall
Heal the World	Heal the World
Laika Come Home	Laika Come Home
Marian Lupu	Marian Lupu
Cronay	Cronay
Cambuur Leeuwarden	SC Cambuur
Arlington County	Arlington County, Virginia
Ludwig Boltzmann	Ludwig Boltzmann
René d'Anjou	René of Anjou
Mohammed Fahim Khan	Mohammed Fahim
Mama Said (song from Metallica)	Mama Said (Metallica song)
Charles Ier (king of England)	Charles I of England
Élisabeth de France (1727-1759)	Louise Élisabeth of France
Aleksander Kwaśniewski	Aleksander Kwaśniewski
Guennadi Padalka	Gennady Padalka
Solna	Solna Municipality
Ethiopia	Ethiopia
Hervé Morin	Hervé Morin
Luis Resto (musician)	Luis Resto (musician)
Championnat du Brésil de football D3	Campeonato Brasileiro Série C
Saint-Ambroise-de-Kildare	Saint-Ambroise-de-Kildare, Quebec
Rattle and Hum	Rattle and Hum
Kerry King	Kerry King
Underdog (song)	Underdog (Kasabian song)
Joker (comics)	Joker (comics)
Green Day	Green Day
US Secretary of Energy	United States Secretary of Energy
RAM Racing	RAM Racing
Ain (département)	Ain
Darkthrone	Darkthrone
Until One	Until One
Greek Parliament	Hellenic Parliament
Magnificent	Magnificent (U2 song)
Liberal-Democratic Party (Germany)	Free Democratic Party (Germany)
Martin Solveig	Martin Solveig
Just Like Heaven (song)	Just Like Heaven (song)
Box Car Racer (album)	Box Car Racer (album)
Statens Järnvägar	SJ AB
I Don't Want to Spoil the Party	I Don't Want to Spoil the Party
Chaudhry Pervaiz Elahi	Chaudhry Pervaiz Elahi
Éléonore de Habsbourg	Eleanor of Austria
Geert Bourgeois	Geert Bourgeois
United Arab Emirates Football Championship	UAE Arabian Gulf League
Government Năstase	First Năstase cabinet
Gare de Kolbotn	Kolbotn Station
Kane Roberts	Kane Roberts
4 hot wave	4 Hot Wave
MODO Hockey	Modo Hockey
Mayfair	Mayfair
IPad Air	IPad Air
PFC CSKA Sofia	PFC CSKA Sofia
Louise de Savoie	Louise of Savoy
HNK Rijeka	HNK Rijeka
Queen	Queen (band)
Jeunesse sportive de Kabylie	JS Kabylie
Need for Speed (series)	Need for Speed
Agnès Maltais	Agnès Maltais
The Uplift Mofo Party Plan	The Uplift Mofo Party Plan
Halo (series)	Halo (series)
Government Azarov II	Second Azarov Government
Frederick John Robinson	F. J. Robinson, 1st Viscount Goderich
LaFace Records	LaFace Records
Yvon Delbos	Yvon Delbos
Chevelure de Bérénice	Coma Berenices
In Love and Death	In Love and Death
Alexander Rybak	Alexander Rybak
Kamel Morjane	Kamel Morjane
Gustav Fridolin	Gustav Fridolin
Pontiac (district provincial)	Pontiac (provincial electoral district)
The Postal Service	The Postal Service
Championnat de France de rugby à XV	Top 14
Quebecor Media	Quebecor Media
Herbert Brownell Junior	Herbert Brownell, Jr.
Republic of Ireland football team	Republic of Ireland national football team
Paul O'Neill	Paul H. O'Neill
Leiden	Leiden
Worcester Warriors	Worcester Warriors
Mieszko III le Vieux	Mieszko III the Old
Manny Legacé	Manny Legace
Institut d'études politiques de Lyon	Institut d'études politiques de Lyon
Da Funk	Da Funk
Orelsan	Orelsan
Tom Morello	Tom Morello
Alphabet manchou	Manchu alphabet
WCW Slamboree	Slamboree
Louis VIII le Lion	Louis VIII of France
Vlaams Belang	Vlaams Belang
Tomblaine	Tomblaine
Nikolai Bulganin	Nikolai Bulganin
Kārlis Ulmanis	Kārlis Ulmanis
Tsonga (language)	Tsonga language
Reggaetón	Reggaeton
Henri III du Saint-Empire	Henry III, Holy Roman Emperor
Hosni Mubarak	Hosni Mubarak
Apollo 7	Apollo 7
Creedence Clearwater Revival	Creedence Clearwater Revival
Harry Styles	Harry Styles
Belle-Rivière	Belle-Rivière, Quebec
Stéphane Bédard	Stéphane Bédard
Jan Čaloun	Jan Čaloun
University of Warsaw	University of Warsaw
Aeros de Houston (LAH)	Houston Aeros (1994–2013)
Sherbrooke	Sherbrooke
Virgo (constellation)	Virgo (constellation)
Charlie Daniels	Charlie Daniels
Stabæk Fotball	Stabæk Fotball
Chains	Chains (Cookies song)
Terry Stotts	Terry Stotts
Níkos Kotziás	Nikos Kotzias
Raúl Alfonsín	Raúl Alfonsín
Hump de Bump	Hump de Bump
If I Lose Myself	If I Lose Myself
Oslo central station	Oslo Central Station
Nord (french department)	Nord (French department)
Patrick Allen	Patrick Allen (politician)
Sainte-Edwidge-de-Clifton	Sainte-Edwidge-de-Clifton, Quebec
Journals	Journals (album)
Luis Carrero Blanco	Luis Carrero Blanco
Brent W. Jett	Brent W. Jett, Jr.
Chief of Staff of the United States Army	Chief of Staff of the United States Army
Scholastic	Scholastic Corporation
Dig Your Own Hole	Dig Your Own Hole
Metal extreme	Extreme metal
Iberian System	Sistema Ibérico
AKB48	AKB48
Alphonse de Bourbon (1907-1938)	Alfonso, Prince of Asturias (1907–1938)
Starfire	Starfire (comics)
Les Collines-de-l'Outaouais	Les Collines-de-l'Outaouais Regional County Municipality
Don't Phunk with My Heart	Don't Phunk with My Heart
Isaac Asimov	Isaac Asimov
Saint-Hubert (Longueuil)	Saint-Hubert, Quebec
Blue Bird	Blue Bird (Ayumi Hamasaki song)
Royaumes francs	Francia
Keith Primeau	Keith Primeau
Wales	Wales
Deftones	Deftones
Opel Corsa	Opel Corsa
The Human League	The Human League
Lostprophets	Lostprophets
Agroindustrial	Agroindustrial
Football Club Utrecht	FC Utrecht
Road Trippin'	Road Trippin'
James Voss	James S. Voss
Ehud Barak	Ehud Barak
Le Mans Football Club	Le Mans FC
Boi Morto	Boi Morto
Jarosław Gowin	Jarosław Gowin
The Game (album de Queen)	The Game (Queen album)
My Story	My Story (Ayumi Hamasaki album)
Clube de Futebol Os Belenenses	C.F. Os Belenenses
Leon Panetta	Leon Panetta
Universal Studios Florida	Universal Studios Florida
President of the Republic of Tunisia	President of Tunisia
Central system	Sistema Central
Atticus Ross	Atticus Ross
Jon Buckland	Jonny Buckland
Bitter Sweet Symphony	Bitter Sweet Symphony
Matane (ville)	Matane
Charles Pasqua	Charles Pasqua
Will.i.am	Will.i.am
FA Cup football 2009-2010	2009–10 FA Cup
Willard Van Orman Quine	Willard Van Orman Quine
Team of Croatia football hopes	Croatia national under-21 football team
Fontainebleau	Fontainebleau
Saint-Robert (Quebec)	Saint-Robert, Quebec
Tornado (comics)	Storm (Marvel Comics)
Urban Hymns	Urban Hymns
Peugeot 301 (2012)	Peugeot 301 (2012)
Mont-Valin	Mont-Valin, Quebec
Dick Durbin	Dick Durbin
STS-63	STS-63
Dee Dee Ramone	Dee Dee Ramone
Italo dance	Italo dance
Élisabeth Farnèse	Elisabeth Farnese
XO (son de Beyoncé)	XO (song)
Randy Wittman	Randy Wittman
President of the Republic of Latvia	President of Latvia
Erich Honecker	Erich Honecker
Nérée LeNoblet Duplessis	Nérée Le Noblet Duplessis
Id Software	Id Software
RCD Espanyol de Barcelona	RCD Espanyol
Egypt	Egypt
Malle (Belgium)	Malle
University College Dublin	University College Dublin
Giovanni Giolitti	Giovanni Giolitti
Google	Google
In My Place	In My Place
Konvict Muzik	Konvict Muzik
Ayo Technology	Ayo Technology
Stind	Staind
Milk and Honey (album)	Milk and Honey (album)
October (album)	October (U2 album)
Papal States	Papal States
Unapologetic	Unapologetic
Frosinone Calcio	Frosinone Calcio
Bobby Womack	Bobby Womack
Charles Lyttelton (10th viscount Cobham)	Charles Lyttelton, 10th Viscount Cobham
Navdeep Bains	Navdeep Bains
Mascouche	Mascouche
Vol. 2 Hard Knock Life	Vol. 2 Hard Knock Life
Texas	Texas
Mirrors (son de Natalia Kills)	Mirrors (Natalia Kills song)
Saint-Damase (Les Maskoutains)	Saint-Damase, Montérégie, Quebec
Thunder from Wichita	Wichita Thunder
18th airborne corps (United States)	XVIII Airborne Corps
Frederick Temple Blackwood	Frederick Hamilton-Temple-Blackwood, 1st Marquess of Dufferin and Ava
Parliament of Catalonia	Parliament of Catalonia
National Assembly (Hungary)	National Assembly (Hungary)
Kaarlo Juho Ståhlberg	Kaarlo Juho Ståhlberg
Saint-Joseph-de-Lepage	Saint-Joseph-de-Lepage, Quebec
Karachi	Karachi
Shoot to Thrill	Shoot to Thrill
Henri Ier Beauclerc	Henry I of England
Organization of the United Nations	United Nations
Nice	Nice
Sunday Morning (son du Velvet Underground)	Sunday Morning (The Velvet Underground song)
Elias Sarkis	Elias Sarkis
Chevrolet Venture	Chevrolet Venture
Radu Vasile	Radu Vasile
Hit-Boy	Hit-Boy
Elisabeth in Bavaria (1876-1965)	Elisabeth of Bavaria, Queen of Belgium
Saint-Herménégilde	Saint-Herménégilde, Quebec
Lio	Lio
It's All Over Now, Baby Blue	It's All Over Now, Baby Blue
Norway team football hopes	Norway national under-21 football team
Augusta-Amélie de Bavière	Princess Augusta of Bavaria
Clayton Yeutter	Clayton Keith Yeutter
Chea Sim	Chea Sim
James Root	Jim Root
USA Network	USA Network
John Vereker	John Vereker, 6th Viscount Gort
Robin (comics)	Robin (comics)
Paul LePage	Paul LePage
Richard Dawkins	Richard Dawkins
Vlade Divac	Vlade Divac
Finland Ice Hockey Championship	Liiga
Équipe de France espoirs de football	France national under-21 football team
Nikólaos Plastíras	Nikolaos Plastiras
Lac-De La Bidière	Lac-De La Bidière, Quebec
Assassin's Creed (series)	Assassin's Creed
Louis de France (1729-1765)	Louis, Dauphin of France (1729–1765)
Francesco Cossiga	Francesco Cossiga
Adolphus of Cambridge	Prince Adolphus, Duke of Cambridge
Université Lille I	Lille University of Science and Technology
Carol Ier	Carol I of Romania
Season 4 of Angel	Angel (season 4)
Duran Duran	Duran Duran
Maybe I'm Amazed	Maybe I'm Amazed
Bonsecours (Quebec)	Bonsecours, Quebec
Johnny Ramone	Johnny Ramone
Georges Sorel	Georges Sorel
Christian IV of Denmark	Christian IV of Denmark
Gaston Bachelard	Gaston Bachelard
All We Know Is Falling	All We Know Is Falling
Saints-Martyrs-Canadiens	Saints-Martyrs-Canadiens, Quebec
University of Heidelberg	Heidelberg University
Kalevan Pallo	KalPa
Oklahoma City	Oklahoma City
Saïd Ennjimi	Saïd Ennjimi
Downtown Records	Downtown Records
Katrina and the Waves	Katrina and the Waves
Francisco Fernández Ordóñez	Francisco Fernández Ordóñez
Constantine II (king of the Hellenes)	Constantine II of Greece
Elisabeth in Bavaria	Empress Elisabeth of Austria
Cyprus (country)	Cyprus
President of the French Republic	President of France
The WB Television Network	The WB
Greater-Poland Voivodship	Greater Poland Voivodeship
Bréda	Breda
Hercules (constellation)	Hercules (constellation)
Noal	Noal
Josh Farro	Josh Farro
Giovanni Goria	Giovanni Goria
Angliers (Quebec)	Angliers, Quebec
Violence of Summer (Love's Taking Over)	Violence of Summer (Love's Taking Over)
Sophie-Amélie de Brunswick-Calenberg	Sophie Amalie of Brunswick-Lüneburg
County of Galway	County Galway
Zooropa	Zooropa
Louis XI	Louis XI of France
Ivy League	Ivy League
Jean II le Bon	John II of France
Yasser Arafat	Yasser Arafat
Darius Rucker	Darius Rucker
Mogens Lykketoft	Mogens Lykketoft
Samuel Skinner	Samuel K. Skinner
Association of American Universities	Association of American Universities
Charles III of Naples	Charles III of Naples
Bad Robot Productions	Bad Robot Productions
Hey Joe	Hey Joe
England football championship 2011-2012	2011–12 Premier League
Matteo Renzi	Matteo Renzi
STS-80	STS-80
Metropolis european of Lille	European Metropolis of Lille
Coalition Avenir Québec	Coalition Avenir Québec
University of Alabama	University of Alabama
AEL Larissa	AE Larissa FC
Honda Racing F1 Team	Honda in Formula One
STS-123	STS-123
Susan L. Still	Susan Kilrain
President of the Arab Republic of Egypt	President of Egypt
Jody Wilson-Raybould	Jody Wilson-Raybould
Erik Comas	Érik Comas
Marie-Antoinette de Bourbon-Siciles (1851-1918)	Princess Maria Antonietta of Bourbon-Two Sicilies
Troy Middleton	Troy H. Middleton
Saint-Laurent (district provincial)	Saint-Laurent (provincial electoral district)
Le Lombard	Le Lombard
Ami Suzuki	Ami Suzuki
Yulia Tymochenko	Yulia Tymoshenko
Società Sportiva Lazio	S.S. Lazio
Carl Sagan	Carl Sagan
Guyane	French Guiana
Philippe VI de Valois	Philip VI of France
Mr Probz	Mr Probz
Octopussy	Octopussy
Vu-den	V-u-den
Robert Walpole	Robert Walpole
Cheese (album)	Cheese (album)
Essex County (New Jersey)	Essex County, New Jersey
Arrondissement de Châlons-en-Champagne	Arrondissement of Châlons-en-Champagne
Juan Carlos Ier	Juan Carlos I of Spain
Capital G	Capital G
Rio (album)	Rio (Duran Duran album)
Hercules Robinson	Hercules Robinson, 1st Baron Rosmead
Ride the Lightning	Ride the Lightning
Nathalie Kosciusko-Morizet	Nathalie Kosciusko-Morizet
Marches	Marche
André Bellavance	André Bellavance
Bachata	Bachata (music)
Tell Me What You See	Tell Me What You See
Chess Records	Chess Records
Lyss	Lyss
Mario Vargas Llosa	Mario Vargas Llosa
Union des democrats pour la République	Union of Democrats for the Republic
Octant	Octans
Henri IV du Saint-Empire	Henry IV, Holy Roman Emperor
François Goulard	François Goulard
Davy Jones (driver)	Davy Jones (racing driver)
Kirkland (Quebec)	Kirkland, Quebec
Cyrus Vance	Cyrus Vance
Dinosaur Jr.	Dinosaur Jr.
Music (album de Mika Nakashima)	Music (Mika Nakashima album)
Vasco dos Santos Gonçalves	Vasco Gonçalves
Université de Sherbrooke	Université de Sherbrooke
County of Savoy	County of Savoy
John Baird (Canadian politician)	John Baird (Canadian politician)
Michel Martelly	Michel Martelly
George Grenville	George Grenville
Hollywood Tonight	Hollywood Tonight
Marie-Thérèse de France (1778-1851)	Marie Thérèse of France
Gouvernement Di Rupo (Belgium)	Di Rupo Government
Robert Gates	Robert Gates
University of London	University of London
Terrence W. Wilcutt	Terrence W. Wilcutt
Emperor of Mexico	Emperor of Mexico
Ritchie Blackmore	Ritchie Blackmore
Saint-Barthélemy (Vaud)	Saint-Barthélemy, Switzerland
Hal (Belgium)	Halle, Belgium
Don't Stand So Close to Me	Don't Stand So Close to Me
Brabham BT49	Brabham BT49
Hua Guofeng	Hua Guofeng
Hélène de Monténégro	Elena of Montenegro
Ernst Benda	Ernst Benda
FK Dnipro	FC Dnipro Dnipropetrovsk
Governor General of Canada	Governor General of Canada
Nirvana (album de Nirvana)	Nirvana (Nirvana album)
Justice and Development Party (Turkey)	Justice and Development Party (Turkey)
Serbian orthodox church	Serbian Orthodox Church
Julius Döpfner	Julius Döpfner
The Rock Show	The Rock Show
Shadow of the Day	Shadow of the Day
Ivo Josipović	Ivo Josipović
Joe Mullen	Joe Mullen
Pierre-Émile Côté	Pierre-Émile Côté
Ecstatic Peace!	Ecstatic Peace!
Hilary Putnam	Hilary Putnam
Hannelore Kraft	Hannelore Kraft
Red Bulls of New York	New York Red Bulls
Amsterdam ArenA	Amsterdam Arena
Daft Punk	Daft Punk
Marcel Pilet-Golaz	Marcel Pilet-Golaz
Beverly Hills	Beverly Hills, California
Mark Stent	Spike Stent
Gare de Bayonne	Gare de Bayonne
Dev	Dev (singer)
Saint-Christophe-et-Nevis	Saint Kitts and Nevis
Scott Phillips (musician)	Scott Phillips (musician)
Memramcook	Memramcook, New Brunswick
Italian Campaign (Second World War)	Italian Campaign (World War II)
Government Yatsenyuk I	First Yatsenyuk Government
Gare de Kløfta	Kløfta Station
Nandrin	Nandrin
Modena	Modena
Simon-Napoleon Parent	Simon-Napoléon Parent
Arthur Schopenhauer	Arthur Schopenhauer
Brown University	Brown University
Australian Senate	Australian Senate
WCW SuperBrawl	SuperBrawl
Charles Ier (king of Portugal)	Carlos I of Portugal
Illuminati (comics)	Illuminati (comics)
Marek Biernacki	Marek Biernacki
André Marie	André Marie
Roberto Bellarosa	Roberto Bellarosa
Keel	Keel (band)
Sega	Sega
Balearic Islands	Balearic Islands
René Mayer	René Mayer
Anti-Revolutionary Party	Anti-Revolutionary Party
Richard M. Daley	Richard M. Daley
Jam (song)	Jam (song)
Albanian Kingdom (1939-1944)	Albanian Kingdom (1939–43)
Ojos así	Ojos Así
Back to Basics	Back to Basics (Christina Aguilera album)
Unione Sportiva Città di Palermo	U.S. Città di Palermo
APOEL Nicosie	APOEL FC
MCMXC a.D.	MCMXC a.D.
Munkivuori	Munkkivuori
Rachida Dati	Rachida Dati
Sam Simon	Sam Simon
Roger Taylor	Roger Taylor (Queen drummer)
The Notorious B.IG	The Notorious B.I.G.
Government Gonzi II	Maltese Government 2008–13
Championnat de Belgique de football D4	Belgian Fourth Division
Alexander I (king of Scotland)	Alexander I of Scotland
Malmö Redhawks	Malmö Redhawks
Bécancour	Bécancour, Quebec
Barry O'Farrell	Barry O'Farrell
Marguerite d'Alsace	Margaret I, Countess of Flanders
Abe Sapien	Abe Sapien
Friedrich Zimmermann	Friedrich Zimmermann
Simonetta Sommaruga	Simonetta Sommaruga
Luisa Fernanda Rudi	Luisa Fernanda Rudi Ubeda
Archibald Wavell	Archibald Wavell, 1st Earl Wavell
New-Brunswick Liberal Association	New Brunswick Liberal Association
Gouvernement Prodi I	Prodi I Cabinet
Ferdinand I of Austria	Ferdinand I of Austria
Limousin	Limousin
Sweet Impact	Sweet Impact
Neven Mimica	Neven Mimica
George Wallace	George Wallace
Bad (album)	Bad (album)
Montcerf-Lytton	Montcerf-Lytton, Quebec
Mirabel (district provincial)	Mirabel (provincial electoral district)
François (pope)	Pope Francis
Gheorghe Gheorghiu-Dej	Gheorghe Gheorghiu-Dej
Debila	Debila
Trance Goa	Goa trance
I'll Still Kill	I'll Still Kill
Carmine Infantino	Carmine Infantino
Ligne Yamanote	Yamanote Line
Gare de Harestua	Harestua Station
William Hague	William Hague
Lot-et-Garonne	Lot-et-Garonne
Sergei Lavrov	Sergey Lavrov
John Romita, Sr.	John Romita Sr.
Theodor Körner (politician)	Theodor Körner (Austrian president)
Paul Halmos	Paul Halmos
Valleseco	Valleseco, Las Palmas
Football Club de Metz	FC Metz
The Works (album de Queen)	The Works (Queen album)
Jarosław Kaczyński	Jarosław Kaczyński
São Valentim (district de Santa Maria)	São Valentim, district of Santa Maria
Alphabet latin	Latin script
François Ier de Liechtenstein	Franz I, Prince of Liechtenstein
Stéphanie de Beauharnais	Stéphanie de Beauharnais
Keith Holyoake	Keith Holyoake
Marc Forné Molné	Marc Forné Molné
Saint-Stanislas-de-Kostka	Saint-Stanislas-de-Kostka, Quebec
Claude Bartolone	Claude Bartolone
Donald Pettit	Donald Pettit
Exodus (group)	Exodus (American band)
Love Songs (album d'Ayumi Hamasaki)	Love Songs (Ayumi Hamasaki album)
Burgundy	Burgundy
Mint Car	Mint Car
The Trammps	The Trammps
Mel Blanc	Mel Blanc
My Chemical Romance	My Chemical Romance
Merengue	Merengue music
Gram Parsons	Gram Parsons
Mont-Saint-Hilaire	Mont-Saint-Hilaire, Quebec
Knock Me Down	Knock Me Down
Myles Kennedy	Myles Kennedy
Kiss (song of Prince)	Kiss (Prince song)
Candiac	Candiac, Quebec
Mandeville (Quebec)	Mandeville, Quebec
Bun B	Bun B
Ueli Maurer	Ueli Maurer
Association sportive Nancy-Lorraine	AS Nancy
Aleksander Szczygło	Aleksander Szczygło
Milton Friedman	Milton Friedman
Recep Tayyip Erdoğan	Recep Tayyip Erdoğan
Civic Democratic Party (Czech Republic)	Civic Democratic Party (Czech Republic)
Stones Throw Records	Stones Throw Records
DNA (album de Little Mix)	DNA (Little Mix album)
Haiti football team	Haiti national football team
Morning Musume	Morning Musume
Nirvana (group)	Nirvana (band)
She's a Woman	She's a Woman
Parti radical (France)	Radical Party (France)
Equatorial Guinea	Equatorial Guinea
Opel Combo	Opel Combo
US Secretary of Agriculture	United States Secretary of Agriculture
Queen of Hip-Pop	Queen of Hip-Pop
War of the League of Augsburg	Nine Years' War
Cerezo Osaka	Cerezo Osaka
Greg Selinger	Greg Selinger
Ernest-Auguste III de Hanovre	Ernest Augustus, Duke of Brunswick
L'Aquila	L'Aquila
Papercut	Papercut (song)
HC Lev Prague	HC Lev Praha
RBX	RBX
Just Don't Give a Fuck	Just Don't Give a Fuck
Fire (son de Kasabian)	Fire (Kasabian song)
Beauce-Sud	Beauce-Sud
Delfino Pescara 1936	Delfino Pescara 1936
Rick Perry	Rick Perry
List of the sovereigns of Bulgaria	List of Bulgarian monarchs
Michel Rocard	Michel Rocard
Parti de la coalition nationale	National Coalition Party
Jeffrey Bell	Jeffrey Bell
Vanwall	Vanwall
Expo '98	Expo '98
Padua	Padua
Yéyé	Yé-yé
Jorge María Mejía	Jorge María Mejía
Iraq	Iraq
Pure Morning	Pure Morning
Alexis de Tocqueville	Alexis de Tocqueville
Specialized exhibition of 2012	Expo 2012
Villeroy (Quebec)	Villeroy, Quebec
Northern Ireland football team	Northern Ireland national football team
Nicolas Cage	Nicolas Cage
Genoa Cricket and Football Club	Genoa C.F.C.
Amos (Quebec)	Amos, Quebec
Christine from Denmark	Christina of Denmark
Médéric Martin	Médéric Martin
Adélaïde de Savoie	Adelaide of Maurienne
Chambly (Quebec)	Chambly, Quebec
Championnat de Suisse de football 2013-2014	2013–14 Swiss Super League
Charles Devens	Charles Devens
Robin Kelly	Robin Kelly
Wolves of Chicago	Chicago Wolves
Jernbaneverket	Norwegian National Rail Administration
Young Americans (album)	Young Americans (album)
Headbanger!!	Head Bangya!!
South-American Football Confederation	CONMEBOL
Les Rita Mitsouko	Les Rita Mitsouko
Baie-des-Sables	Baie-des-Sables, Quebec
Monsters of lake Erie	Lake Erie Monsters
Anytime	Anytime (Kumi Koda song)
Brecht (Belgium)	Brecht, Belgium
Expedition 21 (ISS)	Expedition 21
Ho Chi Minh	Ho Chi Minh
The John Butler Trio	John Butler Trio
Tony Blair	Tony Blair
Christophe Willem	Christophe Willem
Richie Sambora	Richie Sambora
Wings of Kalamazoo (LIH)	Kalamazoo Wings (1974–2000)
Charlevoix (regional county municipality)	Charlevoix Regional County Municipality
Charouine	Charouine
New Jersey	New Jersey
Wilaya de Béchar	Béchar Province
Jackie Stewart	Jackie Stewart
Aragon (autonomous community)	Aragon
Sirenia (group)	Sirenia (band)
Lac-Bouchette	Lac-Bouchette, Quebec
Eissportverein Zug	EV Zug
Touchin' on My	Touchin' on My
Doo-Wops and Hooligans	Doo-Wops & Hooligans
Post-hardcore	Post-hardcore
Amsterdam	Amsterdam
Bedtime Story	Bedtime Story (Madonna song)
Aquitaine-Limousin-Poitou-Charentes	Aquitaine-Limousin-Poitou-Charentes
Saint-Eugène-de-Ladrière	Saint-Eugène-de-Ladrière, Quebec
Mika (singer)	Mika (singer)
Trondheim central station	Trondheim Central Station
Saxony-Anhalt	Saxony-Anhalt
Brian May	Brian May
Casablanca Records	Casablanca Records
Valletta Football Club	Valletta F.C.
Fussball-Club Sankt-Gallen	FC St. Gallen
Concise	Concise
Marvel Studios	Marvel Studios
Montmagny (regional county municipality)	Montmagny Regional County Municipality
One of These Days (song of Pink Floyd)	One of These Days (instrumental)
Pierre Lellouche	Pierre Lellouche
European Left Party	Party of the European Left
Azerbaijan football team	Azerbaijan national football team
Peter II (king of Yugoslavia)	Peter II of Yugoslavia
Palace of Topkapı	Topkapı Palace
Every Little Thing	Every Little Thing (band)
Paul Reynaud	Paul Reynaud
Aqua (group)	Aqua (band)
La Rage au ventre (original record)	Southpaw (soundtrack)
Microsoft	Microsoft
Châteauguay (district provincial)	Châteauguay (provincial electoral district)
Alone (song)	Alone (Heart song)
Jeroen Dijsselbloem	Jeroen Dijsselbloem
MTV Networks	Viacom Media Networks
First Spanish Republic	First Spanish Republic
Krist Novoselic	Krist Novoselic
Eugene Cernan	Eugene Cernan
Charles-Louis of-Austria (1833-1896)	Archduke Karl Ludwig of Austria
Saint-Séverin (Robert-Cliche)	Saint-Séverin, Chaudière-Appalaches, Quebec
A Night at the Opera (album de Queen)	A Night at the Opera (Queen album)
Nikola Pašić	Nikola Pašić
Fear of the Dark (album)	Fear of the Dark (Iron Maiden album)
Abdelwahed Radi	Abdelwahed Radi
Eric Holder	Eric Holder
Oftringen	Oftringen
The Future (song)	The Future (song)
STS-125	STS-125
George VI	George VI
Fantasy Ride	Fantasy Ride
Dominion of Newfoundland	Dominion of Newfoundland
Jules II	Pope Julius II
United Soccer League	United Soccer League
Ion Iliescu	Ion Iliescu
Kóstas Karamanlís	Kostas Karamanlis
House of Hohenzollern	House of Hohenzollern
Mika Špiljak	Mika Špiljak
When I Think of You	When I Think of You
Aedermannsdorf	Aedermannsdorf
Angra (group)	Angra (band)
Dean Heller	Dean Heller
Johannes Rau	Johannes Rau
Université Bocconi	Bocconi University
Tamar Beroutchashvili	Tamar Beruchashvili
Simon and Garfunkel	Simon & Garfunkel
Malik Ghulam Muhammad	Malik Ghulam Muhammad
Gare de Sonsveien	Sonsveien Station
Martti Miettunen	Martti Miettunen
John Breckinridge	John Breckinridge (U.S. Attorney General)
Scots	Scots language
Saint-Brieuc	Saint-Brieuc
Kiev	Kiev
UK House of Commons	House of Commons of the United Kingdom
Drone (music)	Drone music
Dundee Football Club	Dundee F.C.
Carlos Arias Navarro	Carlos Arias Navarro
The Neptunes	The Neptunes
John Stevens	John Stevens (ice hockey)
Sony Computer Entertainment	Sony Computer Entertainment
AO Kerkyra	PAE Kerkyra
Cholet	Cholet
Pontifical Catholic University of Peru	Pontifical Catholic University of Peru
Synyster Gates	Synyster Gates
Alex Bourret	Alex Bourret
Bruce Cassidy	Bruce Cassidy
Delicacies	Gourmandises
Boulogne-sur-Mer	Boulogne-sur-Mer
Diamonds and Pearls	Diamonds and Pearls
Pierre-et-Marie-Curie University	Pierre and Marie Curie University
Jaco Pastorius	Jaco Pastorius
Chen Shui-bian	Chen Shui-bian
Mellingen	Mellingen
United States Navy	United States Navy
Pietro Grasso	Pietro Grasso
Domingos Leite Pereira	Domingos Leite Pereira
Larrousse	Larrousse
Lauro Cavazos	Lauro Cavazos
Suicide Squad	Suicide Squad
Richie Hawtin	Richie Hawtin
Just Good Friends	Just Good Friends (song)
Pierre Manent	Pierre Manent
Jean-Baptiste Say	Jean-Baptiste Say
Mr. Tambourine Man	Mr. Tambourine Man
I'll Go Crazy If I Don't Go Crazy Tonight	I'll Go Crazy If I Don't Go Crazy Tonight
Stanstead-East	Stanstead-Est, Quebec
Sainte-Anne-de-la-Pocatière	Sainte-Anne-de-la-Pocatière
Punk celtique	Celtic punk
Ibrahim Mahlab	Ibrahim Mahlab
Rwanda	Rwanda
Mark Jackson (basketball)	Mark Jackson (basketball)
Saint-Jean-de-Matha	Saint-Jean-de-Matha, Quebec
Figueirense Futebol Clube	Figueirense FC
Kim Jong-un	Kim Jong-un
Master and Servant	Master and Servant
Kurt Schmücker	Kurt Schmücker
János Kádár	János Kádár
Béarn (Quebec)	Béarn, Quebec
Tingwick	Tingwick, Quebec
Thank You (album de Duran Duran)	Thank You (Duran Duran album)
Intercontinental Cup	Intercontinental Cup (football)
Bioggio	Bioggio
Dido	Dido (singer)
Curtis Leschyshyn	Curtis Leschyshyn
See Emily Play	See Emily Play
Harold Macmillan	Harold Macmillan
Kingdom of Holland	Kingdom of Holland
Torpedo Nijni Novgorod	Torpedo Nizhny Novgorod
Xenophón Zolótas	Xenophon Zolotas
Afghan War (2001-2014)	War in Afghanistan (2001–14)
Momir Bulatović	Momir Bulatović
Opel Astra	Opel Astra
Florence	Florence
Hockey Club Fribourg-Gotteron	HC Fribourg-Gottéron
Chevrolet	Chevrolet
Jacques Laffite	Jacques Laffite
Future house	Future house
Clem Burke	Clem Burke
Lee Hsien Loong	Lee Hsien Loong
Ford Mondeo	Ford Mondeo
Wish You Were Here (Incubus song)	Wish You Were Here (Incubus song)
Saint-Gédéon-de-Beauce	Saint-Gédéon-de-Beauce, Quebec
The Doors	The Doors
Crystal Palace Football Club	Crystal Palace F.C.
Post-bop	Post-bop
Baby One More Time (song)	Baby One More Time (song)
Marie-Élisabeth de Bavière	Princess Maria Elisabeth of Bavaria
Oka (Quebec)	Oka, Quebec
Beinwil am See	Beinwil am See
William C. C. Claiborne	William C. C. Claiborne
Niklaus Wirth	Niklaus Wirth
Baby's in Black	Baby's in Black
Juho Sunila	Juho Sunila
Edward of Wessex	Prince Edward, Earl of Wessex
Finally Famous (album)	Finally Famous (Big Sean album)
Prime minister of Estonia	Prime Minister of Estonia
Associazione Calcio Milan	A.C. Milan
Hans Peter Tschudi	Hans-Peter Tschudi
The Rise and Fall of Ziggy Stardust and the Spiders from Mars	The Rise and Fall of Ziggy Stardust and the Spiders from Mars
Le Granit	Le Granit Regional County Municipality
Ukraine football team	Ukraine national football team
Earthling	Earthling (album)
Labour Party (Norway)	Labour Party (Norway)
TNA Against All Odds	TNA Against All Odds
Håkon VI from Norway	Haakon VI of Norway
Gilbert du Motier de La Fayette	Gilbert du Motier, Marquis de Lafayette
Jordan Grand Prix	Jordan Grand Prix
Alan Wilder	Alan Wilder
Waters Rising	Waters Rising
Eldon Parish	Eldon Parish, New Brunswick
Bobby Darin	Bobby Darin
Renaud	Renaud
Within Temptation	Within Temptation
Yverdon-les-Bains	Yverdon-les-Bains
Malayalam	Malayalam
Jacques Hadamard	Jacques Hadamard
Els Borst	Els Borst
Wotton	Wotton, Quebec
Marie-Christine of-Austria	Maria Christina of Austria
First Minister of Scotland	First Minister of Scotland
Michel Therrien	Michel Therrien
Blanche de Castille	Blanche of Castile
Doxa Katokopias	Doxa Katokopias F.C.
Louis Althusser	Louis Althusser
Thomas Stafford	Thomas P. Stafford
James Patrick	James Patrick (ice hockey)
Apollo 8	Apollo 8
Libor Procházka	Libor Procházka
The Script (album)	The Script (album)
Eugène IV	Pope Eugene IV
David Fury	David Fury
Province Sud (New Caledonia)	South Province, New Caledonia
By the Way (album)	By the Way
Fugees	Fugees
Villa Park	Villa Park
Rounder Records	Rounder Records
Sacré-Coeur (Quebec)	Sacré-Coeur, Quebec
Anne (empress of Russia)	Anna of Russia
Diane Lemieux	Diane Lemieux
Warp Records	Warp (record label)
MaYaN	Mayan (band)
Plantagenet	House of Plantagenet
Emotions	Emotions (Mariah Carey album)
Derek and the Dominos	Derek and the Dominos
Ulf Dahlén	Ulf Dahlén
Pontiac (automobile)	Pontiac
Luke Cage	Luke Cage
Static-X	Static-X
Warning (song from Green Day)	Warning (Green Day song)
County of Westchester	Westchester County, New York
Showtime	Showtime (TV network)
Going Back (album)	Going Back (album)
PFC Slavia Sofia	PFC Slavia Sofia
Mont-Tremblant	Mont-Tremblant, Quebec
Alphonse II of Aragon	Alfonso II of Aragon
Universal Orlando Resort	Universal Orlando
Alphabet gréc	Greek alphabet
Daniel Mayer	Daniel Mayer
São Valentim (Santa Maria)	São Valentim, Santa Maria
Government Ciorbea	Ciorbea I Cabinet
Jean-Paul Delevoye	Jean-Paul Delevoye
Fredericton	Fredericton
Order of the Bath	Order of the Bath
Guillaume IV (grand-duke of Luxembourg)	William IV, Grand Duke of Luxembourg
Ryūtarō Hashimoto	Ryutaro Hashimoto
Verchères	Verchères
Freestyle (genre musical)	Freestyle music
Ghosts	Ghosts
Red (album de Taylor Swift)	Red (Taylor Swift album)
Alliance of liberals and democrats for Europe	Alliance of Liberals and Democrats for Europe Party
Rock You Like a Hurricane	Rock You Like a Hurricane
Sindhi	Sindhi language
Belgium football team	Belgium national football team
Henri-Edgar Lavigueur	Henri-Edgar Lavigueur
Richard Riley	Richard Riley
Seljuks	Seljuq dynasty
Team of Morocco of football	Morocco national football team
Rimouski-Neigette	Rimouski-Neigette
Mieczysław Rakowski	Mieczysław Rakowski
Robert Smith (musician)	Robert Smith (musician)
Theodor Stolojan	Theodor Stolojan
Sport Club Corinthians Paulista	Sport Club Corinthians Paulista
The xx	The xx
Opeth	Opeth
FireHouse	FireHouse (band)
Loir-et-Cher	Loir-et-Cher
Danville (Quebec)	Danville, Quebec
Roxton Pond	Roxton Pond, Quebec
Behind the Wheel	Behind the Wheel
Leonid Brezhnev	Leonid Brezhnev
Qinghai	Qinghai
Noise rock	Noise rock
Lancia	Lancia
Frederick Browning	Frederick Browning
Galore	Galore (The Cure album)
Dragon Ball	Dragon Ball
Schmiedrued	Schmiedrued
Bellinzona	Bellinzona
Alpes-de-Haute-Provence	Alpes-de-Haute-Provence
Gaston Doumergue	Gaston Doumergue
Stade de la Liberation	Stade de la Libération
Lübeck	Lübeck
La Marguerite	Democracy is Freedom – The Daisy
HC Sparta Prague	HC Sparta Praha
United Socialist Party of Venezuela	United Socialist Party of Venezuela
Cowpunk	Cowpunk
Cantley	Cantley, Quebec
Mauricio Macri	Mauricio Macri
Jacques Derrida	Jacques Derrida
Hudson (Quebec)	Hudson, Quebec
Genius 2000	Genius 2000
Laimdota Straujuma	Laimdota Straujuma
Paul Gautsch	Paul Gautsch von Frankenthurn
Auguste de Leuchtenberg	Auguste de Beauharnais
Too Much Love Will Kill You	Too Much Love Will Kill You
Johns-Hopkins University	Johns Hopkins University
Perigueux	Périgueux
Xu Shichang	Xu Shichang
I Know What I Like (In Your Wardrobe)	I Know What I Like (In Your Wardrobe)
Bolshoi Theater	Bolshoi Theatre
KAT-TUN	KAT-TUN
Championnat des Netherlands de football D2	Eerste Divisie
Wolfgang Schüssel	Wolfgang Schüssel
Saint-Frédéric	Saint-Frédéric, Quebec
Hustlin'	Hustlin'
Sigismund III of Poland	Sigismund III Vasa
Social Distortion	Social Distortion
Pierre Marc Johnson	Pierre-Marc Johnson
ADO La Haye	ADO Den Haag
Isaac Hayes	Isaac Hayes
Prime Minister of Greece	Prime Minister of Greece
Protectorate of Bohemia-Moravia	Protectorate of Bohemia and Moravia
Chris Grayling	Chris Grayling
K. K. Downing	K. K. Downing
Ram (album)	Ram (album)
Alexandra de Denmark	Alexandra of Denmark
Autoamerican	Autoamerican
John Lucas (basketball)	John Lucas II
Expedition 31 (ISS)	Expedition 31
Whataya Want from Me	Whataya Want from Me
Spanish worker socialist party	Spanish Socialist Workers' Party
Burkina Faso	Burkina Faso
Hage Geingob	Hage Geingob
Muddy Waters	Muddy Waters
Chuck Berry	Chuck Berry
George I (king of Great Britain)	George I of Great Britain
René Descartes	René Descartes
University of Paris	University of Paris
Bridgestone	Bridgestone
Brazilian Football Cup	Copa do Brasil
Early hardcore	Gabber
Montenegro	Montenegro
Fortress (Alter Bridge album)	Fortress (Alter Bridge album)
Henryville (Quebec)	Henryville, Quebec
Randy Cunneyworth	Randy Cunneyworth
United States Air Force	United States Air Force
Tony Banks	Tony Banks (musician)
Wilaya d'Adrar	Adrar Province
Music Corporation of America	MCA Inc.
Polow da Don	Polow da Don
Baie de San Francisco	San Francisco Bay
Batman Forever (album)	Batman Forever (soundtrack)
Vital Koval	Vitali Koval
Quincy Jones	Quincy Jones
Awake (album de Dream Theater)	Awake (Dream Theater album)
Henry IV (king of England)	Henry IV of England
Dmitri Ier Donskoy	Dmitry Donskoy
Baudouin (king of Belgians)	Baudouin of Belgium
Arizona	Arizona
The END	The E.N.D
Charles Fourier	Charles Fourier
Charles IV (emperor of the Romans)	Charles IV, Holy Roman Emperor
East Rutherford	East Rutherford, New Jersey
Wrath	Courroux
Kingdom of Sicily	Kingdom of Sicily
Haïlé Sélassié Ier	Haile Selassie
Reuven Rivlin	Reuven Rivlin
Cream	Cream (band)
Sanche Ier (king of Portugal)	Sancho I of Portugal
Messina	Messina
Double (song)	Double (BoA song)
Mediaset España	Mediaset España Comunicación
Courtrai	Kortrijk
Pyrénées-Atlantiques	Pyrénées-Atlantiques
Käerjeng	Käerjeng
Whodini	Whodini
Flash of Western New York	Western New York Flash
Ken Salazar	Ken Salazar
Behemoth	Behemoth (band)
White Lies (group)	White Lies (band)
ASA Târgu Mureș	ASA 2013 Târgu Mureș
John C. Spencer	John C. Spencer
Tony Granato	Tony Granato
Grêmio Foot-Ball Porto Alegrense	Grêmio Foot-Ball Porto Alegrense
Steve Porcaro	Steve Porcaro
There's a Place	There's a Place
Christina Aguilera (album)	Christina Aguilera (album)
Take Back the City	Take Back the City
Tomáš Surový	Tomáš Surový
Muhammad Rafiq Tarar	Muhammad Rafiq Tarar
Bel Air (Los Angeles)	Bel Air, Los Angeles
Saint-Cléophas	Saint-Cléophas, Quebec
Reggio de Calabria	Reggio Calabria
Battle of the Dardanelles	Gallipoli Campaign
Catalan	Catalan language
Earl Roche	Earl Roche
Khieu Samphân	Khieu Samphan
French Parliament	French Parliament
Norway Football Championship	Tippeligaen
Led Zeppelin	Led Zeppelin
Albert Hertzog	Albert Hertzog
La Rioja	La Rioja (Spain)
Jeffrey Chiesa	Jeffrey Chiesa
Girls on Film	Girls on Film
Nancy	Nancy, France
Ami Selection	Ami Selection
Karin Enström	Karin Enström
Eva Kjer Hansen	Eva Kjer Hansen
Marie-Thérèse of Modena (1849-1919)	Maria Theresa of Austria-Este (1849–1919)
Constance (Germany)	Konstanz
Alec Douglas-Home	Alec Douglas-Home
Union des verts et des paysans	Union of Greens and Farmers
The Long Road	The Long Road
Wilhelm Groener	Wilhelm Groener
French Canadians	French Canadians
Expedition 2 (ISS)	Expedition 2
Ligue des champions de la CAF 2007	2007 CAF Champions League
Florence and the Machine	Florence and the Machine
Technical University of Munich	Technische Universität München
Metal progressive	Progressive metal
Kazakhstan	Kazakhstan
Ginger Baker	Ginger Baker
Clube Desportivo de Tondela	C.D. Tondela
Front pour la victorie	Front for Victory
Adam Smith	Adam Smith
Italian Championship of football D3	Lega Pro Prima Divisione
Michal Řepík	Michal Řepík
The Battle of Los Angeles	The Battle of Los Angeles (album)
Coupe de la Ligue francaise de football 2015-2016	2015–16 Coupe de la Ligue
Dare (song)	Dare (song)
When the Sun Goes Down (album de Selena Gomez and the Scene)	When the Sun Goes Down (Selena Gomez & the Scene album)
John King, Jr.	John King, Jr.
Martin L. Gore	Martin Gore
Dizzee Rascal	Dizzee Rascal
Lithium (song of Nirvana)	Lithium (Nirvana song)
Jan Pronk	Jan Pronk
North-Holland	North Holland
Mark Recchi	Mark Recchi
Sinikka Mönkäre	Sinikka Mönkäre
Muslim League of Pakistan (Q)	Pakistan Muslim League (Q)
Adolfo Suarez	Adolfo Suárez
Rock sudiste	Southern rock
Breakaway (album)	Breakaway (Kelly Clarkson album)
Thierry St-Cyr	Thierry St-Cyr
Season 1 of Angel	Angel (season 1)
District federal central	Central Federal District
The Times They Are a-Changin' (song)	The Times They Are a-Changin' (song)
Calcutta	Kolkata
All My Loving	All My Loving
Saint-François-de-Sales (Quebec)	Saint-François-de-Sales, Quebec
İsmet İnönü	İsmet İnönü
For You Blue	For You Blue
Desecration Smile	Desecration Smile
Algirdas Brazauskas	Algirdas Brazauskas
Mary-Anne of-Austria (1683-1754)	Maria Anna of Austria
WWE 2K16	WWE 2K16
Royal Football Club Seraing (167)	Seraing United
Luc Letellier de Saint-Just	Luc Letellier de St-Just
Sind	Sindh
Haiti	Haiti
Gare de Vevelstad	Vevelstad Station
Hans Luther	Hans Luther
Gregoire XV	Pope Gregory XV
Rupprecht of Bavaria	Rupprecht, Crown Prince of Bavaria
Bluegrass	Bluegrass music
William Plunket	William Plunket, 5th Baron Plunket
Beck Hansen	Beck
Love on Top	Love on Top
Isaac Herzog (politician)	Isaac Herzog
Carlos César	Carlos César
House of-Orange-Nassau	House of Orange-Nassau
Brian Cowen	Brian Cowen
Wilhelm Frick	Wilhelm Frick
King Crimson	King Crimson
No Love	No Love
Dr. Dre	Dr. Dre
Saint-Jean-Port-Joli	Saint-Jean-Port-Joli, Quebec
Electric Light Orchestra	Electric Light Orchestra
The Drifters	The Drifters
Danish Monarchy	Monarchy of Denmark
Mike Einziger	Mike Einziger
John G. Roberts Jr.	John Roberts
Dynasty of Mehemet Ali	Muhammad Ali dynasty
Constance Chlore	Constantius Chlorus
With a Little Help from My Friends	With a Little Help from My Friends
Jean-Yves Duclos	Jean-Yves Duclos
Rio de Janeiro	Rio de Janeiro
Mary McAleese	Mary McAleese
FC Lugano	FC Lugano
Notre-Dame-des-Bois	Notre-Dame-des-Bois, Quebec
Dead Wrong	Dead Wrong (song)
Petrarca Rugby Padua	Petrarca Rugby
Forgot About Dre	Forgot About Dre
Rama VII	Prajadhipok
Taddea Visconti	Taddea Visconti
Dacia Duster	Dacia Duster
The Time of Our Lives (album)	The Time of Our Lives (EP)
Assemblée nationale (Québec)	National Assembly of Quebec
Fussball-Club Aarau	FC Aarau
Season 2 of Angel	Angel (season 2)
3rd army (United States)	United States Army Central
Marguerite Tudor	Margaret Tudor
Lokomotiv Moscow (football)	FC Lokomotiv Moscow
La Vallée-de-la-Gatineau	La Vallée-de-la-Gatineau Regional County Municipality
Tamil	Tamil language
Far Cry (series)	Far Cry
FK Dynamo Moscow	FC Dynamo Moscow
Brendan Morrison	Brendan Morrison
Italo Calvino	Italo Calvino
Government Stolojan	Stolojan I Cabinet
Forza Italia (1994)	Forza Italia
Herbie Hancock	Herbie Hancock
Christian Democracy (Italy)	Christian Democracy (Italy)
Duke University	Duke University
Kayōkyoku	Kayōkyoku
Independent Democratic Union	Independent Democratic Union
ROOTS	R.O.O.T.S.
Grand Theft Auto 2	Grand Theft Auto 2
50 Cent	50 Cent
South Africa football team	South Africa national football team
David Rice Atchison	David Rice Atchison
Sad but True	Sad but True
Carthage	Carthage
Prince-Edward-Island	Prince Edward Island
Guns N' Roses	Guns N' Roses
Henri VIII	Henry VIII of England
Saint-François-du-Lac	Saint-François-du-Lac, Quebec
Revival (album de Selena Gomez)	Revival (Selena Gomez album)
Roberto Maroni	Roberto Maroni
Palermo	Palermo
Hervé Mariton	Hervé Mariton
Grand Bilbao	Greater Bilbao
John Robertson (politician, Australia)	John Robertson (New South Wales Premier)
Dejavu	Dejavu (Kumi Koda album)
Ross County Football Club	Ross County F.C.
Bono	Bono
41st parliament of canada	41st Canadian Parliament
Azeri	Azerbaijani language
Territoire de Pondicherry	Puducherry
Sheer Heart Attack	Sheer Heart Attack
Portuguese Ligue de football professionnel	Liga Portuguesa de Futebol Profissional
Prime Minister of the United Kingdom	Prime Minister of the United Kingdom
House of Windsor	House of Windsor
Google Chrome	Google Chrome
Jaume Bartumeu Cassany	Jaume Bartumeu
Everybody Hurts	Everybody Hurts
École normale superieure (Paris)	École Normale Supérieure
The Raconteurs	The Raconteurs
Private Dancer	Private Dancer
Krasnodar Krai	Krasnodar Krai
Midnight City	Midnight City
Bourget (district provincial)	Bourget (electoral district)
Jean-Pierre Raffarin	Jean-Pierre Raffarin
Uppsala Cathedral	Uppsala Cathedral
Loveppears	Loveppears
Head of the Tunisian Government	Head of Government of Tunisia
Éléonore d'Aragon (1358-1382)	Eleanor of Aragon, Queen of Castile
Dance-pop	Dance-pop
Chris Brown (album)	Chris Brown (album)
Philippe Séguin	Philippe Séguin
Louise-Marie de Gonzague	Marie Louise Gonzaga
Method Man	Method Man
Mohammed ben Nayef Al Saoud	Muhammad bin Nayef
Can't Get It Out of My Head	Can't Get It Out of My Head
Yvelines	Yvelines
Faustin-Archange Touadéra	Faustin-Archange Touadéra
Derrick Green	Derrick Green
African Union	African Union
Championnat du Japon de football	J1 League
Avicenna	Avicenna
Valdas Adamkus	Valdas Adamkus
Janet.	Janet (album)
Jämtland	Jämtland
Liverpool Football Club	Liverpool F.C.
Ramón González Valencia	Ramón González Valencia
Ferdinand II (king of Portugal)	Ferdinand II of Portugal
Voice (album de Mika Nakashima)	Voice (Mika Nakashima album)
Carl Bildt	Carl Bildt
Mary of Hungary (1257-1323)	Mary of Hungary, Queen of Naples
Fontana Records	Fontana Records
Marc Garneau	Marc Garneau
Liberal Party of British Columbia	British Columbia Liberal Party
STS-71	STS-71
Sony Music Entertainment	Sony Music Entertainment
James H. Doolittle	Jimmy Doolittle
Udinese Calcio	Udinese Calcio
Lot (river)	Lot (river)
Edmund James Flynn	Edmund James Flynn
Soyuz TMA-16	Soyuz TMA-16
You Rock My World	You Rock My World
Mario Lemieux	Mario Lemieux
Soyuz TMA-07M	Soyuz TMA-07M
Joey Jordison	Joey Jordison
President of the United States	President of the United States
Simon Gallup	Simon Gallup
Antalyaspor	Antalyaspor
Bradford Bulls	Bradford Bulls
Rudolf Carnap	Rudolf Carnap
Michael Leighton	Michael Leighton
President of Romania	President of Romania
Butch Otter	Butch Otter
Popular Army of the Spanish Republic	Spanish Republican Army
Soleimane Frangié	Suleiman Frangieh
This Boy	This Boy
Guy Simonds	Guy Simonds
Macedonia football team	Macedonia national football team
Houston	Houston
Hery Rajaonarimampianina	Hery Rajaonarimampianina
Democrats of Sweden	Sweden Democrats
Republican Left of Catalonia	Republican Left of Catalonia
Czech Social Democratic Party	Czech Social Democratic Party
Mike Dirnt	Mike Dirnt
Yōichi Masuzoe	Yōichi Masuzoe
Venezuela	Venezuela
Seasons (song)	Seasons (Ayumi Hamasaki song)
Al Pitrelli	Al Pitrelli
Johan Rudolf Thorbecke	Johan Rudolph Thorbecke
Juhan Parts	Juhan Parts
Sándor Wekerle	Sándor Wekerle
Ms. Kelly	Ms. Kelly
Calabasas	Calabasas, California
Pow R. Toc H.	Pow R. Toc H.
Mario Dumont	Mario Dumont
Shinzō Abe	Shinzō Abe
Sigmund Freud	Sigmund Freud
Stade Ahmadou-Ahidjo	Stade Ahmadou Ahidjo
Mama (song)	Mama (Genesis song)
Shimon Peres	Shimon Peres
Denny Laine	Denny Laine
Waiting for the End	Waiting for the End (Linkin Park song)
Assens (Vaud)	Assens, Switzerland
Jean (grand-duke of Luxembourg)	Jean, Grand Duke of Luxembourg
Giórgos Papandreou (1952)	George Papandreou
Ken Nelson	Ken Nelson (British record producer)
Century Media Records	Century Media Records
Imaginaerum	Imaginaerum
Use Your Illusion II	Use Your Illusion II
Honduras football team	Honduras national football team
Castille-La Manche	Castilla-La Mancha
Asse (Belgium)	Asse
Michael Hainisch	Michael Hainisch
José Froilán González	José Froilán González
Wuppertal	Wuppertal
Social Democrats (Denmark)	Social Democrats (Denmark)
You've Really Got a Hold on Me	You've Really Got a Hold on Me
The Best of Depeche Mode Volume 1	The Best of Depeche Mode Volume 1
National Transition Council (Libya)	National Transitional Council
Poupe (constellation)	Puppis
Arthur Meighen	Arthur Meighen
Pasqual Maragall	Pasqual Maragall i Mira
Libourne	Libourne
Viktor Fasth	Viktor Fasth
Grande Armée	Grande Armée
Lenita Toivakka	Lenita Toivakka
Jawaharlal Nehru	Jawaharlal Nehru
Mary Robinson	Mary Robinson
Fianna Fáil	Fianna Fáil
John Tortorella	John Tortorella
Recharged	Recharged
Joan Martí i Alanis	Joan Martí i Alanis
Theodore Roosevelt	Theodore Roosevelt
Guillaume d'Ockham	William of Ockham
Stade du Pacaembu	Pacaembu Stadium
Jam band	Jam band
Jean XXIII	Pope John XXIII
Andrzej Duda	Andrzej Duda
East Fife Football Club	East Fife F.C.
Harold Melvin & the Blue Notes	Harold Melvin & the Blue Notes
Bellevue (Washington)	Bellevue, Washington
University of Texas at Austin	University of Texas at Austin
Arkansas	Arkansas
German federal elections 2013	German federal election, 2013
The White Stripes	The White Stripes
Headquarters of Leningrad	Siege of Leningrad
Léopold Sédar Senghor	Léopold Sédar Senghor
Taylor Swift	Taylor Swift
Winthrop Rockefeller	Winthrop Rockefeller
Hans-Dietrich Genscher	Hans-Dietrich Genscher
Sainte-Gertrude-Manneville	Sainte-Gertrude-Manneville, Quebec
Bryan Fogarty	Bryan Fogarty
Kapelle-op-den-Bos	Kapelle-op-den-Bos
Lucian Truscott	Lucian Truscott
Secret (Ayumi Hamasaki album)	Secret (Ayumi Hamasaki album)
SSC Naples	S.S.C. Napoli
James B. Edwards	James B. Edwards
DEG Metro Stars	Düsseldorfer EG
Carla Anderson Hills	Carla Anderson Hills
One by One (album des Foo Fighters)	One by One (Foo Fighters album)
Mexican Football Championship	Liga MX
County of Carlow	County Carlow
Shakin' Hands	Shakin' Hands
Bertrand (district provincial)	Bertrand (electoral district)
Ludovica from Bavaria	Princess Ludovika of Bavaria
Basil McRae	Basil McRae
Brian Wilson	Brian Wilson
Georges Ier de Saxe	George, King of Saxony
Andrew Mellon	Andrew Mellon
Scottish Parliament	Scottish Parliament
Occupation of Austria after the Second World War	Allied-occupied Austria
House Tudor	House of Tudor
Marie-Jeanne-Baptiste de Savoie	Marie Jeanne Baptiste of Savoy-Nemours
Doug Weight	Doug Weight
Pictures of You	Pictures of You (The Cure song)
Alias Season 2	Alias (season 2)
Daniel Tkaczuk	Daniel Tkaczuk
FC Barcelona B	FC Barcelona B
ABC Records	ABC Records
Opel Mokka	Opel Mokka
Independent State of Croatia	Independent State of Croatia
Jeremy Corbyn	Jeremy Corbyn
Seine	Seine
FK Mladá Boleslav	FK Mladá Boleslav
Florvil Hyppolite	Florvil Hyppolite
War of Spanish Succession	War of the Spanish Succession
Shandong Luneng Taishan	Shandong Luneng Taishan F.C.
European Coupe des football cup winners 1998-1999	1998–99 UEFA Cup Winners' Cup
Ronald Brown	Ron Brown (U.S. politician)
Washington (State)	Washington (state)
André Bettencourt	André Bettencourt
Fever (song of Little Willie John)	Fever (Little Willie John song)
Dickey Betts	Dickey Betts
Anjou–Louis-Riel	Anjou–Louis-Riel
Waking the Fallen	Waking the Fallen
Spanish Armed Forces	Spanish Armed Forces
Lessons to Be Learned	Lessons to Be Learned
Friedrich Nietzsche	Friedrich Nietzsche
The Chemical Brothers	The Chemical Brothers
Metalcore	Metalcore
Espérance Sportive Troyes Aube Champagne	Troyes AC
Out of Our Heads	Out of Our Heads
Get Your Wings	Get Your Wings
Ludwig Erhard	Ludwig Erhard
Campinas	Campinas
Andy Burnham	Andy Burnham
Don't Lie	Don't Lie
Soul to Squeeze	Soul to Squeeze
Mavericks of Dallas	Dallas Mavericks
House of Burgundy in Portugal	Portuguese House of Burgundy
Tom Corbett	Tom Corbett
Lou Reed	Lou Reed
Sheezus	Sheezus
Parti républicain (France)	Republican Party (France)
Paul Quilès	Paul Quilès
The Immaculate Collection	The Immaculate Collection
Antónia de Braganza	Infanta Maria Antonia of Portugal
Origin of Symmetry	Origin of Symmetry
Itamar Franco	Itamar Franco
John Fogerty	John Fogerty
Kazan	Kazan
Senate (Spain)	Senate of Spain
Graffiti Bridge (album)	Graffiti Bridge (album)
University of Ottawa	University of Ottawa
India football team	India national football team
Ministry of Defence (Spain)	Ministry of Defence (Spain)
Saint-Roch-de-l'Achigan	Saint-Roch-de-l'Achigan, Quebec
Deux-Sèvres	Deux-Sèvres
Noel Gayler	Noel Gayler
Ahmed ben Abdelaziz Al Saoud	Ahmed bin Abdulaziz Al Saud
Guangdong	Guangdong
Birdman (rapper)	Birdman (rapper)
You Like Me Too Much	You Like Me Too Much
House of Councillors (Japan)	House of Councillors (Japan)
Horace Smith-Dorrien	Horace Smith-Dorrien
Willie Nelson	Willie Nelson
Ingvar Carlsson	Ingvar Carlsson
Mark Jansen	Mark Jansen
The Byrds	The Byrds
Saint-Ignace-de-Loyola	Saint-Ignace-de-Loyola, Quebec
Teen pop	Teen pop
A Quick One, While He's Away	A Quick One, While He's Away
James Callaghan	James Callaghan
Trick-Trick	Trick-Trick
Fiat 500L	Fiat 500L
Jacques Flynn	Jacques Flynn
Hashim Thaçi	Hashim Thaçi
Matra Sports	Equipe Matra Sports
Monza	Monza
Salé	Salé
Matti Vanhanen	Matti Vanhanen
Fuji Television	Fuji Television
Irish War of Independence	Irish War of Independence
Marie de Bourgogne	Mary of Burgundy
Doggystyle	Doggystyle
Cassiopeia (constellation)	Cassiopeia (constellation)
Arsenal Football Club	Arsenal F.C.
Jaime Gama	Jaime Gama
Just Like a Woman	Just Like a Woman
The Pogues	The Pogues
Barrie	Barrie
DC	DC
South of Heaven	South of Heaven
Eve-Olution	Eve-Olution
Rykodisc	Rykodisc
Les Pays-d’en-Haut	Les Pays-d'en-Haut Regional County Municipality
Life in Cartoon Motion	Life in Cartoon Motion
Theodor W. Adorno	Theodor W. Adorno
Augsburg	Augsburg
Barbara Bush	Barbara Bush
Miss Univers 1953	Miss Universe 1953
Edward Schafer	Ed Schafer
Mike Hawthorn	Mike Hawthorn
Espoo	Espoo
Oxford University	University of Oxford
Bohuslav Sobotka	Bohuslav Sobotka
Sale Sharks	Sale Sharks
Amman international stadium	Amman International Stadium
Nâdiya	Nâdiya
Angola	Angola
Katowice	Katowice
Albert Reynolds	Albert Reynolds
Placebo (group)	Placebo (band)
Gaspard Fauteux	Gaspard Fauteux
Licensed to Ill	Licensed to Ill
Baie-de-la-Bouteille	Baie-de-la-Bouteille, Quebec
Be My Last	Be My Last
Pär Arlbrandt	Pär Arlbrandt
Marie d'Aragon	Maria of Aragon, Queen of Portugal
Echoes (song)	Echoes (Pink Floyd song)
Philippa de Lancâtre	Philippa of Lancaster
Liu Shaoqi	Liu Shaoqi
Platinum 9 Disc	Platinum 9 Disc
Boris Williams	Boris Williams
Qing Dynasty	Qing dynasty
Martin Ier d'Aragon	Martin of Aragon
Louis-Amable Jetté	Louis-Amable Jetté
Apologize	Apologize (OneRepublic song)
European Union	European Union
Swamp pop	Swamp pop
Alan John Dixon	Alan J. Dixon
Young Justice	Young Justice
Les Cèdres (Quebec)	Les Cèdres, Quebec
Wiesbaden	Wiesbaden
Church of Riddarholmen	Riddarholm Church
André de Grèce	Prince Andrew of Greece and Denmark
Podemos (spanish party)	Podemos (Spanish political party)
West Bolton	West Bolton, Quebec
Zuidplas	Zuidplas
Socialist Republic of Croatia	Socialist Republic of Croatia
President of the Republic of China (Taiwan)	President of the Republic of China
Mary of England (1496-1533)	Mary Tudor, Queen of France
European parliament	European Parliament
Maxime Bernier	Maxime Bernier
Malaga	Málaga
Brenden Morrow	Brenden Morrow
Region de Bruxelles-Capitale	Brussels
Celta de Vigo	Celta de Vigo
British Racing Motors	British Racing Motors
Bottens	Bottens
Warriors of Golden State	Golden State Warriors
Jeh Johnson	Jeh Johnson
Saint-Simon (Les Basques)	Saint-Simon, Bas-Saint-Laurent, Quebec
Jody Hull	Jody Hull
Édouard Balladur	Édouard Balladur
Exposition universelle de 1958	Expo 58
Sergei Ivanov (politician)	Sergei Ivanov
The Sweet Escape	The Sweet Escape
Vassy (singer)	Vassy (singer)
Lucien Bouchard	Lucien Bouchard
Citroën ZX	Citroën ZX
Techno de troit	Detroit techno
Friedrich Engels	Friedrich Engels
Federal Ministry of Justice (Germany)	Federal Ministry of Justice and Consumer Protection
Lenzburg	Lenzburg
Danish-Americans	Danish Americans
Croatian Democratic Union	Croatian Democratic Union
Muse (group)	Muse (band)
Dre and Vidal	Dre & Vidal
Rivière-Mistassini	Rivière-Mistassini, Quebec
White Zombie	White Zombie (band)
Mouldi Kefi	Mouldi Kefi
Robert L. Gibson	Robert L. Gibson
Renault Laguna	Renault Laguna
Carl Perkins	Carl Perkins
Boulevard of Broken Dreams	Boulevard of Broken Dreams (Green Day song)
Yuri Andropov	Yuri Andropov
Reform Party of Estonia	Estonian Reform Party
Témiscamingue	Témiscamingue Regional County Municipality
British Monarchy	Monarchy of the United Kingdom
Niger	Niger
Fenerbahçe Spor Kulübü (football)	Fenerbahçe S.K. (football)
Osella	Osella
Boris Yeltsin	Boris Yeltsin
Vincent Auriol	Vincent Auriol
Johntà Austin	Johntá Austin
Ghettotech	Ghettotech
Rap metal	Rap metal
Jeremiah Denton	Jeremiah Denton
Louis-Alexandre Berthier	Louis-Alexandre Berthier
Deep Purple	Deep Purple
Dominique de Villepin	Dominique de Villepin
Parti québécois	Parti Québécois
Courteney Cox	Courteney Cox
Faouzia Fouad	Fawzia Fuad of Egypt
Shaukat Aziz	Shaukat Aziz
Ségolène Royal	Ségolène Royal
Monique Gagnon-Tremblay	Monique Gagnon-Tremblay
Lyndon B. Johnson	Lyndon B. Johnson
Rap-A-Lot Records	Rap-A-Lot Records
Bury Football Club	Bury F.C.
Did I Let You Know	Did I Let You Know
Greatest Hits (album de 2Pac)	Greatest Hits (Tupac Shakur album)
Hohenrain	Hohenrain
Egyptian Football Championship	Egyptian Premier League
Jerry Mateparae	Jerry Mateparae
Charlevoix-Est	Charlevoix-Est Regional County Municipality
Outaouais (Quebec)	Outaouais
Nikki Sixx	Nikki Sixx
For All the Cows	For All the Cows
Johnny Herbert	Johnny Herbert
Monthey	Monthey
Werner Faymann	Werner Faymann
Jan Fischer	Jan Fischer (politician)
Liberal-Democratic Party (Japan)	Liberal Democratic Party (Japan)
France 2	France 2
Omar Karame	Omar Karami
Saint-André-Avellin	Saint-André-Avellin, Quebec
Bob Kerrey	Bob Kerrey
Wizards of Washington	Washington Wizards
Genoa	Genoa
Hardcore Justice	Hardcore Justice
Frédéric Bastiat	Frédéric Bastiat
Kingdom of Romania	Kingdom of Romania
Fussball-Club Thun	FC Thun
The Cult	The Cult
Manic Street Preachers	Manic Street Preachers
Mikhail Koutouzov	Mikhail Kutuzov
Tim Rice-Oxley	Tim Rice-Oxley
Saint-Modeste	Saint-Modeste, Quebec
Paolo Nespoli	Paolo Nespoli
Norman Steenrod	Norman Steenrod
Ladislaus I of Poland	Władysław I the Elbow-high
Brian Connolly	Brian Connolly
Chef de cabinet de la Maison-Blanche	White House Chief of Staff
Weather Report	Weather Report
Elastic Heart	Elastic Heart
Construction Time Again	Construction Time Again
Government Sipilä	Sipilä Cabinet
Moderate (Sweden)	Moderate Party
Campania	Campania
Château-d'Œx	Château-d'Œx
Kate Austen	Kate Austen
Grateful Dead	Grateful Dead
United States Senate	United States Senate
Tarbes	Tarbes
Psychobilly	Psychobilly
Sainte-Praxède	Sainte-Praxède, Quebec
The Man Who Sold the World (song)	The Man Who Sold the World
KSC Lokeren	K.S.C. Lokeren Oost-Vlaanderen
Shy'm	Shy'm
Parish of Burton	Burton Parish, New Brunswick
Pennsylvania State University	Pennsylvania State University
Alassane Ouattara	Alassane Ouattara
Cello rock	Cello rock
Shibuya-kei	Shibuya-kei
La Oreja de Van Gogh	La Oreja de Van Gogh
SK Brann	SK Brann
Ante Pavelić	Ante Pavelić
Standing on the Shoulder of Giants	Standing on the Shoulder of Giants
Head of the Government of Andorra	List of heads of government of Andorra
Richard O'Connor	Richard O'Connor
Nkosazana Dlamini-Zuma	Nkosazana Dlamini-Zuma
Hun Sen	Hun Sen
Funky house	Funky house
Soyuz 10	Soyuz 10
Halloween Havoc	Halloween Havoc
Province of Tarragona	Province of Tarragona
Dave Stewart (singer)	David A. Stewart
Stevenage Football Club	Stevenage F.C.
Survivor (album de Destiny's Child)	Survivor (Destiny's Child album)
Seine-Saint-Denis	Seine-Saint-Denis
T-ara	T-ara
Pop psychédélique	Psychedelic pop
Sixth Coalition	War of the Sixth Coalition
Vladimir Titov	Vladimir Georgiyevich Titov
Protagoras	Protagoras
Moldova	Moldova
Kiss Me, Kiss Me, Kiss Me	Kiss Me, Kiss Me, Kiss Me
Serbia team football hopes	Serbia national under-21 football team
Dareka no Negai ga Kanau Koro	Dareka no Negai ga Kanau Koro
Kingdom of Portugal	Kingdom of Portugal
Jürgen Schmude	Jürgen Schmude
Guillaume III (king of the Netherlands)	William III of the Netherlands
Zine el-Abidine Ben Ali	Zine El Abidine Ben Ali
Quezon City	Quezon City
Caroline de Bade	Caroline of Baden
ERC Ingolstadt	ERC Ingolstadt
John Howard (politician)	John Howard
The Fray	The Fray
Wings of Kalamazoo	Kalamazoo Wings
Lech Wałęsa	Lech Wałęsa
Honshu	Honshu
All My Life (song of Foo Fighters)	All My Life (Foo Fighters song)
Please Please Me (album)	Please Please Me
Rusty Cage	Rusty Cage
Arrondissement de Riom	Arrondissement of Riom
Union Royale Belge des Sociétés de Football-Association	Royal Belgian Football Association
Low (Quebec)	Low, Quebec
Lac-Jacques-Cartier	Lac-Jacques-Cartier, Quebec
French Polynesia	French Polynesia
Ana Botella	Ana Botella
Metal gothique	Gothic metal
Çaykur Rizespor	Çaykur Rizespor
Antonio Villaraigosa	Antonio Villaraigosa
Gembloux	Gembloux
Castle of Glass	Castle of Glass
Chris Ferraro	Chris Ferraro
Roman Herzog	Roman Herzog
Kasterlee	Kasterlee
Côte-Saint-Luc	Côte-Saint-Luc
Peugeot 306	Peugeot 306
Wild Ones (song)	Wild Ones (song)
Routhierville	Routhierville, Quebec
Hope (Quebec)	Hope, Quebec
Freedom Party	Party for Freedom
Royal Excel Mouscron	Royal Mouscron-Péruwelz
NEC Nijmegen	N.E.C. (football club)
Rexhep Mejdani	Rexhep Meidani
Harold Alexander	Harold Alexander, 1st Earl Alexander of Tunis
Marseille	Marseille
Roman Republic	Roman Republic
Charles II (duke of Parma)	Charles II, Duke of Parma
Civic choice for Italy	Civic Choice
Kazabazua	Kazabazua, Quebec
Socialist Republic of Macedonia	Socialist Republic of Macedonia
Kawi	Kawi language
Diácono João Luiz Pozzobon	Diácono João Luiz Pozzobon
Wish (album de The Cure)	Wish (The Cure album)
Bosnian	Bosnian language
Czech Republic Football Championship	Czech First League
Viktor Zoubkov	Viktor Zubkov
Grandson	Grandson, Switzerland
Raw Power	Raw Power
James D. Halsell	James D. Halsell
Dorval	Dorval
Picard (Quebec)	Picard, Quebec
United States Attorney General	United States Attorney General
Championnat de France amateur de football 2008-2009	2008–09 Championnat de France amateur
Super Smash Bros. (series)	Super Smash Bros.
Northern soul	Northern soul
Ruff Ryders Entertainment	Ruff Ryders Entertainment
Isaac Newton	Isaac Newton
Norbert Röttgen	Norbert Röttgen
STS-35	STS-35
Joliette (Quebec)	Joliette
Cherry Red	Cherry Red Records
António Maria da Silva	António Maria da Silva
Space Cowboy	Space Cowboy (musician)
Club Bruges KV	Club Brugge KV
Grand-Métis	Grand-Métis, Quebec
Helmut Kohl	Helmut Kohl
Aartselaar	Aartselaar
Willem II Tilburg	Willem II (football club)
Francesco Crispi	Francesco Crispi
Stark Industries	Stark Industries
Beziers	Béziers
Terence T. Henricks	Terence T. Henricks
Gotta Be Somebody	Gotta Be Somebody
Franklin Pierce	Franklin Pierce
Richard von Weizsäcker	Richard von Weizsäcker
Acton Vale	Acton Vale, Quebec
Geoffroy V d'Anjou	Geoffrey Plantagenet, Count of Anjou
Valeri Korzoune	Valery Korzun
New Zealand Labour Party	New Zealand Labour Party
Rivière-aux-Outardes	Rivière-aux-Outardes, Quebec
Wang Lee-hom	Wang Leehom
Extreme Championship Wrestling (WWE)	ECW (WWE)
Volvo (automotive)	Volvo Cars
Fuck You!	Fuck You (CeeLo Green song)
Derry	Derry
Konrad Adenauer	Konrad Adenauer
L'Isle (Vaud)	L'Isle
Shallow Be Thy Game	Shallow Be Thy Game
Homeward Bound	Homeward Bound (song)
Richard Coeur de Lion	Richard I of England
FC Steaua Bucharest	FC Steaua București
Death metal melodic	Melodic death metal
Where Them Girls At	Where Them Girls At
University of Melbourne	University of Melbourne
A-ha	A-ha
Casimir IV Jagellon	Casimir IV Jagiellon
Octopus's Garden	Octopus's Garden
Sainte-Anne-du-Sault	Sainte-Anne-du-Sault, Quebec
Université Laval	Laval University
Phil Hill	Phil Hill
William John Bennett	William Bennett
Here We Go Again (album de Demi Lovato)	Here We Go Again (Demi Lovato album)
De Graafschap Doetinchem	De Graafschap
Israeli Labour Party	Israeli Labor Party
Cadiz	Cádiz
Eeyou Istchee Baie-James (municipality)	Baie-James
Edition of Contemporary Music	ECM Records
Alfredo de Sá Cardoso	Alfredo de Sá Cardoso
Edwige-Sophie de Suède	Hedvig Sophia of Sweden
Tcherno More Varna	PFC Cherno More Varna
Bullet	Bullet, Switzerland
Ulster Unionist Party	Ulster Unionist Party
Phil Spector	Phil Spector
Menino Jesus	Menino Jesus
Roberto Venturini	Roberto Venturini
Hyderabad	Hyderabad
Dom Antônio Reis	Dom Antônio Reis
England	England
Policy of Truth	Policy of Truth
FK Anji Makhachkala	FC Anzhi Makhachkala
Nelson Mandela	Nelson Mandela
Football League	The Football League
County of San Mateo	San Mateo County, California
Petro Poroshenko	Petro Poroshenko
Sunita Williams	Sunita Williams
Buddy Holly	Buddy Holly
Erwin Rommel	Erwin Rommel
Saint-Henri (Quebec)	Saint-Henri, Chaudière-Appalaches, Quebec
La Jolla	La Jolla
Delhi	Delhi
Brad Marsh	Brad Marsh
Galilée (savant)	Galileo Galilei
Andrius Kubilius	Andrius Kubilius
Mirrors (son de Justin Timberlake)	Mirrors (Justin Timberlake song)
Bruins de Providence	Providence Bruins
Kilmarnock Football Club	Kilmarnock F.C.
Saint-Séverin (Mékinac)	Saint-Séverin, Mauricie, Quebec
Juventus Football Club	Juventus F.C.
Virden (Manitoba)	Virden, Manitoba
Joe Murphy	Joe Murphy (ice hockey)
Ibiza	Ibiza
Dub	Dub music
Carignan (Quebec)	Carignan, Quebec
Humanoid (album)	Humanoid (album)
Live After Death	Live After Death
Nataša Mićić	Nataša Mićić
Mercy (son de Duffy)	Mercy (Duffy song)
Pyrenees	Pyrenees
Howie Morenz	Howie Morenz
Socialist International	Socialist International
Ardennes (department)	Ardennes (department)
Norodom Sihanouk	Norodom Sihanouk
Cup of the English League of football 2015-2016	2015–16 Football League Cup
Bowman (Quebec)	Bowman, Quebec
Uppsala	Uppsala
Lac-au-Saumon	Lac-au-Saumon, Quebec
Oleg Kotov	Oleg Kotov
2010 Winter Olympic Games	2010 Winter Olympics
Sgt. Pepper's Lonely Hearts Club Band (album)	Sgt. Pepper's Lonely Hearts Club Band
European Commissioner for Economic and Monetary Affairs	European Commissioner for Economic and Monetary Affairs and the Euro
Jim McCarty (drummer)	Jim McCarty
Alain Juppé	Alain Juppé
Antonio Segni	Antonio Segni
Argentina football team	Argentina national football team
New York Islanders	New York Islanders
America	Americas
Université Jagiellon	Jagiellonian University
Satakunta	Satakunta
Return to Forever	Return to Forever
Ängelholm	Ängelholm
Krasnodar	Krasnodar
Line of Sørland	Sørlandet Line
All Hope Is Gone (song)	All Hope Is Gone (song)
North Korea	North Korea
Rock With You (song)	Rock with You (BoA song)
Cape Town	Cape Town
Chilean Football Cup	Copa Chile
Horatio Herbert Kitchener	Herbert Kitchener
Raymond Poincaré	Raymond Poincaré
River Rats d'Albany	Albany River Rats
Roman Čechmánek	Roman Čechmánek
Baron Strucker	Baron Strucker
Newport (Estrie)	Newport, Quebec
Jean V (king of Portugal)	John V of Portugal
Folk psychedelic	Psychedelic folk
Italy football team	Italy national football team
Acid techno	Acid techno
Kyriakos Mitsotakis	Kyriakos Mitsotakis
General Motors	General Motors
Association sportive de Béziers Hérault	AS Béziers Hérault
University of Alberta	University of Alberta
Gare de Stabekk	Stabekk Station
Angelo Sodano	Angelo Sodano
Stade brestois 29	Stade Brestois 29
Ferdinand II (emperor of the Romans)	Ferdinand II, Holy Roman Emperor
Sebaa	Sbaa
Zomba Label Group	Zomba Group of Companies
Citroën Traction Avant	Citroën Traction Avant
Brian Sutter	Brian Sutter
Van Halen	Van Halen
Ronnie Peterson	Ronnie Peterson
Ham-Sud	Ham-Sud, Quebec
Mötley Crüe	Mötley Crüe
Malaysia	Malaysia
Maçanet de Cabrenys	Maçanet de Cabrenys
TATu	T.A.T.u.
Terek Grozny	FC Terek Grozny
Beautiful Day (song)	Beautiful Day
Paul Krugman	Paul Krugman
Régime de Vichy	Vichy France
Thomas d'Aquin	Thomas Aquinas
Alsace-Champagne-Ardenne-Lorraine	Alsace-Champagne-Ardenne-Lorraine
President of the government of Serbia	Prime Minister of Serbia
South End (Boston)	South End, Boston
The Downward Spiral	The Downward Spiral
Fontes Pereira de Melo	Fontes Pereira de Melo
Carnival Ride	Carnival Ride
Good Kid, M.AAD City	Good Kid, M.A.A.D City
Nissan Sentra	Nissan Sentra
Sounds from Nowheresville	Sounds from Nowheresville
Imagine (song)	Imagine (John Lennon song)
Tonight, Tonight, Tonight	Tonight, Tonight, Tonight
Victor-Emmanuel II	Victor Emmanuel II of Italy
Beatrice Ask	Beatrice Ask
Predators de Nashville	Nashville Predators
The Revolution (group)	The Revolution (band)
María de las Mercedes de Bourbon (1880-1904)	Mercedes, Princess of Asturias
The Main	The Hand (comics)
TNA Final Resolution	Final Resolution
Boy George	Boy George
Courrendlin	Courrendlin
Manicouagan (regional county municipality)	Manicouagan Regional County Municipality
Parachutes (album)	Parachutes (album)
Menznau	Menznau
Geoff Regan	Geoff Regan
Calgary	Calgary
Nord-Pas-de-Calais-Picardie	Nord-Pas-de-Calais-Picardie
Val-Morin	Val-Morin, Quebec
City of Brussels	City of Brussels
Championnat de France de football 2005-2006	2005–06 Ligue 1
Adam Foote	Adam Foote
Felipe Massa	Felipe Massa
Sportclub Heerenveen	SC Heerenveen
Kevin Kregel	Kevin R. Kregel
Yukon	Yukon
Delta Machine	Delta Machine
Screamo	Screamo
Federal President (Germany)	President of Germany
Henry of Mecklenburg-Schwerin (duke)	Prince Henry, Duke of Mecklenburg-Schwerin
Salt Lake City	Salt Lake City
Government Kiviniemi	Kiviniemi Cabinet
Stock Aitken Waterman	Stock Aitken Waterman
X (album de Kylie Minogue)	X (Kylie Minogue album)
Post-rock	Post-rock
Gare de Nittedal	Nittedal Station
List of Prime Ministers of Yugoslavia	Prime Minister of Yugoslavia
Archdiocese of Mechelen-Brussels	Roman Catholic Archdiocese of Mechelen-Brussels
Rock 'n' Roll Circus (album)	Rock 'n' Roll Circus
Cater 2 U	Cater 2 U
Victor Marijnen	Victor Marijnen
Muslim League of Pakistan (N)	Pakistan Muslim League (N)
Sainte-Hélène-de-Bagot	Sainte-Hélène-de-Bagot, Quebec
Democrats 66	Democrats 66
Georges Bidault	Georges Bidault
Fédor Ier	Feodor I of Russia
Sergueï Krikaliov	Sergei Krikalev
Coupe des clubs champions europeans 1957-1958	1957–58 European Cup
Glen Hanlon	Glen Hanlon
Botafogo de Futebol e Regatas	Botafogo de Futebol e Regatas
Timo Soini	Timo Soini
The New York Dolls	New York Dolls
Chamois niortais Football Club	Chamois Niortais F.C.
Henri Becquerel	Henri Becquerel
Barraute	Barraute, Quebec
Tottenham Hotspur Football Club	Tottenham Hotspur F.C.
Rodolfo Graziani	Rodolfo Graziani
Portugal	Portugal
Dennis Rodman	Dennis Rodman
Bolton Wanderers Football Club	Bolton Wanderers F.C.
University of Iceland	University of Iceland
Enslaved	Enslaved (band)
Andrew Card	Andrew Card
Angel of Death	Angel of Death (Slayer song)
Spanish War	Spanish Civil War
André 3000	André 3000
Villeneuve (Vaud)	Villeneuve, Vaud
Ruthless Records (Los Angeles)	Ruthless Records
Mark Pederson	Mark Pederson
Paul Sauvé	Paul Sauvé
Trap (music)	Trap music
Jean Ier (roi de Portugal)	John I of Portugal
The People of Freedom	The People of Freedom
Jeanne Ire la Folle	Joanna of Castile
Jonathan Kaplan (director)	Jonathan Kaplan
Ego Trippin'	Ego Trippin'
Peterborough (Ontario)	Peterborough, Ontario
Otter Lake	Otter Lake, Quebec
Saint-Arsène	Saint-Arsène, Quebec
Crise du canal de Suez	Suez Crisis
Ollon	Ollon
Province de Lleida	Province of Lleida
Sainte-Anne-de-Bellevue	Sainte-Anne-de-Bellevue, Quebec
Parade (album)	Parade (Prince album)
HC Kometa Brno	HC Kometa Brno
Lulu (singer)	Lulu (singer)
Parti socialiste (Belgium)	Parti Socialiste (Belgium)
Russia	Russia
Le Havre	Le Havre
Ariel Sharon	Ariel Sharon
People Are People	People Are People
Magog	Magog, Quebec
Marie II (queen of Portugal)	Maria II of Portugal
Paul Simonon	Paul Simonon
Don't You Worry Child	Don't You Worry Child
Three Imaginary Boys	Three Imaginary Boys
Agglomeration of Longueuil	Urban agglomeration of Longueuil
Jean-Pierre Bel	Jean-Pierre Bel
Yukon New Democratic Party	Yukon New Democratic Party
Welsh (people)	Welsh people
Vevey	Vevey
Ministry of Defence Finland	Minister of Defence (Finland)
Midnight Love	Midnight Love
William P. Clark	William P. Clark, Jr.
Willi Stoph	Willi Stoph
William Wirt	William Wirt (Attorney General)
Rocks	Rocks (Aerosmith album)
Mantua	Mantua
Vassili Chuikov	Vasily Chuikov
AFC Champions League	AFC Champions League
A Saucerful of Secrets (song)	A Saucerful of Secrets (song)
Rick Nelson	Ricky Nelson
John Belushi	John Belushi
Nicolas Machiavelli	Niccolò Machiavelli
Army Distinguished Service Medal	Distinguished Service Medal (U.S. Army)
Never Gonna Be Alone	Never Gonna Be Alone
Spread Your Wings	Spread Your Wings
Sainte-Christine (Quebec)	Sainte-Christine, Quebec
Ferenc Gyurcsány	Ferenc Gyurcsány
Victoria (queen)	Queen Victoria
Charles IV de Lorraine	Charles IV, Duke of Lorraine
James K. Polk	James K. Polk
Giorgio Borg Olivier	George Borg Olivier
Rap West Coast	West Coast hip hop
Poison (song)	Poison (Alice Cooper song)
Wolf Pack de Hartford	Hartford Wolf Pack
David Lloyd Johnston	David Johnston
Thriller (album)	Thriller (Michael Jackson album)
New Carlisle (Quebec)	New Carlisle, Quebec
Eupen	Eupen
Derek Bell (driver)	Derek Bell (racing driver)
Greg Abbott	Greg Abbott
Gotye	Gotye
Faroe islands football team	Faroe Islands national football team
Christian-Democrats (Sweden)	Christian Democrats (Sweden)
Yellow Red KV Mechelen	KV Mechelen
Channel Norman Islands	Channel Islands
Communauté forale de Navarre	Navarre
Marche-en-Famenne	Marche-en-Famenne
Diocese of Rome	Diocese of Rome
Tavannes (Bern)	Tavannes
Mohammad Reza Pahlavi	Mohammad Reza Pahlavi
Geography of Greece	Geography of Greece
Jack Dalrymple	Jack Dalrymple
Pierre-Évariste Leblanc	Pierre-Évariste Leblanc
William M. Evarts	William M. Evarts
Iurie Leancă	Iurie Leancă
Careless Whisper	Careless Whisper
Bill Laimbeer	Bill Laimbeer
University of Birmingham	University of Birmingham
Franco-Americans	French Americans
Yoshihiko Noda	Yoshihiko Noda
Dominican Republic	Dominican Republic
Music soul	Soul music
Pierreville (Quebec)	Pierreville, Quebec
Margot Wallström	Margot Wallström
Pori	Pori
A Whiter Shade of Pale	A Whiter Shade of Pale
Frontiers Records	Frontiers Records
Aleksandr Siomine	Alexander Semin
Season 18 of South Park	South Park (season 18)
Danilo Türk	Danilo Türk
Liz Sherman	Liz Sherman
Gottlob Frege	Gottlob Frege
Sparks de Los Angeles	Los Angeles Sparks
Boethius	Boethius
Melbourne Victory Football Club	Melbourne Victory FC
Michel Guimond	Michel Guimond
Jeb Bush	Jeb Bush
Maurice Rouvier	Maurice Rouvier
Gare de Høybråten	Høybråten Station
Colombia	Colombia
Takeo Fukuda	Takeo Fukuda
Women's Professional Soccer	Women's Professional Soccer
Presidency of Bosnia-Herzegovina	Presidency of Bosnia and Herzegovina
Jean-Marc Ayrault	Jean-Marc Ayrault
Astralwerks	Astralwerks
Thousand-Islands (provincial riding)	Mille-Îles
Roots rock	Roots rock
Loud Records	Loud Records
Russian Republic	Russian Republic
Endgame (album de Megadeth)	Endgame (Megadeth album)
Acadians	Acadians
All Hell's Breakin' Loose	All Hell's Breakin' Loose
Latvia	Latvia
Gare de Montauban-Ville-Bourbon	Gare de Montauban-Ville-Bourbon
Aix-les-Bains	Aix-les-Bains
Jacques Chagnon	Jacques Chagnon
Port-Daniel–Gascons	Port-Daniel–Gascons
Lord Chancellor	Lord Chancellor
President of the Italian Republic	President of Italy
Treasure (chanson de Bruno Mars)	Treasure (Bruno Mars song)
Leopold II (king of the Belgians)	Leopold II of Belgium
Séville FC	Sevilla FC
Blake Wheeler	Blake Wheeler
Baltic Sea	Baltic Sea
Jean-Jacques Rousseau	Jean-Jacques Rousseau
Kazimierz Marcinkiewicz	Kazimierz Marcinkiewicz
Sainte-Martine	Sainte-Martine, Quebec
Nea Salamina Famaguste	Nea Salamis Famagusta FC
Tulle	Tulle
Socialist Republic of Slovenia	Socialist Republic of Slovenia
Joseph-Godéric Blanchet	Joseph-Goderic Blanchet
Costa Rica football team	Costa Rica national football team
Marie-Thérèse de Habsbourg-Lorraine-Teschen	Maria Theresa of Austria (1816–1867)
Drummond (provincial riding)	Drummond (provincial electoral district)
Hanna-Barbera Productions	Hanna-Barbera
Maurice Trintignant	Maurice Trintignant
Citadels of Quebec	Quebec Citadelles
Esa Tikkanen	Esa Tikkanen
Richard Neville (5th Earl of Salisbury)	Richard Neville, 5th Earl of Salisbury
Jump blues	Jump blues
Jealous Guy	Jealous Guy
Alexandrine de Mecklenburg-Schwerin	Alexandrine of Mecklenburg-Schwerin
Peaceville Records	Peaceville Records
Christian VII	Christian VII of Denmark
Al Jourgensen	Al Jourgensen
Aaron Sorkin	Aaron Sorkin
Fernando de la Rúa	Fernando de la Rúa
Aquiles Priester	Aquiles Priester
Saison 26 des Simpsons	The Simpsons (season 26)
Raising Hell (album de Run–DMC)	Raising Hell (album)
Lee Ranaldo	Lee Ranaldo
Rap rock	Rap rock
Hip-hop industriel	Industrial hip hop
Laurent Aïello	Laurent Aïello
Dream Theater	Dream Theater
Reload (album)	Reload (Tom Jones album)
Jorge Sampaio	Jorge Sampaio
Novare	Novara
Hamburg	Hamburg
Take Me to Church	Take Me to Church
Sylvia Mathews Burwell	Sylvia Mathews Burwell
Leo (constellation)	Leo (constellation)
Edward Derwinski	Ed Derwinski
Saint-Fortunat	Saint-Fortunat, Quebec
Jacques Barrot	Jacques Barrot
Bow Wow	Bow Wow (rapper)
Katholieke Universiteit Leuven	Katholieke Universiteit Leuven
Hemberg	Hemberg
Bertie Ahern	Bertie Ahern
Kalmar FF	Kalmar FF
New Zealand	New Zealand
Alex da Kid	Alex da Kid
Lachute	Lachute
Wouter Bos	Wouter Bos
Gouvernement Verhofstadt I	Verhofstadt I Government
Russell T Davies	Russell T Davies
Dan Auerbach	Dan Auerbach
Mark Santorelli	Mark Santorelli
Parish of Blissville	Blissville Parish, New Brunswick
University Paris-Dauphine	Paris Dauphine University
Anatoli Serdioukov	Anatoliy Serdyukov
Frankfurt-am-Main	Frankfurt
Rona Ambrose	Rona Ambrose
Münchwilen (Thurgau)	Münchwilen, Thurgau
D-beat	D-beat
The Cheetah Girls (group)	The Cheetah Girls (group)
Zhao Ziyang	Zhao Ziyang
Bashir Gemayel	Bachir Gemayel
Psychosocial (song)	Psychosocial (song)
Tom Marshall	Tom Marshall (politician)
Iceland football team	Iceland national football team
Concordia University	Concordia University
Tim Drake	Tim Drake
Luxembourg football team	Luxembourg national football team
Dušan Simović	Dušan Simović
Prime minister of Sweden	Prime Minister of Sweden
Sheryl Crow	Sheryl Crow
Kanagawa Prefecture	Kanagawa Prefecture
President of the European Commission	President of the European Commission
Les Adventures de Tintin	The Adventures of Tintin
William Brock	Bill Brock
Wojtek Wolski	Wojtek Wolski
Hibernian Football Club	Hibernian F.C.
David Coverdale	David Coverdale
University of Coimbra	University of Coimbra
I Should Have Known Better	I Should Have Known Better
Berner Sport Club Young Boys	BSC Young Boys
Steve McNamara	Steve McNamara
Saint-Norbert-d'Arthabaska	Saint-Norbert-d'Arthabaska, Quebec
PlayStation Network	PlayStation Network
Beautiful (Eminem song)	Beautiful (Eminem song)
Eyes Open	Eyes Open
Aube (department)	Aube
Moudon	Moudon
Embrace	Embrace (English band)
Elisabeth Kopp	Elisabeth Kopp
When You're In	When You're In
Parallel Universe	Parallel Universe (song)
Roeselare	Roeselare
Giambattista Vico	Giambattista Vico
Invincible (album de Michael Jackson)	Invincible (Michael Jackson album)
Haute-Garonne	Haute-Garonne
Michele Alboreto	Michele Alboreto
José Montilla	José Montilla
Brad McCrimmon	Brad McCrimmon
Blois	Blois
Bruce McLaren	Bruce McLaren
Duché de Savoie	Duchy of Savoy
Coimbra	Coimbra
Bremen-and-Verden	Bremen-Verden
Jeffrey A. Hoffman	Jeffrey A. Hoffman
Region of Murcia	Region of Murcia
John Ballance	John Ballance
Senneterre (parish)	Senneterre, Quebec (parish)
Christine de France	Christine of France
Polish parliamentary elections 2011	Polish parliamentary election, 2011
Marie d'Anjou	Marie of Anjou
Malta Football Championship	Maltese Premier League
STS-61-B	STS-61-B
Egyptian hieroglyphic script	Egyptian hieroglyphs
Stefaan De Clerck	Stefaan De Clerck
Chris Hadfield	Chris Hadfield
Union pour la liberté	Freedom Union (Poland)
Abbaye Notre-Dame de Fontevraud	Fontevraud Abbey
Hans van Mierlo	Hans van Mierlo
Cleveland Horsemen	Cleveland Cavaliers
Chutes-de-la-Chaudière (district provincial)	Chutes-de-la-Chaudière (electoral district)
Velvet Revolver	Velvet Revolver
Max Scheler	Max Scheler
West Germany	West Germany
Michel Ouellet	Michel Ouellet
James Burnley IV	James H. Burnley IV
Pasadena	Pasadena, California
Hatley (municipality)	Hatley, Quebec (municipality)
June 2012 Greek legislative elections	Greek legislative election, June 2012
The Marshall Mathers LP	The Marshall Mathers LP
Till There Was You	Till There Was You
Secretary of State Interior	Home Secretary
Sunburn	Sunburn (Muse song)
Roberta Pinotti	Roberta Pinotti
Headstrong (album)	Headstrong (Ashley Tisdale album)
Mike Portnoy	Mike Portnoy
Emil Constantinescu	Emil Constantinescu
Norwegian Wood (This Bird Has Flown)	Norwegian Wood (This Bird Has Flown)
Hamburg SV	Hamburger SV
Artpop	Artpop
Nellyville	Nellyville
Terminator Renaissance	Terminator Salvation
Kit Lambert	Kit Lambert
Marek Belka	Marek Belka
Portishead (group)	Portishead (band)
We Started Nothing	We Started Nothing
Le Rocher-Percé	Le Rocher-Percé Regional County Municipality
New Brunswick Legislative Assembly	Legislative Assembly of New Brunswick
Kentucky	Kentucky
IF Elfsborg	IF Elfsborg
Senate of the Republic (Italy)	Senate of the Republic (Italy)
Studio City	Studio City, Los Angeles
This Is a Call	This Is a Call
La Morandière	La Morandière, Quebec
Pierre Mazeaud	Pierre Mazeaud
Creuse (department)	Creuse
Ghana	Ghana
Space rock	Space rock
Elephunk	Elephunk
Jutta Urpilainen	Jutta Urpilainen
Hey You (son de Pink Floyd)	Hey You (Pink Floyd song)
Around the World in a Day	Around the World in a Day
Marja van Bijsterveldt	Marja van Bijsterveldt
Déléage	Déléage, Quebec
Jokerit	Jokerit
Félix de Bourbon-Parme	Prince Felix of Bourbon-Parma
Maria-Chapdelaine	Maria-Chapdelaine
Bordeaux	Bordeaux
Club de Fútbol Monterrey	C.F. Monterrey
Gerhart Baum	Gerhart Baum
Higher Ground	Higher Ground (Stevie Wonder song)
Papineau (regional county municipality)	Papineau Regional County Municipality
Bombay	Mumbai
Crust punk	Crust punk
Mont-Tramelan	Mont-Tramelan
Niki Lauda	Niki Lauda
Barbara Mikulski	Barbara Mikulski
Gare de Skien	Skien Station
Agostino Casaroli	Agostino Casaroli
Boavista Futebol Clube	Boavista F.C.
Everything is Wrong	Everything Is Wrong
Republic of Venice	Republic of Venice
Fiodor Dostoyevsky	Fyodor Dostoyevsky
Barend Biesheuvel	Barend Biesheuvel
Aymara (language)	Aymara language
The Times They Are a-Changin'	The Times They Are a-Changin' (album)
Your Color	Your Color
Bas-Rhin	Bas-Rhin
Omiya Ardija	Omiya Ardija
Egon Krenz	Egon Krenz
Marlies de Toronto	Toronto Marlies
Manfred Ier of Sicily	Manfred, King of Sicily
Aoulef	Aoulef
Bruce Springsteen	Bruce Springsteen
Sainte-Agathe-de-Lotbinière	Sainte-Agathe-de-Lotbinière, Quebec
Jeanne Sauvé	Jeanne Sauvé
Bristol (England)	Bristol
Sainte-Émélie-de-l'Énergie	Sainte-Émélie-de-l'Énergie, Quebec
Ray Manzarek	Ray Manzarek
Federal Ministry of Defence (Germany)	Federal Ministry of Defence (Germany)
Rainer Barzel	Rainer Barzel
A Dance with Dragons	A Dance with Dragons
Strasbourg	Strasbourg
Peterborough United Football Club	Peterborough United F.C.
Canadian Monarchy	Monarchy of Canada
Stade Marcel-Picot	Stade Marcel Picot
Cameroon football team	Cameroon national football team
Ecole polytechnique federal de Zurich	ETH Zurich
Treaty of Sèvres	Treaty of Sèvres
Algirdas Šemeta	Algirdas Šemeta
Stefan Johansson	Stefan Johansson
Eugène de Beauharnais	Eugène de Beauharnais
Toulouse	Toulouse
Poznan	Poznań
University of Bristol	University of Bristol
British Army	British Army
Thomas Bangalter	Thomas Bangalter
Pump (album)	Pump (album)
Lac-des-Eaux-Mortes	Lac-des-Eaux-Mortes, Quebec
Stu Barnes	Stu Barnes
Dordogne (department)	Dordogne
Melvins	Melvins
Polydor	Polydor Records
Little Feat	Little Feat
Face Value (album)	Face Value (album)
European economic community	European Economic Community
Walking After You	Walking After You
Liste des Prime ministers of Senegal	Prime Minister of Senegal
Kim Beazley	Kim Beazley
Doug Wickenheiser	Doug Wickenheiser
Biffy Clyro	Biffy Clyro
Leave Me Alone	Leave Me Alone
Ayreon	Ayreon
Victoria (State)	Victoria (Australia)
Yellow Submarine (album)	Yellow Submarine (album)
So So Def Recordings	So So Def Recordings
Marguerite de Lorraine	Marguerite of Lorraine
Ligue des champions de la CAF	CAF Champions League
Audi	Audi
Rocky Mountains	Rocky Mountains
Scorpion (album d'Eve)	Scorpion (album)
Seattle	Seattle
Techno hardcore	Hardcore (electronic dance music genre)
Jeff Lynne	Jeff Lynne
Punk folk	Folk punk
Anneke van Giersbergen	Anneke van Giersbergen
Steingrímur Hermannsson	Steingrímur Hermannsson
Leonid Koutchma	Leonid Kuchma
Kenneth Edmonds	Babyface (musician)
President of the Republic of Poland	President of Poland
Maggie De Block	Maggie De Block
Fleet Foxes	Fleet Foxes
Maurice de Nassau	Maurice, Prince of Orange
ABBA	ABBA
Constantine (Algeria)	Constantine, Algeria
I'm Free (song of Who)	I'm Free (The Who song)
Gouvernement Salmond I	First Salmond government
Mitja Ribičič	Mitja Ribičič
Tanpopo	Tanpopo
Communist Party of Greece	Communist Party of Greece
North-West (South Africa)	North West (South African province)
Champlain (district provincial)	Champlain (provincial electoral district)
Sainte-Thècle	Sainte-Thècle, Quebec
Championnat de France de rugby à XV de 2e division	Rugby Pro D2
Tha Blue Carpet Treatment	Tha Blue Carpet Treatment
Kapellen (Antwerp)	Kapellen, Belgium
Stingrays of South Carolina of South Carolina	South Carolina Stingrays
Glen Murray (politician)	Glen Murray (politician)
Little Mix	Little Mix
Velociraptor!	Velociraptor!
Futebol Clube do Porto	FC Porto
Karim Ghellab	Karim Ghellab
Adolphe-Frédéric de Suède	Adolf Frederick, King of Sweden
John Rawls	John Rawls
Best of Soul	Best of Soul
Les Etchemins	Les Etchemins Regional County Municipality
Art rock	Art rock
Auckland University	University of Auckland
John 5	John 5 (guitarist)
Tintigny	Tintigny
Federal Ministry of Finance (Germany)	Federal Ministry of Finance (Germany)
Joseph de Villèle	Jean-Baptiste de Villèle
Mille-Isles	Mille-Isles, Quebec
M. Pokora	M. Pokora
Lachie Turner	Lachlan Turner
Ernst Cassirer	Ernst Cassirer
Long Road to Ruin	Long Road to Ruin
Bendt Bendtsen	Bendt Bendtsen
North Hollywood	North Hollywood, Los Angeles
Julius Vogel	Julius Vogel
Crunkcore	Crunkcore
Story Musgrave	Story Musgrave
Calvados (department)	Calvados (department)
Rapids du Colorado	Colorado Rapids
Joseph de Maistre	Joseph de Maistre
Unity democratic coalition	Unitary Democratic Coalition
With Teeth	With Teeth
Duché de Normandie	Duchy of Normandy
British Touring Car Championship	British Touring Car Championship
Blackout (album de Scorpions)	Blackout (Scorpions album)
Rights and Freedoms Movement	Movement for Rights and Freedoms
Anna Fotyga	Anna Fotyga
Winnipeg Jets	Winnipeg Jets
Afrobeat	Afrobeat
Bedtime Stories (album de Madonna)	Bedtime Stories (Madonna album)
Panayótis Kouroumblís	Panagiotis Kouroumblis
Tycho (musician)	Tycho (musician)
Sven Väth	Sven Väth
David Boyle	David Boyle, 7th Earl of Glasgow
The Dreaming	The Dreaming (album)
Józef Piłsudski	Józef Piłsudski
Technologic	Technologic
Uusimaa	Uusimaa
Nick Clegg	Nick Clegg
Popular Party (Portugal)	CDS – People's Party
Lionel Jospin	Lionel Jospin
Ronnie James Dio	Ronnie James Dio
Bump! Bump!	Bump Bump!
Misono	Misono
Epicurus	Epicurus
Nissan Pulsar	Nissan Pulsar
NAC Breda	NAC Breda
John Cornyn	John Cornyn
Henri (grand-duke of Luxembourg)	Henri, Grand Duke of Luxembourg
Yitzhak Rabin	Yitzhak Rabin
The Who	The Who
Austria-Hungary	Austria-Hungary
Charles Taylor (philosopher)	Charles Taylor (philosopher)
Future History	Future History (album)
Guillaume III d'Orange-Nassau	William III of England
There Is Nothing Left to Lose	There Is Nothing Left to Lose
Parish of Drummond	Drummond Parish, New Brunswick
Misery Business	Misery Business
James Schlesinger	James R. Schlesinger
Anfield	Anfield
Badmotorfinger	Badmotorfinger
Norway football team	Norway national football team
Kingdom of Ireland	Kingdom of Ireland
Parklife	Parklife
Fringe (tv series)	Fringe (TV series)
Amina Benkhadra	Amina Benkhadra
Laundry Service	Laundry Service
Val-Brillant	Val-Brillant, Quebec
Chad Kroeger	Chad Kroeger
Alain Nasreddine	Alain Nasreddine
Bad Boy Records	Bad Boy Records
Élie Decazes	Élie, duc Decazes
Alphonse-Charles de Bourbon	Infante Alfonso Carlos, Duke of San Jaime
Thomas Akers	Thomas Akers
Aosta Valley	Aosta Valley
Sato Kilman	Sato Kilman
Óscar Carmona	Óscar Carmona
Nenad Bogdanović	Nenad Bogdanović
Beauharnois (district provincial)	Beauharnois (provincial electoral district)
Gabriel Ramanantsoa	Gabriel Ramanantsoa
Oscar II	Oscar II of Sweden
Alaska	Alaska
Province du Cape	Cape Province
Lomer Gouin	Lomer Gouin
Gro Harlem Brundtland	Gro Harlem Brundtland
Live Nation Entertainment	Live Nation Entertainment
Guipuscoa	Gipuzkoa
Marne (department)	Marne
Ewa Kopacz	Ewa Kopacz
War Pigs	War Pigs
Parti socialiste (France)	Socialist Party (France)
Los Angeles County	Los Angeles County, California
Got to Be There (album)	Got to Be There
Arts et Métiers ParisTech	Arts et Métiers ParisTech
David Pryor	David Pryor
Mikuláš Dzurinda	Mikuláš Dzurinda
Keizō Obuchi	Keizō Obuchi
Kings of Los Angeles	Los Angeles Kings
National Rugby Championship	National Rugby Championship
Marie Ire (queen of England)	Mary I of England
Jacques Lacan	Jacques Lacan
Showbiz	Showbiz (album)
Cathedral of the Archangel-Saint-Michael of Moscow	Cathedral of the Archangel
Notre-Dame-du-Laus	Notre-Dame-du-Laus, Quebec
Gare de Jørstad	Jørstad Station
Olivier Magne	Olivier Magne
Rochester (New York)	Rochester, New York
Viktor Klima	Viktor Klima
Sandro Pertini	Sandro Pertini
Henning Voscherau	Henning Voscherau
Sandis Ozoliņš	Sandis Ozoliņš
Arthur Foljambe	Arthur Foljambe, 2nd Earl of Liverpool
Theo-Ben Gurirab	Theo-Ben Gurirab
Moshe Katsav	Moshe Katsav
AC Sparta Prague	AC Sparta Prague
Jaguar Racing	Jaguar Racing
George Reid	George Reid (Australian politician)
Line of Meråker	Meråker Line
Viau (district provincial)	Viau
Volvo S60	Volvo S60
Coupe de France de football 2011-2012	2011–12 Coupe de France
Cameroon	Cameroon
DITC	Diggin' in the Crates Crew
Chute-Saint-Philippe	Chute-Saint-Philippe, Quebec
Platanias FC	Platanias F.C.
Swiss Football Championship	Swiss Super League
HC Slovan Bratislava	HC Slovan Bratislava
Silver Star (medal)	Silver Star
IPad	IPad
Where Have You Been	Where Have You Been
National University Taras-Shevchenko of Kiev	Taras Shevchenko National University of Kyiv
Ioannis Plakiotakis	Ioannis Plakiotakis
Mouvement réformateur (Belgium)	Mouvement Réformateur
Aliaksei Kalioujny	Alexei Kalyuzhny
Cri (language)	Cree language
Championnat du Portugal de football D2	LigaPro
Raymond Bachand	Raymond Bachand
Sergueï Volkov (cosmonaute)	Sergey Alexandrovich Volkov
Camille Chautemps	Camille Chautemps
Enrico Letta	Enrico Letta
Johan Holmqvist	Johan Holmqvist
Load (album)	Load (album)
Marie-Manuelle de Portugal	Maria Manuela, Princess of Portugal
Saint-Domingue (colonie francaise)	Saint-Domingue
Heavenly voices	Ethereal wave
Rangers Football Club	Rangers F.C.
Ministry of Finance of Finland	Minister of Finance (Finland)
Till Death Do Us Part (album de Cypress Hill)	Till Death Do Us Part (Cypress Hill album)
Blondie (group)	Blondie (band)
Robert-Cliche	Robert-Cliche Regional County Municipality
William Bradford (attorney general)	William Bradford (Attorney General)
Carina Christensen	Carina Christensen
Microscope (constellation)	Microscopium
Phil Housley	Phil Housley
Caroline du Nord	North Carolina
Jakaya Kikwete	Jakaya Kikwete
Just (song)	Just (song)
António de Oliveira Salazar	António de Oliveira Salazar
Staten Island	Staten Island
Italy	Italy
Robert Stewart (viscount Castlereagh)	Robert Stewart, Viscount Castlereagh
Jean Dieudonné	Jean Dieudonné
Hans Krebs	Hans Krebs (Wehrmacht general)
Jean-Pierre Chevènement	Jean-Pierre Chevènement
San José (California)	San Jose, California
Break the Rules (album)	Break the Rules (album)
Louis-Jules Allard	Jules Allard
County Wicklow	County Wicklow
Cornwall (Ontario)	Cornwall, Ontario
Gare de Marienborg	Marienborg Station
Championnat de Suisse de football 2012-2013	2012–13 Swiss Super League
John Dewey	John Dewey
Marc Lavoine	Marc Lavoine
Dalhousie University	Dalhousie University
The Blueprint 3	The Blueprint 3
Communauté d'agglomeration Caen la Mer	Agglomeration community of Caen la Mer
Social Democratic Party (Romania)	Social Democratic Party (Romania)
Matthew Tuck	Matthew Tuck
Lac-Pythonga	Lac-Pythonga, Quebec
Nottingham Forest Football Club	Nottingham Forest F.C.
Alexander I (emperor of russia)	Alexander I of Russia
Blackburn Rovers Football Club	Blackburn Rovers F.C.
Danish Social Liberal Party	Danish Social Liberal Party
John Hall	John Hall (New Zealand politician)
Libra (album)	Libra (Toni Braxton album)
Vilnius University	Vilnius University
Arrival (ABBA album)	Arrival (ABBA album)
Farouk (king of Egypt)	Farouk of Egypt
Liberal Democrats (UK)	Liberal Democrats
Saison 7 des Simpsons	The Simpsons (season 7)
Ostend	Ostend
Asbestos	Asbestos, Quebec
Louis-Auguste de Bourbon (1670-1736)	Louis Auguste, Duke of Maine
Ismail Pasha	Isma'il Pasha
Sorel-Tracy	Sorel-Tracy
Nicolae Timofti	Nicolae Timofti
Team of Morocco olympic of football	Morocco national under-23 football team
Stanley Gene	Stanley Gene
Penny Pritzker	Penny Pritzker
Joaquín Lavín	Joaquín Lavín
Prime minister of Burma	Prime Minister of Myanmar
South Park	South Park
Sergei Fiodorov	Sergei Fedorov
Karl Renner	Karl Renner
Death-doom	Death-doom
Yes (album de Mika Nakashima)	Yes (Mika Nakashima album)
Ali Khamenei	Ali Khamenei
President of the Council of Ministers of Italy	Prime Minister of Italy
Trent Reznor	Trent Reznor
Irkutsk	Irkutsk
Puy-de-Dôme	Puy-de-Dôme
King Kunta	King Kunta
Antonio Inoki	Antonio Inoki
Philippe d'Orléans (1838-1894)	Prince Philippe, Count of Paris
Dreaming Out Loud	Dreaming Out Loud (OneRepublic album)
Piers Sellers	Piers Sellers
Love Buzz	Love Buzz
Thierry Repentin	Thierry Repentin
The Diary of Alicia Keys	The Diary of Alicia Keys
Staples Center	Staples Center
Corrèze (department)	Corrèze
Columbia (river)	Columbia River
Ibrahim Ismail Chundrigar	I. I. Chundrigar
Order of the Rising Sun	Order of the Rising Sun
Archdiocese of Milan	Roman Catholic Archdiocese of Milan
Sochi	Sochi
Exeter City Football Club	Exeter City F.C.
Wellington	Wellington
Saint-Charles-Garnier	Saint-Charles-Garnier, Quebec
Brazilian Social Democracy Party	Brazilian Social Democracy Party
I Can See for Miles	I Can See for Miles
Mont-Élie (Quebec)	Mont-Élie, Quebec
Lester Bowles Pearson	Lester B. Pearson
Feyenoord Rotterdam	Feyenoord
Lefebvre (Quebec)	Lefebvre, Quebec
Italian Championship of football D2	Serie B
A Taste of Honey (song)	A Taste of Honey (song)
Mouloudia olympique Béjaïa	MO Béjaïa
Sarthe (department)	Sarthe
Saint-Ferdinand	Saint-Ferdinand, Quebec
Sergei Bazarevich	Sergei Bazarevich
Bertel Haarder	Bertel Haarder
Louise Beaudoin	Louise Beaudoin
Jay Inslee	Jay Inslee
Verona	Verona
Nick Mason	Nick Mason
Joaquim Chissano	Joaquim Chissano
Jomo Kenyatta	Jomo Kenyatta
Prism (album de Katy Perry)	Prism (Katy Perry album)
Gazélec Football Club Ajaccio	Gazélec Ajaccio
Daniel Johnson (son)	Daniel Johnson, Jr.
Loire-Atlantique	Loire-Atlantique
Associazione Sportiva Livorno Calcio	A.S. Livorno Calcio
Jarkko Immonen	Jarkko Immonen
KwaZulu-Natal	KwaZulu-Natal
Apple Records	Apple Records
Rita Süssmuth	Rita Süssmuth
Babyshambles	Babyshambles
Louis III of Bavaria	Ludwig III of Bavaria
Pranab Mukherjee	Pranab Mukherjee
Bernard-Henri Lévy	Bernard-Henri Lévy
Auguste de Suède	Prince August, Duke of Dalarna
Riverside Records	Riverside Records
Espen Knutsen	Espen Knutsen
Jacques VI et Ier	James VI and I
I'm Not a Girl, Not Yet a Woman	I'm Not a Girl, Not Yet a Woman
Magic (song)	Magic (Coldplay song)
Al Green	Al Green
Saint-Épiphane	Saint-Épiphane, Quebec
Ben Keith	Ben Keith
Reverdy Johnson	Reverdy Johnson
Off the Wall (album)	Off the Wall (album)
Philip IV (king of Spain)	Philip IV of Spain
Volker Bouffier	Volker Bouffier
Jack Lang	Jack Lang (French politician)
Viktor Savinykh	Viktor Savinykh
2008 canadian federal election	Canadian federal election, 2008
STS-91	STS-91
Louisiana	Louisiana
Crémazie (district provincial)	Crémazie (electoral district)
Luleå	Luleå
Bari	Bari
Tadeusz Mazowiecki	Tadeusz Mazowiecki
Antonio de Mendoza	Antonio de Mendoza
Michèle Alliot-Marie	Michèle Alliot-Marie
Charles James Haughey	Charles Haughey
Frederic II of Prussia	Frederick the Great
County of Meath	County Meath
Patti Smith	Patti Smith
Reinhard Heydrich	Reinhard Heydrich
Avital Ronell	Avital Ronell
Pierre-Étienne Flandin	Pierre-Étienne Flandin
Shefford (Quebec)	Shefford, Quebec
Jaroslav Špaček	Jaroslav Špaček
Bob Johnston	Bob Johnston
Grenville-sur-la-Rouge	Grenville-sur-la-Rouge, Quebec
Gangsta Lovin'	Gangsta Lovin'
Peregrine Maitland	Peregrine Maitland
Canton de Neuchâtel	Canton of Neuchâtel
John Cale	John Cale
Dave Manson	Dave Manson
Dear (artist)	Cher
Catherine de Valois (1401-1437)	Catherine of Valois
Championnat d'Algérie de football D2	Algerian Ligue Professionnelle 2
Sichuan	Sichuan
List of Monarchs of Scotland	List of Scottish monarchs
Soliman le Magnifique	Suleiman the Magnificent
Bringing It All Back Home	Bringing It All Back Home
Hélène de Mecklenburg-Schwerin	Duchess Helene of Mecklenburg-Schwerin
Ready for the Weekend	Ready for the Weekend (album)
Annie Lennox	Annie Lennox
Carina (constellation)	Carina (constellation)
Guemar (El Oued)	Guemar
Ajax Amsterdam	AFC Ajax
Jennifer Lynch	Jennifer Lynch
Anne de Bretagne	Anne of Brittany
Ford	Ford Motor Company
Gare de Lilestrøm	Lillestrøm Station
Bridge over Troubled Water	Bridge over Troubled Water
KVC Westerlo	K.V.C. Westerlo
Nicholas I of Montenegro	Nikola I Petrović-Njegoš
Brooklyn	Brooklyn
Bilbao	Bilbao
Teppo Numminen	Teppo Numminen
Estadio Nacional (Lima)	Estadio Nacional de Lima
Abdel-Ilah Benkiran	Abdelilah Benkirane
Soyuz TMA-02M	Soyuz TMA-02M
Gaétan Barrette	Gaétan Barrette
Chiptune	Chiptune
Klaus Iohannis	Klaus Iohannis
Fatmir Sejdiu	Fatmir Sejdiu
Daring Club Motema Pembe	Daring Club Motema Pembe
Équipe de France de football des less de 17 ans	France national under-17 football team
Crissier	Crissier
Viva la Vida or Death and All His Friends	Viva la Vida or Death and All His Friends
Let's Get It Started	Let's Get It Started
Renault Koleos	Renault Koleos
Abadla	Abadla
Innuendo (album)	Innuendo (album)
Michaëlle Jean	Michaëlle Jean
Snoop Dogg	Snoop Dogg
West Point Military Academy	United States Military Academy
MGK	Machine Gun Kelly (rapper)
Scott Weiland	Scott Weiland
Jo Cals	Jo Cals
Season 14 of South Park	South Park (season 14)
Ramones (album)	Ramones (album)
Anthony Edwards	Anthony Edwards
Christiane Taubira	Christiane Taubira
Closer to God	Closer (Nine Inch Nails song)
Walking on a Dream (album)	Walking on a Dream
Disraeli (parish)	Disraeli, Quebec (parish)
Hurricane Danny (1997)	Hurricane Danny (1997)
Northern Cape	Northern Cape
Lloyd Austin	Lloyd Austin
Edward Saïd	Edward Said
Oud-Turnhout	Oud-Turnhout
Mosley Music Group	Mosley Music Group
Stanislav Gross	Stanislav Gross
Law and justice	Law and Justice
William Orbit	William Orbit
Snow (Hey Oh)	Snow (Hey Oh)
Judith de Bohême	Judith of Bohemia
Victor de Broglie (1785-1870)	Victor de Broglie (1785–1870)
Dennis Fentie	Dennis Fentie
Burnley Football Club	Burnley F.C.
Inwil	Inwil
Anatoli Karpov	Anatoly Karpov
Perfect Day (son de Lou Reed)	Perfect Day (Lou Reed song)
Joliette (district provincial)	Joliette (provincial electoral district)
STS-90	STS-90
Indus	Indus River
Sainte-Julienne	Sainte-Julienne, Quebec
Music for a Big Night Out	Music for a Big Night Out
Casino Royale (movie, 1967)	Casino Royale (1967 film)
Alicante	Alicante
Pete Wentz	Pete Wentz
The Velvet Rope	The Velvet Rope
French Section of the Workers International	French Section of the Workers' International
Romainmôtier-Envy	Romainmôtier-Envy
Léglise	Léglise
Joseph Stalin	Joseph Stalin
The Emotions	The Emotions
Stéphane Ortelli	Stéphane Ortelli
Renault Latitude	Renault Latitude
Should Be Higher	Should Be Higher
Assembly nationale (France)	National Assembly (France)
Peter I of Serbia	Peter I of Serbia
Soyuz TMA-18	Soyuz TMA-18
Tivoli	Tivoli, Lazio
Shake Your Body (Down to the Ground)	Shake Your Body (Down to the Ground)
Hands (Little Boots)	Hands (Little Boots album)
Armando Guebuza	Armando Guebuza
It's Late	It's Late
Michael Ignatieff	Michael Ignatieff
New Richmond	New Richmond, Quebec
Keith B. Alexander	Keith B. Alexander
Olaf Kölzig	Olaf Kölzig
Top Dawg Entertainment	Top Dawg Entertainment
Bring Your Daughter to the Slaughter	Bring Your Daughter to the Slaughter
Stewart Grand Prix	Stewart Grand Prix
Cezary Grabarczyk	Cezary Grabarczyk
Aleksei Koudachov	Alexei Kudashov
Kasabian (album)	Kasabian (album)
Saint-Laurent-de-l'Île-d'Orléans	Saint-Laurent-de-l'Île-d'Orléans
List of Pennsylvania Governors	List of Governors of Pennsylvania
Leslie Feist	Feist (singer)
Euclid Tsakalotos	Euclid Tsakalotos
My World 2.0	My World 2.0
Keep Talking	Keep Talking
Montagny-près-Yverdon	Montagny-près-Yverdon
Blink-182	Blink-182
Alive 2007	Alive 2007
Walter Benjamin	Walter Benjamin
Copa Libertadores 1965	1965 Copa Libertadores
Copenhagen	Copenhagen
Chairman of the Government of the Russian Federation	Prime Minister of Russia
Reign in Blood	Reign in Blood
Ilham Aliyev	Ilham Aliyev
Angers Sporting Club de l'Ouest	Angers SCO
Reprise Records	Reprise Records
In Flames	In Flames
Paddy Ashdown	Paddy Ashdown
Years & Years	Years & Years
Obersiggenthal	Obersiggenthal
Anastasio Bustamante	Anastasio Bustamante
Aquarium (album)	Aquarium (Aqua album)
Summer Days (And Summer Nights!!)	Summer Days (And Summer Nights!!)
Ursula Lehr	Ursula Lehr
Unity (Latvian political party)	Unity (Latvian political party)
Dutch football championship	Eredivisie
FC Barcelona (basket-ball)	FC Barcelona Bàsquet
Rock instrumental	Instrumental rock
Lech Kaczyński	Lech Kaczyński
Travis Green	Travis Green
Pamplona	Pamplona
Pierre Mauroy	Pierre Mauroy
Turkish Football Championship D2	TFF First League
Gebhard Müller	Gebhard Müller
Supremacy	Supremacy (song)
Sculptor (constellation)	Sculptor (constellation)
Protopunk	Proto-punk
Factor-X	X-Factor (comics)
Rassemblement du peuple francais	Rally of the French People
Hebrew University of Jerusalem	Hebrew University of Jerusalem
Françoise Hardy	Françoise Hardy
Christian Dubé	Christian Dubé (ice hockey)
Doggumentary	Doggumentary
Mart Laar	Mart Laar
Vicenza	Vicenza
Jesse Brown	Jesse Brown
Team of Democratic Republic of Congo of football	DR Congo national football team
Detroit vs. Everybody	Detroit vs. Everybody
Chamber of Deputies (Romania)	Chamber of Deputies (Romania)
College rock	College rock
Industrial music	Industrial music
Portneuf (city)	Portneuf, Quebec
Dimension Films	Dimension Films
Communauté d'agglomeration de Pau-Pyrénées	Communauté d'agglomération de Pau-Pyrénées
Ford Galaxy	Ford Galaxy
Pávlos Koundouriótis	Pavlos Kountouriotis
Kathleen Blanco	Kathleen Blanco
Bolivia football team	Bolivia national football team
Roger Brooke Taney	Roger B. Taney
S&M (album)	S&M (Metallica album)
Frederick d'York	Prince Frederick, Duke of York and Albany
University of Strasbourg	University of Strasbourg
Coupe Intertoto 2005	2005 UEFA Intertoto Cup
Mahavishnu Orchestra	Mahavishnu Orchestra
Black Mer	Black Sea
Government Yatseniouk II	Second Yatsenyuk Government
Saturday Night Fever (album)	Saturday Night Fever (soundtrack)
Sainte-Geneviève-de-Batiscan	Sainte-Geneviève-de-Batiscan, Quebec
Columbia Pictures	Columbia Pictures
Vladimir Ilyich Lenin	Vladimir Lenin
Technical University of Berlin	Technical University of Berlin
Overexposed	Overexposed (album)
Tainted Love	Tainted Love
Vinnie Paul	Vinnie Paul
Roger Etchegaray	Roger Etchegaray
Laurent Fabius	Laurent Fabius
Bob Dylan	Bob Dylan
Coaticook (regional county municipality)	Coaticook Regional County Municipality
Eric Shinseki	Eric Shinseki
Queen's Park Football Club	Queen's Park F.C.
SK Slavia Prague	SK Slavia Prague
Vice-royalty of Peru	Viceroyalty of Peru
Rabat	Rabat
Psycho Circus (album)	Psycho Circus
Xavier Bettel	Xavier Bettel
Scream (album de Tokio Hotel)	Scream (Tokio Hotel album)
André Weil	André Weil
Cabinet Helle Thorning-Schmidt II	Thorning-Schmidt II Cabinet
Leopold of Albany	Prince Leopold, Duke of Albany
Shut Down Volume 2	Shut Down Volume 2
NERD	N.E.R.D
Detroit (Michigan)	Detroit
Slowcore	Slowcore
Stade montois (rugby à XV)	Stade Montois
Vladimír Růžička	Vladimír Růžička
Paul Weller	Paul Weller
Jan Hendrik Hofmeyr	Jan Hendrik Hofmeyr (1894–1948)
First Empire	First French Empire
Grande-Rivière (Quebec)	Grande-Rivière, Quebec
Cool and Dre	Cool & Dre
Misunderstanding	Misunderstanding (Genesis song)
Guy Mollet	Guy Mollet
Pat Price	Pat Price (ice hockey)
Pickering	Pickering, Ontario
Indonesia	Indonesia
'Till I Collapse	'Till I Collapse
Didier Burkhalter	Didier Burkhalter
The Liberals	Liberals (Sweden)
POD (group)	P.O.D.
Breakbeat hardcore	Breakbeat hardcore
Animals (album)	Animals (Pink Floyd album)
Young Buck	Young Buck
Slipknot	Slipknot (band)
Mohamed Nabil Benabdallah	Nabil Benabdallah
Syd Barrett	Syd Barrett
Richard Seddon	Richard Seddon
Arlene Foster	Arlene Foster
Louis Ier (king of Spain)	Louis I of Spain
Marie-Claude Morin	Marie-Claude Morin
Peter Robinson (politician)	Peter Robinson (Northern Ireland politician)
Cristobal Huet	Cristobal Huet
Swansea City Association Football Club	Swansea City A.F.C.
Rock	Rock music
Ivan II Ivanovitch	Ivan II of Moscow
Chinese Communist Party	Communist Party of China
The Writing's on the Wall	The Writing's on the Wall
Charles Fergusson	Sir Charles Fergusson, 7th Baronet
Mike Sullivan	Mike Sullivan (ice hockey, born 1968)
Samuel Beckett	Samuel Beckett
Maximilien-Emmanuel de Bavière	Maximilian II Emanuel, Elector of Bavaria
Phase finale de la Ligue Europa 2011-2012	2011–12 UEFA Europa League knockout phase
Forever (song of Drake)	Forever (Drake song)
Big Machine Records	Big Machine Records
The Hague	The Hague
Rockabilly	Rockabilly
Amédée VIII de Savoie	Antipope Felix V
Rama IX	Bhumibol Adulyadej
Werner Dollinger	Werner Dollinger
Lac-Oscar	Lac-Oscar, Quebec
Union of South American Nations	Union of South American Nations
Shōichi Nakagawa	Shōichi Nakagawa
Citizens for European development of Bulgaria	GERB
Ian Paice	Ian Paice
Artūrs Irbe	Artūrs Irbe
Living Things (album)	Living Things (Linkin Park album)
Vassili III	Vasili III of Russia
God Only Knows	God Only Knows
Andover Parish	Andover Parish, New Brunswick
Turner Network Television	TNT (TV channel)
Piece of Mind	Piece of Mind
Teen Titans (comics)	Teen Titans
Willem Drees	Willem Drees
Aleksandar Popović (politician)	Aleksandar Popović (politician)
Moby (album)	Moby (album)
Samuel Reshevsky	Samuel Reshevsky
Ai no uta	Ai no Uta (Kumi Koda song)
The New Heroes	Big Hero 6 (film)
Paul Erdős	Paul Erdős
Ruisseau-Ferguson	Ruisseau-Ferguson, Quebec
Notre-Dame-de-la-Salette	Notre-Dame-de-la-Salette, Quebec
Bath Rugby	Bath Rugby
FINE*	F.I.N.E.*
Robert Thirsk	Robert Thirsk
Ottoman Dynasty	Ottoman dynasty
Goh Chok Tong	Goh Chok Tong
Mahmoud Abbas	Mahmoud Abbas
Dirk Kempthorne	Dirk Kempthorne
Alejandro Rodríguez de Valcárcel	Alejandro Rodríguez de Valcárcel
Agnès de France (1260-1325)	Agnes of France, Duchess of Burgundy
Route Transcanadienne	Trans-Canada Highway
UK	United Kingdom
Arab champions football league 2007-2008	2007–08 Arab Champions League
Deathcore	Deathcore
Kärpät Oulu	Oulun Kärpät
Dorade (constellation)	Dorado
Little 15	Little 15
Gnarls Barkley	Gnarls Barkley
Marguerite-D'Youville (regional county municipality)	Marguerite-D'Youville Regional County Municipality
Taylor Hawkins	Taylor Hawkins
FIFA Clubs World Cup	FIFA Club World Cup
Hermann Müller	Hermann Müller (politician)
Michael Leavitt	Mike Leavitt
IFK Göteborg	IFK Göteborg
University of Washington	University of Washington
Baie-des-Chaloupes	Baie-des-Chaloupes, Quebec
Supertramp	Supertramp
Fix You	Fix You
Saint-André-d'Argenteuil	Saint-André-d'Argenteuil, Quebec
Labour Party of Korea	Workers' Party of Korea
Austria	Austria
Metal industriel	Industrial metal
Soyuz TMA-05M	Soyuz TMA-05M
James B. Hertzog	J. B. M. Hertzog
Franz Josef Jung	Franz Josef Jung
Virginia (State)	Virginia
Bernard Edwards	Bernard Edwards
Ulla Schmidt	Ulla Schmidt
Louvain	Leuven
Careful with That Axe, Eugene	Careful with That Axe, Eugene
Bad Meets Evil	Bad Meets Evil
Walter Forward	Walter Forward
Pirkanmaa	Pirkanmaa
John S. McCain, Jr.	John S. McCain Jr.
Dalton McGuinty (son)	Dalton McGuinty
Checker Records	Checker Records
Wherever I May Roam	Wherever I May Roam
Rafael Frühbeck de Burgos	Rafael Frühbeck de Burgos
Fédération internationale de football association	FIFA
Devan Dubnyk	Devan Dubnyk
War of the Mahdists	Mahdist War
Payable on Death	Payable on Death
Bronze Records	Bronze Records
No Reply (song)	No Reply (song)
Mozambique football team	Mozambique national football team
Trespassing	Trespassing (album)
Pat Quinn (politician)	Pat Quinn (politician)
Feel My Mind	Feel My Mind
Snap (music)	Snap music
Nelligan (provincial district)	Nelligan (electoral district)
Penn Nouth	Penn Nouth
Boston	Boston
Candlelight Records	Candlelight Records
Fribourg-im-Brisgau	Freiburg im Breisgau
The Catalyst	The Catalyst
Viktor Tchernomyrdin	Viktor Chernomyrdin
Electorate of Saxony	Electorate of Saxony
Noumea	Nouméa
Gorillaz (album)	Gorillaz (album)
Ken Holland	Ken Holland
Helsingin Jalkapalloklubi	Helsingin Jalkapalloklubi
Bahamas	The Bahamas
Anne Hidalgo	Anne Hidalgo
Meteora	Meteora (album)
Sainte-Lucie	Saint Lucia
Brian Holzinger	Brian Holzinger
Emmanuel-Philibert de Savoie (1528-1580)	Emmanuel Philibert, Duke of Savoy
Fearless (album de Taylor Swift)	Fearless (Taylor Swift album)
Devanagari	Devanagari
Al-Hilal Football Club	Al-Hilal FC
People Are Strange	People Are Strange
François Fillon	François Fillon
RSO Records	RSO Records
Lajoux (Switzerland)	Lajoux (Switzerland)
Chamber of Deputies of Chile	Chamber of Deputies of Chile
Presidents of Burma	President of Myanmar
Lechia Gdańsk	Lechia Gdańsk
Saint-Charles-sur-Richelieu	Saint-Charles-sur-Richelieu, Quebec
Tielt	Tielt
Battle of Berlin	Battle of Berlin
Coupe des cities de fairs 1958-1960	1958–60 Inter-Cities Fairs Cup
Federal Ministry of the Interior (Germany)	Federal Ministry of the Interior (Germany)
James John Edmund Guerin	James John Edmund Guerin
Alfonso II (king of Portugal)	Afonso II of Portugal
Homer Martin Adkins	Homer Martin Adkins
Rapid Vienna	SK Rapid Wien
Gambia football team	Gambia national football team
The Carrier	The Transporter
Xinjiang	Xinjiang
John Slaney	John Slaney
Chamber of Deputies of Argentina	Argentine Chamber of Deputies
Waltenschwil	Waltenschwil
Bohemian Rhapsody	Bohemian Rhapsody
John McAllister Schofield	John Schofield
This Place Hotel	This Place Hotel
Giez (Vaud)	Giez
Sadi Carnot (politician)	Marie François Sadi Carnot
Alexandra Pavlovna of Russia	Grand Duchess Alexandra Pavlovna of Russia
Hip-hop experimental	Experimental hip hop
Avon Publications	Avon (publisher)
Yes	Yes (band)
Greatest Hits (album d'Aqua)	Greatest Hits (Aqua album)
World Championship Wrestling	World Championship Wrestling
Shelter (song)	Shelter (The xx song)
Rob Zombie	Rob Zombie
Hifikepunye Pohamba	Hifikepunye Pohamba
Ilkhanides	Ilkhanate
FK Austria Vienna	FK Austria Wien
Stade Jan-Breydel	Jan Breydel Stadium
Notre-Dame-de-la-Merci	Notre-Dame-de-la-Merci, Quebec
Blue Jackets de Columbus	Columbus Blue Jackets
Boutros Boutros-Ghali	Boutros Boutros-Ghali
Parc des Sports (Annecy)	Parc des Sports, Annecy
Marie-Louise of Spain (1745-1792)	Maria Luisa of Spain
Notre-Dame-des-Prairies	Notre-Dame-des-Prairies, Quebec
Live in the LBC & Diamonds in the Rough	Live in the LBC & Diamonds in the Rough
Crunk	Crunk
Yves Bérubé	Yves Bérubé
Baby One More Time (album)	Baby One More Time (album)
ASEC Mimosas (football)	ASEC Mimosas
Angels and Airwaves	Angels & Airwaves
Game Boy Advance	Game Boy Advance
Gare d'Eidsvoll	Eidsvoll Station
Stone Temple Pilots	Stone Temple Pilots
Saracens	Saracens F.C.
Polish parliamentary elections 2015	Polish parliamentary election, 2015
Károlos Papoúlias	Karolos Papoulias
Jacob Lew	Jack Lew
Lynn Martin	Lynn Morley Martin
Konstantínos Stephanópoulos	Konstantinos Stephanopoulos
System of a Down	System of a Down
Victor Cavendish	Victor Cavendish, 9th Duke of Devonshire
Premyslides	Přemyslid dynasty
Restigouche County	Restigouche County, New Brunswick
European football championship	UEFA European Championship
Sainte-Geneviève-de-Berthier	Sainte-Geneviève-de-Berthier, Quebec
Guy Caron	Guy Caron
Oslo	Oslo
Nickerson Field	Nickerson Field
Movement 5 stars	Five Star Movement
Juan de Borbón y Battenberg	Infante Juan, Count of Barcelona
Horst Ehmke	Horst Ehmke
Eric Saade	Eric Saade
Fresh Cream	Fresh Cream
Ecole des hautes études en sciences sociales	School for Advanced Studies in the Social Sciences
English (people)	French people
Ingolstadt	Ingolstadt
Dionigi Tettamanzi	Dionigi Tettamanzi
Équipe du Sénégal de football	Senegal national football team
Vassilikí Thánou-Christophílou	Vassiliki Thanou-Christophilou
Civil War	American Civil War
Maka Kotto	Maka Kotto
Interscope Records	Interscope Records
Just Blaze	Just Blaze
Michael Collins (politician)	Michael Collins (Irish leader)
Waratahs	New South Wales Waratahs
Sounders FC de Seattle	Seattle Sounders FC
Eiffel (language)	Eiffel (programming language)
Charles Simonyi	Charles Simonyi
Wilhelmine of Prussia (1774-1837)	Wilhelmine of Prussia, Queen of the Netherlands
Mark Lanegan	Mark Lanegan
Brian Marshall	Brian Marshall
Alt-J	Alt-J
Get a Grip	Get a Grip
STS-113	STS-113
Boleslas III Mouth-Torse	Bolesław III Wrymouth
Isabelle d'Angoulême	Isabella of Angoulême
Rope (song)	Rope (song)
Peugeot	Peugeot
Ivan Ier Kalita	Ivan I of Moscow
Artemis Fowl	Artemis Fowl (series)
Harry S. Truman	Harry S. Truman
List of the sovereigns of the Netherlands	List of monarchs of the Netherlands
Panasonic Wild Knights	Panasonic Wild Knights
+44	+44 (band)
Ivan Koniev	Ivan Konev
Trois-Rives	Trois-Rives, Quebec
Tappara	Tappara
François Bozizé	François Bozizé
Charles de Valois	Charles, Count of Valois
Pál Teleki	Pál Teleki
Borussia Mönchengladbach	Borussia Mönchengladbach
José María Aznar	José María Aznar
Olympic stadium of Munich	Olympiastadion (Munich)
Grupo Desportivo Estoril-Praia	G.D. Estoril Praia
André Boisclair	André Boisclair
Down on the Upside	Down on the Upside
Tancredo Neves (Santa Maria)	Tancredo Neves, Santa Maria
Francoprovençal	Franco-Provençal language
Saint-Bruno-de-Guigues	Saint-Bruno-de-Guigues, Quebec
Clarendon (Quebec)	Clarendon, Quebec
Janet Jagan	Janet Jagan
Muhammad Ali Bogra	Mohammad Ali Bogra
Football Club Bari 1908	F.C. Bari 1908
Gare de Lysaker	Lysaker Station
Tomahawk Technique	Tomahawk Technique
Surtees Racing Organisation	Surtees
Sulejman Ugljanin	Sulejman Ugljanin
Prime minister of Portugal	Prime Minister of Portugal
Olimpia Milan	Olimpia Milano
As I Am (album)	As I Am
Ron Asheton	Ron Asheton
Vyacheslav Boutsaïev	Vyacheslav Butsayev
Ecuador (country)	Ecuador
Dimitrios Voulgaris	Dimitrios Voulgaris
Michael Shuman	Michael Shuman
Can't Be Tamed	Can't Be Tamed
Butch Vig	Butch Vig
Saint-Brais	Saint-Brais
English football federation	The Football Association
Sin (song)	Sin (song)
Salim el-Hoss	Selim Hoss
Andy Miele	Andy Miele
Virgin Records	Virgin Records
Æneas Mackay	Aeneas Mackay
Benin	Benin
Charles-Louis de Ficquelmont	Count Karl Ludwig von Ficquelmont
Butch Goring	Butch Goring
In Utero (album)	In Utero (album)
Deportivo Saprissa	Deportivo Saprissa
Chet Faker	Chet Faker
Vuosaari	Vuosaari
Volkswagen Golf VII	Volkswagen Golf Mk7
Aftermath Entertainment	Aftermath Entertainment
Kölner Haie	Kölner Haie
Yu-Gi-Oh!	Yu-Gi-Oh!
Michel Foucault	Michel Foucault
Eric Dolphy	Eric Dolphy
Lon Nol	Lon Nol
Jura (department)	Jura (department)
Max Stirner	Max Stirner
Coupe des clubs champions europeans 1959-1960	1959–60 European Cup
Janet Napolitano	Janet Napolitano
Torcuato Fernández Miranda	Torcuato Fernández-Miranda
Lick It Up (song)	Lick It Up (song)
Europe (group)	Europe (band)
BV 09 Borussia Dortmund	Borussia Dortmund
2012 Summer Olympic Games	2012 Summer Olympics
Olympic Stadium of Rome	Stadio Olimpico
Heinemann (edition)	Heinemann (publisher)
Sergio Mattarella	Sergio Mattarella
Robert Lang	Robert Lang (ice hockey)
Saint-Luc-de-Bellechasse	Saint-Luc-de-Bellechasse, Quebec
Urmas Paet	Urmas Paet
Ralph Regenvanu	Ralph Regenvanu
Charles University of Prague	Charles University in Prague
B'Day	B'Day (Beyoncé album)
The Eminem Show	The Eminem Show
Them Crooked Vultures	Them Crooked Vultures
Live à Paris (album de Céline Dion)	Live à Paris
Calais	Calais
It's a Laugh Productions	It's a Laugh Productions
Marguerite III de Flandre	Margaret III, Countess of Flanders
Bruce Babbitt	Bruce Babbitt
Budapest	Budapest
Don Waddell	Don Waddell
Motion (album de Calvin Harris)	Motion (Calvin Harris album)
Ristigouche-Partie-Sud-Est	Ristigouche-Partie-Sud-Est, Quebec
Cyanide (song)	Cyanide (song)
Homework	Homework (Daft Punk album)
Lauritz Lauritzen	Lauritz Lauritzen
Diocèse de Trois-Rivières	Roman Catholic Diocese of Trois-Rivières
Super Bowl XL	Super Bowl XL
Social Democratic Party of Finland	Social Democratic Party of Finland
Superbus	Superbus (band)
Roy Orbison	Roy Orbison
Stripped (song)	Stripped (song)
Brian Jones (musician)	Brian Jones
Valve (company)	Valve Corporation
Gare de Holmlia	Holmlia Station
VIK Västerås HK	VIK Västerås HK
Government Davutoğlu I	First Davutoğlu Cabinet
Grillz (song)	Grillz
Kelly Clarkson	Kelly Clarkson
École nationale d'administration (France)	École nationale d'administration
Charlotte de Grande-Bretagne	Charlotte, Princess Royal
I Feel You	I Feel You
Lac-Ernest	Lac-Ernest, Quebec
Abdelfattah Mourou	Abdelfattah Mourou
Games of Throne	A Song of Ice and Fire
Mohamed Ghannouchi	Mohamed Ghannouchi
Bernardino Machado	Bernardino Machado
Norman Mineta	Norman Mineta
Indie folk	Indie folk
Dragon (constellation)	Draco (constellation)
Oh Love	Oh Love
Wendy B. Lawrence	Wendy B. Lawrence
Angus King	Angus King
Take My Breath Away	Take My Breath Away
Lay Lady Lay	Lay Lady Lay
Rockwilder	Rockwilder
Nicolas Malebranche	Nicolas Malebranche
La Patrie (municipality)	La Patrie, Quebec
L'Isle-Verte	L'Isle-Verte, Quebec
Voltaire	Voltaire
Attert (river)	Attert (river)
Sainte-Marguerite-du-Lac-Masson	Sainte-Marguerite-du-Lac-Masson, Quebec
Yvonand	Yvonand
Lens (Pas-de-Calais)	Lens, Pas-de-Calais
PCD (album)	PCD (album)
Enema of the State	Enema of the State
Don't Believe the Truth	Don't Believe the Truth
Way to Heaven	Way to Heaven
Club Foot	Club Foot (song)
Benjamin Franklin	Benjamin Franklin
Zipper Down	Zipper Down
Michael Fincke	Michael Fincke
In This Skin	In This Skin
Antonio López de Santa Anna	Antonio López de Santa Anna
Yoko Ono	Yoko Ono
Élisabeth Stuart	Elizabeth Stuart, Queen of Bohemia
Palma de Mallorca	Palma, Majorca
Lac-Drolet	Lac-Drolet, Quebec
Government Katainen	Katainen Cabinet
Royal Albert Elisabeth Club de Mons	R.A.E.C. Mons
Burt Bacharach	Burt Bacharach
I Can Only Imagine	I Can Only Imagine (David Guetta song)
Rise Against	Rise Against
European football championship 1984	UEFA Euro 1984
Georgia football team	Georgia national football team
Sainte-Paule (Quebec)	Sainte-Paule, Quebec
Highway to Hell (song)	Highway to Hell (song)
Union sportive Créteil-Lusitanos	US Créteil-Lusitanos
Blink-182 (album)	Blink-182 (album)
André (apostle)	Andrew the Apostle
Sebadoh	Sebadoh
Charles IV le Bel	Charles IV of France
Guennadi Strekalov	Gennadi Strekalov
House of Holstein-Gottorp	House of Holstein-Gottorp (Swedish line)
Vallée-Jonction	Vallée-Jonction, Quebec
Bebop	Bebop
Happy (son de Pharrell Williams)	Happy (Pharrell Williams song)
Provisional authority of the coalition	Coalition Provisional Authority
Parmenides	Parmenides
Time (son de Pink Floyd)	Time (Pink Floyd song)
Lordi	Lordi
Prime Minister of Finland	Prime Minister of Finland
John McCarthy	John McCarthy (computer scientist)
Spiralling	Spiralling
Troye Sivan	Troye Sivan
Brent Smith	Brent Smith
Eddie Clarke	Eddie Clarke
Perm	Perm
Savoie (department)	Savoie
Benny Benassi	Benny Benassi
Country Song	Country Song (Pink Floyd song)
Jacky Ickx	Jacky Ickx
Jeanne de Bourbon (1338-1378)	Joanna of Bourbon
Democratic League of Kosovo	Democratic League of Kosovo
Margrethe II	Margrethe II of Denmark
Trieste	Trieste
Alan Johnson	Alan Johnson
Frédéric VIII de Danemark	Frederick VIII of Denmark
US presidential election 2008	United States presidential election, 2008
The Alesha Show	The Alesha Show
Update (album)	Mise à jour
Gare de Dombås	Dombås Station
Non-Aligned Movement	Non-Aligned Movement
Maryse Ouellet	Maryse Ouellet
Croix de guerre 1939-1945	Croix de guerre 1939–1945 (France)
Wimmis	Wimmis
Joseph-Édouard Cauchon	Joseph-Édouard Cauchon
A Question of Lust	A Question of Lust
Justin Broadrick	Justin Broadrick
Songs for the Deaf	Songs for the Deaf
Saint-Jean-Baptiste (Montérégie)	Saint-Jean-Baptiste, Quebec
Soviet socialist republic of Belarus	Byelorussian Soviet Socialist Republic
Abbey Road (album)	Abbey Road
Hebrew alphabet	Hebrew alphabet
Freezers of Hamburg	Hamburg Freezers
The Queen's College (Oxford)	The Queen's College, Oxford
Saint-Didace	Saint-Didace, Quebec
Repentigny (Quebec)	Repentigny, Quebec
Chambly (district provincial)	Chambly (provincial electoral district)
Mike Rann	Mike Rann
The Endless River	The Endless River
Jessie Ware	Jessie Ware
Larry Williams	Larry Williams
Seemann	Seemann
Alexis Ier (tsar of Russia)	Alexis of Russia
Creighton Williams Abrams	Creighton Abrams
Albert III Achille de Brandebourg	Albrecht III Achilles, Elector of Brandenburg
Stargate (producers)	Stargate (production team)
Jyrki Katainen	Jyrki Katainen
Milt Schmidt	Milt Schmidt
Volkswagen Golf VI	Volkswagen Golf Mk6
Atresmedia	Atresmedia
Paul VI	Pope Paul VI
The End (album de Mika Nakashima)	The End (Mika Nakashima album)
Tony Hrkac	Tony Hrkac
John Lydon	John Lydon
United Artists	United Artists
I Created Disco	I Created Disco
Buono!	Buono!
White Lines (Don't Do It)	White Lines (Don't Don't Do It)
Andy Priaulx	Andy Priaulx
Skyscraper	Skyscraper (song)
Across the Universe	Across the Universe
Rodolfo Martín Villa	Rodolfo Martín Villa
Dwayne Roloson	Dwayne Roloson
Emperor of Japan	Emperor of Japan
Beloeil (Belgium)	Belœil
Fastway	Fastway (band)
Maronite Church	Maronite Church
Bruce Fraser	Bruce Fraser, 1st Baron Fraser of North Cape
House of Lords	House of Lords
Marina and the Diamonds	Marina and the Diamonds
CREAM	C.R.E.A.M.
Stade tunisien (football)	Stade Tunisien
Warwick (Quebec)	Warwick, Quebec
Stanstead (township municipality)	Stanstead, Quebec (township)
Pier Ferdinando Casini	Pier Ferdinando Casini
Irv Gotti	Irv Gotti
Kloten Flyers	Kloten Flyers
Tsai Ing-wen	Tsai Ing-wen
Avex Trax	Avex Trax
Gaspé (city)	Gaspé, Quebec
Lifetime (television channel)	Lifetime (TV network)
Marek Schwarz	Marek Schwarz
Venom (group)	Venom (band)
Hey Jude	Hey Jude
Chambery	Chambéry
Liberal-Democratic Party of Moldova	Liberal Democratic Party of Moldova
Let It Be (album des Beatles)	Let It Be
Agnès de Poitiers (wife of Henri III of the Holy-Empire)	Agnes of Poitou
Jean-de-Dieu Soult	Jean-de-Dieu Soult
Komets de Fort Wayne	Fort Wayne Komets
Charles Lee (lawyer)	Charles Lee (attorney general)
Sebastián Piñera	Sebastián Piñera
Ulysses S. Grant	Ulysses S. Grant
Saint-Barthélemy (Quebec)	Saint-Barthélemy, Quebec
Vermont	Vermont
Kirk Muller	Kirk Muller
Government Rõivas II	Taavi Rõivas' second cabinet
George IV	George IV of the United Kingdom
Saint-Damien	Saint-Damien, Quebec
Can (group)	Can (band)
Lillestrøm Sportsklubb	Lillestrøm SK
Abdel Rahim al-Kib	Abdurrahim El-Keib
Sultanat de Roum	Sultanate of Rum
Élena Paparízou	Elena Paparizou
Sainte-Croix (Quebec)	Sainte-Croix, Quebec
Ishrat-ul-Ibad Khan	Ishratul Ibad
Patxi López	Patxi López
Helloween	Helloween
The Feast and the Famine	The Feast and the Famine
The Family Jewels	The Family Jewels (Marina and the Diamonds album)
Björk	Björk
Anna (Go to Him)	Anna (Go to Him)
Dakar (region)	Dakar Region
Saint-Pierre-de-Broughton	Saint-Pierre-de-Broughton, Quebec
Brahmi	Brahmi script
Atlantique stade rochelais	Atlantique Stade Rochelais
Saturn (video games console)	Sega Saturn
One Hot Minute	One Hot Minute
Saint-Étienne-des-Grès	Saint-Étienne-des-Grès, Quebec
Bristol City Football Club	Bristol City F.C.
People's Republic of Hungary	Hungarian People's Republic
Piet Hein Donner	Piet Hein Donner
STS-84	STS-84
Murcia	Murcia
Run (Snow Patrol song)	Run (Snow Patrol song)
Treaties of Utrecht (1713)	Treaty of Utrecht
Twista	Twista
Sardinia	Sardinia
J Records	J Records
Joaquín Almunia	Joaquín Almunia
Notts County Football Club	Notts County F.C.
Vanha Munkkiniemi	Vanha Munkkiniemi
Hummer H2	Hummer H2
Mick Mars	Mick Mars
Dogg Food	Dogg Food
Edwin Meese	Edwin Meese
Parti national peasant chrétien democrate	Christian Democratic National Peasants' Party
Wale (rapper)	Wale (rapper)
Khedivate of Egypt	Khedivate of Egypt
Eric Fehr	Eric Fehr
Condoleezza Rice	Condoleezza Rice
Professor Green	Professor Green
Arrondissement de La Flèche	Arrondissement of La Flèche
Austria football team	Austria national football team
New Delhi	New Delhi
You Know My Name (Look Up the Number)	You Know My Name (Look Up the Number)
Honey Don't	Honey Don't
Chinese Communist Party General Secretary	General Secretary of the Communist Party of China
Martha and the Vandellas	Martha and the Vandellas
Russian football championship	Russian Football Premier League
Arnold Layne	Arnold Layne
Petr Nedvěd	Petr Nedvěd
Marilyn Manson	Marilyn Manson
Southend United Football Club	Southend United F.C.
Roxanne (song)	Roxanne (song)
Schaerbeek	Schaerbeek
Anglo-American War of 1812	War of 1812
Spanish War of Independence	Peninsular War
Rwanda football team	Rwanda national football team
Turnhout	Turnhout
Rajya Sabha	Rajya Sabha
Olympique lyonnais (feminines)	Olympique Lyonnais (Ladies)
Mark Ronson	Mark Ronson
Albanel (Quebec)	Albanel, Quebec
Crosstown Traffic	Crosstown Traffic (song)
Candy Shop (son de 50 Cent)	Candy Shop
Blue Öyster Cult	Blue Öyster Cult
Blood Sugar Sex Magik	Blood Sugar Sex Magik
Rodion Malinovski	Rodion Malinovsky
Expedition 1 (ISS)	Expedition 1
Valérie Fourneyron	Valérie Fourneyron
Maison de Lorraine	House of Lorraine
Gare de Hamar	Hamar Station
Fascination Records	Fascination Records
Al-Ahli SC (Jeddah)	Al-Ahli Saudi FC
Gränichen	Gränichen
The Pretty Things	The Pretty Things
Sinergy	Sinergy
Paul Rodgers	Paul Rodgers
Amiens	Amiens
Extremadura	Extremadura
Human After All	Human After All
Reconvilier	Reconvilier
Industrial dance	Industrial dance music
Robert Young (guitarist)	Robert Young (musician)
Bujar Nishani	Bujar Nishani
Girl Next Door (group)	Girl Next Door (band)
Kingdom of Libya	Kingdom of Libya
No Mercy	No Mercy (T.I. album)
Louis Napoleon	Louis, Prince Napoléon
Sanche II (king of Portugal)	Sancho II of Portugal
Trick (album)	Trick (Kumi Koda album)
Albania football hopeful team	Albania national under-21 football team
Club America	Club América
Patrik Eliáš	Patrik Eliáš
Gouvernement Ponta I	First Ponta cabinet
José Antonio Griñán	José Antonio Griñán
Palo Alto	Palo Alto, California
Isuzu Gemini	Isuzu Gemini
Rebeuvelier	Rebeuvelier
Georges Leygues	Georges Leygues
Emo	Emo
Feadz	Feadz
Insomniac (album)	Insomniac (Green Day album)
Taishō Tennō	Emperor Taishō
Republic of Two Nations	Polish–Lithuanian Commonwealth
David Vitter	David Vitter
John E. Blaha	John E. Blaha
Montérégie	Montérégie
Lokeren	Lokeren
Carrie Underwood	Carrie Underwood
Yeovil Town Football Club	Yeovil Town F.C.
Toni Braxton (album)	Toni Braxton (album)
Carly Rae Jepsen	Carly Rae Jepsen
Paul Vanden Boeynants	Paul Vanden Boeynants
Natalia Gherman	Natalia Gherman
Lommel United	Lommel United
Indie pop	Indie pop
Dirty South	Southern hip hop
Tony Campos	Tony Campos
Joe Quesada	Joe Quesada
Marie-Christine de Savoie	Maria Cristina of Savoy
Hungarian Workers Party	Hungarian Working People's Party
Nawaz Sharif	Nawaz Sharif
Mikael Tellqvist	Mikael Tellqvist
Vittorio Emanuele Orlando	Vittorio Emanuele Orlando
John Turner (politician)	John Turner
Pietro Badoglio	Pietro Badoglio
DJ Jazzy Jeff	DJ Jazzy Jeff
Henry of Gloucester	Prince Henry, Duke of Gloucester
Oliver Otis Howard	Oliver O. Howard
José Blanco	José Blanco López
The Lox	The Lox
Ligue internationale (baseball)	International League
Wyoming	Wyoming
Progressive-Conservative Association of Alberta	Progressive Conservative Association of Alberta
Dune (movie)	Dune (film)
Tori Amos	Tori Amos
Kgalema Motlanthe	Kgalema Motlanthe
Jürgen Warnke	Jürgen Warnke
Crossover thrash	Crossover thrash
Turkey football team	Turkey national football team
Ministry of Finance (Netherlands)	Ministry of Finance (Netherlands)
Purple Rain (song)	Purple Rain (song)
Saint-Alban (Quebec)	Saint-Alban, Quebec
Nicholas Brady	Nicholas F. Brady
Rock and Roll (son de Led Zeppelin)	Rock and Roll (Led Zeppelin song)
George Martin	George Martin
Annemie Turtelboom	Annemie Turtelboom
Expedition 41 (ISS)	Expedition 41
Beveren (East Flanders)	Beveren
Sainte-Anne-de-Beaupré	Sainte-Anne-de-Beaupré
Maserati Ghibli I	Maserati Ghibli
Tim Armstrong	Tim Armstrong
Dennis Endras	Dennis Endras
Liaoning	Liaoning
Saint-Philippe (Quebec)	Saint-Philippe, Quebec
Muhammad Zia-ul-Haq	Muhammad Zia-ul-Haq
Nathalie Normandeau	Nathalie Normandeau
Henri VI (king of England)	Henry VI of England
Thomas Ewing	Thomas Ewing
Job Cohen	Job Cohen
ANO 2011	ANO 2011
Santa Clara (California)	Santa Clara, California
Averroes	Averroes
Lento violento	Lento Violento
Facelift	Facelift (album)
Hans Christian Schmidt	Hans Christian Schmidt
Muhammad Mian Soomro	Muhammad Mian Soomro
Peter V (king of Portugal)	Pedro V of Portugal
Giuseppe Saragat	Giuseppe Saragat
Canton des Grisons	Graubünden
Distinguished Flying Cross (USA)	Distinguished Flying Cross (United States)
Indiana Pacers	Indiana Pacers
George Abela	George Abela
Patrick Wilson (music)	Patrick Wilson (musician)
Canton du Valais	Valais
Saint-Donat (La Mitis)	Saint-Donat, Bas-Saint-Laurent, Quebec
DJ Quik	DJ Quik
Lukko	Lukko
Mobb Deep	Mobb Deep
Feel Good Inc.	Feel Good Inc.
Graham Hill	Graham Hill
Agustín Muñoz Grandes	Agustín Muñoz Grandes
Rupperswil	Rupperswil
Maria (Quebec)	Maria, Quebec
Elizabeth of York	Elizabeth of York
Mette Frederiksen	Mette Frederiksen
Aleh Antonenka	Oleg Antonenko
Elektra Records	Elektra Records
Ivo Sanader	Ivo Sanader
Youssouf Raza Gilani	Yousaf Raza Gillani
You're All I Have	You're All I Have
Sebastiano Baggio	Sebastiano Baggio
Dexter Holland	Dexter Holland
Dutch-Americans	Dutch Americans
TF1	TF1
Time (album d'Electric Light Orchestra)	Time (Electric Light Orchestra album)
Abacab (song)	Abacab (song)
Gänsbrunnen	Gänsbrunnen
Jan Eduard de Quay	Jan de Quay
María de la Esperanza de Borbón y Orleans	Princess Maria de la Esperanza of Bourbon-Two Sicilies
Stromae	Stromae
Wings at the Speed of Sound	Wings at the Speed of Sound
Pierre Duchesne (lieutenant-governor)	Pierre Duchesne
Siouxsie and the Banshees	Siouxsie and the Banshees
Jacobus Johannes Fouché	Jacobus Johannes Fouché
Vitoria-Gasteiz	Vitoria-Gasteiz
La Defense	La Défense
Boris Tadić	Boris Tadić
The Woman in Me (album)	The Woman in Me (Shania Twain album)
A Song for XX	A Song for ××
Aftermath (album des Rolling Stones)	Aftermath (The Rolling Stones album)
Matt Cardle	Matt Cardle
Saint-Cyprien-de-Napierville	Saint-Cyprien-de-Napierville, Quebec
Conservative Party (UK)	Conservative Party (UK)
Gallichan	Gallichan, Quebec
Albert II (prince de Monaco)	Albert II, Prince of Monaco
Rockferry	Rockferry
Thankful (album de Kelly Clarkson)	Thankful (Kelly Clarkson album)
François d'Assise de Bourbon	Francis, Duke of Cádiz
Le Chenit	Le Chenit
Leeuw-Saint-Pierre	Sint-Pieters-Leeuw
Association de la jeunesse auxerroise	AJ Auxerre
Go Over	Goover
My Prerogative	My Prerogative
Pardon Me	Pardon Me
Édouard VII	Edward VII
Nu jazz	Nu jazz
Slovenia football championship	Slovenian PrvaLiga
Luther Vandross	Luther Vandross
Double Vision (song)	Double Vision (3OH!3 song)
Monkey Wrench	Monkey Wrench (song)
Andrew L. Lewis, Jr.	Andrew L. Lewis, Jr.
António Costa	António Costa
George Dantzig	George Dantzig
Colts of Barrie	Barrie Colts
Violet Hill	Violet Hill
Funk rock	Funk rock
Sweetest Thing	Sweetest Thing
You've Got to Hide Your Love Away	You've Got to Hide Your Love Away
Dany Heatley	Dany Heatley
Diessbach bei Büren	Diessbach bei Büren
Ésioff-Léon Patenaude	Esioff-Léon Patenaude
Pisa	Pisa
Bronisław Komorowski	Bronisław Komorowski
Math rock	Math rock
Sebastian Ingrosso	Sebastian Ingrosso
Arnold Schwarzenegger	Arnold Schwarzenegger
Star Trek Into Darkness	Star Trek Into Darkness
Amélie d'Orléans	Amélie of Orléans
Learn to Fly	Learn to Fly
Jean-Luc Dehaene	Jean-Luc Dehaene
Belarusian	Belarusian language
Clark Terry	Clark Terry
Stade San Paolo	Stadio San Paolo
Anne of Austria (1549-1580)	Anna of Austria, Queen of Spain
William P. Barr	William P. Barr
The Way I Are	The Way I Are
Dmitri Medvedev	Dmitry Medvedev
Henry John Temple	Henry John Temple, 3rd Viscount Palmerston
Nu metal	Nu metal
Eton College	Eton College
Christian II of Denmark	Christian II of Denmark
Steve Perry	Steve Perry
Michael Fortier	Michael Fortier
Hämeenlinnan Pallokerho	HPK
Guangzhou Evergrande	Guangzhou Evergrande Taobao F.C.
Steve Kerr	Steve Kerr
Hungarian	Hungarian language
Matt Sorum	Matt Sorum
Kaori Mochida	Kaori Mochida
Nossa Senhora Medianeira	Nossa Senhora Medianeira
Laval (Quebec)	Laval, Quebec
Benjamin Franklin Butler (lawyer)	Benjamin Franklin Butler (lawyer)
İstanbul Başakşehir FK	İstanbul Başakşehir F.K.
Batiscan	Batiscan, Quebec
Timberwolves du Minnesota	Minnesota Timberwolves
Wohlen (Aargau)	Wohlen, Aargau
Giordano Bruno	Giordano Bruno
Pink (singer)	Pink (singer)
Patrice Lefebvre	Patrice Lefebvre
Raymond Spruance	Raymond A. Spruance
Mike Patton	Mike Patton
Barys Astana	Barys Astana
Estoril	Estoril
Soyuz TMA-15M	Soyuz TMA-15M
Anthony Kiedis	Anthony Kiedis
David Ben Gurion	David Ben-Gurion
Oleksandr Turchynov	Oleksandr Turchynov
Mont-Albert	Mont-Albert, Quebec
Joël Bouchard	Joël Bouchard
Philippe Leclerc de Hauteclocque	Philippe Leclerc de Hauteclocque
Hamadi Jebali	Hamadi Jebali
Tihomir Orešković	Tihomir Orešković
Donald Tusk	Donald Tusk
Fleuve Saint-Laurent	Saint Lawrence River
Destiny (Jacksons album)	Destiny (The Jacksons album)
Don't Stop 'Til You Get Enough	Don't Stop 'Til You Get Enough
Alphonse de Bourbon-Siciles (1841-1934)	Prince Alfonso, Count of Caserta
Nossa Senhora das Dores	Nossa Senhora das Dores, Santa Maria
GUN Records	GUN Records
Miss Hulk	She-Hulk
England football championship 2009-2010	2009–10 Premier League
Steve Jones (musician)	Steve Jones (musician)
Me. I Am Mariah The Elusive Chanteuse	Me. I Am Mariah The Elusive Chanteuse
Languedoc-Roussillon-Midi-Pyrénées	Languedoc-Roussillon-Midi-Pyrénées
Gujarati	Gujarati language
Senate (Belgium)	Senate (Belgium)
C++	C++
La Matapédia	La Matapédia Regional County Municipality
Suck My Kiss	Suck My Kiss
Show Me Love	Show Me Love (Robin S. song)
Mariano Rumor	Mariano Rumor
Giovanni Spadolini	Giovanni Spadolini
Jeff Loomis	Jeff Loomis
House of Bourbon-Siciles	House of Bourbon-Two Sicilies
Jyväskylä	Jyväskylä
Brett Sonne	Brett Sonne
Patti LaBelle	Patti LaBelle
Me (album)	Me (Misono album)
Robert Curbeam	Robert Curbeam
Saint-Sébastien (Le Haut-Richelieu)	Saint-Sébastien, Montérégie, Quebec
Université Paris-Ouest-Nanterre-La-Défense	Paris West University Nanterre La Défense
Serbian Progressive Party	Serbian Progressive Party
Adrian Smith	Adrian Smith
Archipel d'Hochelaga	Hochelaga Archipelago
Augusta de Saxe-Gotha-Altenburg	Princess Augusta of Saxe-Gotha
Dragan Đilas	Dragan Đilas
Touch Too Much	Touch Too Much
STS-50	STS-50
Richard Hughes (musician)	Richard Hughes (musician)
Coupe de la Ligue francaise de football 2014-2015	2014–15 Coupe de la Ligue
Miklós Horthy	Miklós Horthy
Ernest-Auguste de Hanovre (1845-1923)	Prince Ernest Augustus, 3rd Duke of Cumberland and Teviotdale
Zurich	Zürich
Rachid Taha	Rachid Taha
Métis-sur-Mer	Métis-sur-Mer, Quebec
Miika Wiikman	Miika Wiikman
João Bernardo Vieira	João Bernardo Vieira
Rueil-Malmaison	Rueil-Malmaison
Massachusetts	Massachusetts
Saint-Tite-des-Caps	Saint-Tite-des-Caps
Heraclitus	Heraclitus
Willebroek	Willebroek
Newt Gingrich	Newt Gingrich
Cannibal (EP)	Cannibal (EP)
Duplessis (district provincial)	Duplessis (electoral district)
Ultra (album)	Ultra (Depeche Mode album)
Netherlands Under-19 Football Team	Netherlands national under-19 football team
Charlie Parker	Charlie Parker
Li Peng	Li Peng
Werner Heisenberg	Werner Heisenberg
The Mark, Tom, and Travis Show (The Enema Strikes Back!)	The Mark, Tom and Travis Show (The Enema Strikes Back!)
Nicolet-Yamaska (district provincial)	Nicolet-Yamaska (electoral district)
Original Soundtracks 1	Original Soundtracks 1
Twisted Sister	Twisted Sister
Sigur Rós	Sigur Rós
Leuze-en-Hainaut	Leuze-en-Hainaut
Alexandre Boulerice	Alexandre Boulerice
True (album d'Avicii)	True (Avicii album)
Saint-Lambert-de-Lauzon	Saint-Lambert-de-Lauzon, Quebec
Kurt Rambis	Kurt Rambis
STS-72	STS-72
Bleach (album)	Bleach (Nirvana album)
Operation Weserübung	Operation Weserübung
Vicente Fox	Vicente Fox
Athletic Club ajaccien	AC Ajaccio
Emma de Normandie	Emma of Normandy
Porsche	Porsche
Gaston Palewski	Gaston Palewski
List of Russian Monarchs	List of Russian rulers
Ne Win	Ne Win
Live à Bercy (album de Mylène Farmer)	Live à Bercy
Toleman	Toleman
University Paris-Sorbonne	Paris-Sorbonne University
Christian Democratic Party of Chile	Christian Democratic Party (Chile)
Kansas	Kansas
Tunnel Vision	Tunnel Vision (song)
Listen to My Heart	Listen to My Heart (BoA album)
Ferdinand II (king of the Two-Sicilies)	Ferdinand II of the Two Sicilies
Victor Entertainment	Victor Entertainment
Boyz II Men	Boyz II Men
Club de Regatas Vasco da Gama	CR Vasco da Gama
Boucherville	Boucherville
Steven Spielberg	Steven Spielberg
Ronald Pofalla	Ronald Pofalla
Nîmes Olympique	Nîmes Olympique
1962 football world cup	1962 FIFA World Cup
Cristian Diaconescu	Cristian Diaconescu
Sainte-Julie (Quebec)	Sainte-Julie, Quebec
Type O Negative	Type O Negative
Conthey	Conthey
Doug Ducey	Doug Ducey
Angry Chair	Angry Chair
Woody Guthrie	Woody Guthrie
PAE Asteras Tripolis	Asteras Tripoli F.C.
Frederic II of Sicily	Frederick III of Sicily
Walk (song)	Walk (Foo Fighters song)
Louis de France (1661-1711)	Louis, Grand Dauphin
Saint-Isidore-de-Clifton	Saint-Isidore-de-Clifton, Quebec
MESSAGE	Message (Aya Ueto album)
Up! (album)	Up! (album)
Arthur Hamilton-Gordon	Arthur Hamilton-Gordon, 1st Baron Stanmore
Paul Alexandrovitch of Russia	Grand Duke Paul Alexandrovich of Russia
The Masterplan (song)	The Masterplan (song)
Bob Kane	Bob Kane
Universal Music Group	Universal Music Group
Montpreveyres	Montpreveyres
Dominique Strauss-Kahn	Dominique Strauss-Kahn
Corsica	Corsica
Government Berlusconi II	Berlusconi II Cabinet
Frank Klepacki	Frank Klepacki
Mika Noronen	Mika Noronen
Coupe de la Ligue francaise de football 2009-2010	2009–10 Coupe de la Ligue
US Secretary of Commerce	United States Secretary of Commerce
Slip-N-Slide Records	Slip-n-Slide Records
Jean-Luc Mélenchon	Jean-Luc Mélenchon
Electro-industrial	Electro-industrial
Katsuya Okada	Katsuya Okada
Charles VI (king of France)	Charles VI of France
Athletic Bilbao	Athletic Bilbao
Peter Schoomaker	Peter Schoomaker
Platform civic	Civic Platform
Calvin Coolidge	Calvin Coolidge
Le Domaine-du-Roy	Le Domaine-du-Roy
Uptown Special	Uptown Special
Patrice de Mac Mahon	Patrice de MacMahon, Duke of Magenta
Pierre Laporte	Pierre Laporte
Gianfranco Fini	Gianfranco Fini
Aisne (department)	Aisne
Saint-Apollinaire (Quebec)	Saint-Apollinaire, Quebec
Paris Première	Paris Première
Hamid Karzai	Hamid Karzai
Oviedo	Oviedo
Nouveau Centre-droit	New Centre-Right
François Ier (roi de France)	Francis I of France
Richie Kotzen	Richie Kotzen
Seat Ibiza	SEAT Ibiza
Rudolf Kirchschläger	Rudolf Kirchschläger
Slippery When Wet	Slippery When Wet
Napoleon II	Napoleon II
National Taiwan University	National Taiwan University
Port of Miami	Port of Miami (album)
Peter Baltes	Peter Baltes
Fordham University	Fordham University
Cody Hodgson	Cody Hodgson
Tammam Salam	Tammam Salam
Anne-Marie David	Anne-Marie David
Philip Hammond	Philip Hammond
The Boy Who Knew Too Much	The Boy Who Knew Too Much (album)
Rob Zepp	Rob Zepp
Hold Me Tight	Hold Me Tight
Abbas II Hilmi	Abbas II of Egypt
Bitch Please II	Bitch Please II
Nintendo Entertainment System	Nintendo Entertainment System
Ghana football team	Ghana national football team
Villeray–Saint-Michel–Parc-Extension	Villeray–Saint-Michel–Parc-Extension
New England	New England
Nigeria football team	Nigeria national football team
Mary de Teck	Mary of Teck
One Love (album de David Guetta)	One Love (David Guetta album)
Saint-Jérôme	Saint-Jérôme, Quebec
Frank Pietrangelo	Frank Pietrangelo
Kingdom of Aragon	Kingdom of Aragon
Loïc Nottet	Loïc Nottet
Cathédrale Notre-Dame de Rouen	Rouen Cathedral
Captain America	Captain America
Fez-Meknes	Fès-Meknès
Large Professor	Large Professor
William Allen Egan	William A. Egan
Iskander Mirza	Iskander Mirza
Union Deportiva Las Palmas	UD Las Palmas
Wanna Be Startin' Somethin'	Wanna Be Startin' Somethin'
William H. Woodin	William H. Woodin
Finger Eleven	Finger Eleven
Gough Whitlam	Gough Whitlam
Naughty Girl	Naughty Girl (Beyoncé song)
José de San Martín	José de San Martín
Audi A3	Audi A3
Jack Layton	Jack Layton
Dream Morning Musume	Dream Morning Musume
Przemysl II	Przemysł II
Diggy Simmons	Diggy Simmons
Stavanger train station	Stavanger Station
Patrick Ollier	Patrick Ollier
Maccabi Tel-Aviv FC	Maccabi Tel Aviv F.C.
CA Independiente	Club Atlético Independiente
University of Wrocław	University of Wrocław
Olympic stadium amsterdam	Olympic Stadium (Amsterdam)
Armenia football team	Armenia national football team
Music for the Masses	Music for the Masses
Henri Queuille	Henri Queuille
Dancing Queen	Dancing Queen
Moncef Marzouki	Moncef Marzouki
US Virgin Islands	United States Virgin Islands
From the Inside (song)	From the Inside (song)
Afrikaners	Afrikaners
Kingdom of Denmark and Norway	Denmark–Norway
Socialist Republic of Romania	Socialist Republic of Romania
Sainte-Brigitte-de-Laval	Sainte-Brigitte-de-Laval
Karl Seitz	Karl Seitz
Saint-Victor (Quebec)	Saint-Victor, Quebec
George III (king of United Kingdom)	George III of the United Kingdom
Oregon	Oregon
Dukla Trenčín	HK Dukla Trenčín
Curtis Brown	Curtis Brown
Milka Planinc	Milka Planinc
Sylvain Simard	Sylvain Simard
Don Heck	Don Heck
Government Solberg	Solberg's Cabinet
Francisco Pinto Balsemão	Francisco Pinto Balsemão
Louis-Philippe Brodeur	Louis-Philippe Brodeur
Alzette	Alzette
Crush (album de Bon Jovi)	Crush (Bon Jovi album)
High and Mighty Color	High and Mighty Color
Mexico	Mexico
Anggun	Anggun
Dupuy (Quebec)	Dupuy, Quebec
Georges de Danemark	Prince George of Denmark
Grow into One	Grow into One
Leo Tindemans	Leo Tindemans
Davíð Oddsson	Davíð Oddsson
Sonny Rollins	Sonny Rollins
Peru football team	Peru national football team
Ferdinand VII	Ferdinand VII of Spain
University of Marburg	University of Marburg
Centre national des indépendants et peasants	National Centre of Independents and Peasants
Geffen Records	Geffen Records
Id Tech 5	Id Tech 5
Feeling This	Feeling This
Olav V	Olav V of Norway
Chuck D	Chuck D
Sainte-Christine-d'Auvergne	Sainte-Christine-d'Auvergne, Quebec
University Notre-Dame-du-Lac	University of Notre Dame
Columbia Records	Columbia Records
The Tubes	The Tubes
No More Mr. Nice Guy (Alice Cooper song)	No More Mr. Nice Guy (song)
Saint-Liboire	Saint-Liboire, Quebec
Team of Côte d'Ivoire de football	Ivory Coast national football team
D12 World	D12 World
Mustafa Kemal Atatürk	Mustafa Kemal Atatürk
Manchester City Football Club reserve and academy team	Manchester City F.C. Reserves and Academy
Government Löfven	Löfven Cabinet
Madagascar	Madagascar
Spiridon Trikoupis	Spyridon Trikoupis
Jean-Louis Borloo	Jean-Louis Borloo
Football Bourg-en-Bresse Péronnas 01	Football Bourg-en-Bresse Péronnas 01
Wilaya d'El Oued	El Oued Province
Jermaine Dupri	Jermaine Dupri
Be Quick or Be Dead	Be Quick or Be Dead
Grande Ourse	Ursa Major
Bulgaria football team	Bulgaria national football team
United Kingdom of Great Britain and Ireland	United Kingdom of Great Britain and Ireland
Ivica Račan	Ivica Račan
Taïeb Fassi-Fihri	Taieb Fassi Fihri
Gelsenkirchen	Gelsenkirchen
Shout It Out Loud (song of Kiss)	Shout It Out Loud (Kiss song)
Modern Records	Modern Records
Bermuda	Bermuda
Équipe de France de football des less de 19 ans	France national under-19 football team
São Paulo	São Paulo
Yang Shangkun	Yang Shangkun
The Red Hot Chili Peppers (album)	The Red Hot Chili Peppers (album)
Moustapha Niasse	Moustapha Niasse
Get the Balance Right!	Get the Balance Right!
Stoneham-and-Tewkesbury	Stoneham-et-Tewkesbury
Palma (Santa Maria)	Palma, Santa Maria
IceCats of Worcester	Worcester IceCats
Dark Horse Records	Dark Horse Records
Herb Brooks Arena	Herb Brooks Arena
Felipe González	Felipe González
People's conservative party	Conservative People's Party (Denmark)
Lotbinière (district provincial)	Lotbinière (provincial electoral district)
Vincent Lecavalier	Vincent Lecavalier
Louis IV Henri de Bourbon-Condé	Louis Henri, Duke of Bourbon
Discipline (album de Janet Jackson)	Discipline (Janet Jackson album)
Rivière-Rouge	Rivière-Rouge
Marie-Louise Coleiro Preca	Marie Louise Coleiro Preca
Take Care (song)	Take Care (song)
Liaqat Ali Khan	Liaquat Ali Khan
The Heat (album de Toni Braxton)	The Heat (Toni Braxton album)
Carabiniers à cheval (France)	Carabiniers-à-Cheval
Congo belge	Belgian Congo
Mott the Hoople	Mott the Hoople
Notre-Dame-de-Montauban	Notre-Dame-de-Montauban, Quebec
The Remix Collection	The Remix Collection (Boyz II Men album)
KV Ostend	K.V. Oostende
Never Let You Go	Never Let You Go (Justin Bieber song)
Kingdom of Hungary	Kingdom of Hungary
I Wanna Be Your Lover	I Wanna Be Your Lover
Steve Hackett	Steve Hackett
Wim Schermerhorn	Willem Schermerhorn
Of Montreal	Of Montreal
Tunisie football team	Tunisia national football team
Creatures of the Night	Creatures of the Night
Nas (rapper)	Nas
Alexandros Papanastasiou	Alexandros Papanastasiou
Nicolás Salmerón	Nicolás Salmerón y Alonso
Princeville	Princeville, Quebec
January 2015 Greek legislative elections	Greek legislative election, January 2015
(I Can't Get No) Satisfaction	(I Can't Get No) Satisfaction
Seek and Destroy (song)	Seek & Destroy
Automatisch	Automatisch
Whitby (Ontario)	Whitby, Ontario
Yves Bolduc	Yves Bolduc
Amharic	Amharic
Nova Santa Marta	Nova Santa Marta
Hanna Suchocka	Hanna Suchocka
Elton John	Elton John
Football Club Tokyo	F.C. Tokyo
Greatest Hits (album des Foo Fighters)	Greatest Hits (Foo Fighters album)
Kamouraska (municipality)	Kamouraska, Quebec
Charles II (king of Spain)	Charles II of Spain
KF Tirana	KF Tirana
Henry Knox	Henry Knox
2014 Indian Legislative Elections	Indian general election, 2014
Éric Hélary	Éric Hélary
Gare TGV Haute-Picardie	Gare TGV Haute-Picardie
Ken Hitchcock	Ken Hitchcock
Paparazzi (song)	Paparazzi (Lady Gaga song)
Legacy Recordings	Legacy Recordings
Jagiellonia Białystok	Jagiellonia Białystok
Akihito	Akihito
Encore (Eminem album)	Encore (Eminem album)
Cover You	Cover You
Eero Heinäluoma	Eero Heinäluoma
Édouard IV	Edward IV of England
George II (king of Britain)	George II of Great Britain
Mary-Anne of-Austria (1635-1696)	Mariana of Austria
W. Michael Blumenthal	W. Michael Blumenthal
Khmer	Khmer language
A Dramatic Turn of Events	A Dramatic Turn of Events
Gdansk	Gdańsk
FC Schalke 04	FC Schalke 04
Lavaltrie	Lavaltrie, Quebec
Rage Against the Machine (album)	Rage Against the Machine (album)
Anthony Kennedy	Anthony Kennedy
The Dutchess	The Dutchess
National Union for the Progress of Romania	National Union for the Progress of Romania
Marissa Cooper	Marissa Cooper
Boisbriand	Boisbriand, Quebec
John Joseph Caldwell Abbott	John Abbott
Blackpool Football Club	Blackpool F.C.
Ariège (department)	Ariège (department)
Murray Rothbard	Murray Rothbard
Enigma (music)	Enigma (musical project)
Papineauville	Papineauville, Quebec
Bernard Laporte	Bernard Laporte
Every Teardrop Is a Waterfall	Every Teardrop Is a Waterfall
Elena Salgado	Elena Salgado
Number Ones	Number Ones (Michael Jackson album)
Brian Gallant	Brian Gallant
Sainte-Anne-de-Sabrevois	Sainte-Anne-de-Sabrevois, Quebec
Alsace-Lorraine	Alsace-Lorraine
STS-116	STS-116
Unione Sportiva Sassuolo Calcio	U.S. Sassuolo Calcio
Rock progressive	Progressive rock
Iain Duncan Smith	Iain Duncan Smith
Herbert Henry Asquith	H. H. Asquith
Scranton	Scranton Penguins
Vojislav Koštunica	Vojislav Koštunica
Union Bordeaux Bègles	Union Bordeaux Bègles
Parma (Ohio)	Parma, Ohio
Bob Sinclar	Bob Sinclar
Nouvelle (Quebec)	Nouvelle, Quebec
Melchior Wathelet (father)	Melchior Wathelet
Granby (Quebec)	Granby, Quebec
Pointe-à-la-Croix	Pointe-à-la-Croix, Quebec
Mohammad Hamid Ansari	Mohammad Hamid Ansari
Esther Phillips	Esther Phillips
Dunkirk	Dunkirk
Eintracht Frankfurt	Eintracht Frankfurt
Mick Jones (foreigner musician)	Mick Jones (Foreigner guitarist)
Pulp (group)	Pulp (band)
Kaliningrad	Kaliningrad
Osaka Prefecture	Osaka Prefecture
I'm a Slave for You	I'm a Slave 4 U
Inhuman Rampage	Inhuman Rampage
Diane Warren	Diane Warren
Naledi Pandor	Naledi Pandor
Beauharnois-Salaberry	Beauharnois-Salaberry Regional County Municipality
Thomas Jefferson	Thomas Jefferson
Denis Thatcher	Denis Thatcher
Paul-Henri Spaak	Paul-Henri Spaak
Brian Lawton	Brian Lawton
Run It!	Run It!
Jacques-Cartier (district provincial)	Jacques-Cartier
Predrag Stojaković	Peja Stojaković
Rochdale Association Football Club	Rochdale A.F.C.
Stadium Lille Métropole	Stadium Lille Métropole
Tabaré Vázquez	Tabaré Vázquez
Duran Duran (album de 1993)	Duran Duran (1993 album)
John Marshall (politician)	John Marshall
Chaim Herzog	Chaim Herzog
Hungarian Socialist Worker Party	Hungarian Socialist Workers' Party
Marie Bashir	Marie Bashir
Punsalmaagiyn Ochirbat	Punsalmaagiin Ochirbat
Marcel Proust	Marcel Proust
Head Like a Hole	Head Like a Hole
Real Salt Lake	Real Salt Lake
Notre-Dame-de-l'Île-Perrot	Notre-Dame-de-l'Île-Perrot
Rumst	Rumst
Petar Stambolić	Petar Stambolić
Einars Repše	Einars Repše
Falling into Infinity	Falling into Infinity
Dave Hancock	Dave Hancock
Roger O'Donnell	Roger O'Donnell
Abdellatif Filali	Abdellatif Filali
Jordi Pujol	Jordi Pujol i Soley
The Kill	The Kill
Big beat	Big beat
Slaughterhouse (supergroup)	Slaughterhouse (hip hop group)
Rijeka	Rijeka
The Unforgettable Fire (album)	The Unforgettable Fire
Fats Domino	Fats Domino
Aloe Blacc	Aloe Blacc
Walk On (song)	Walk On (U2 song)
Dreams (son des Cranberries)	Dreams (The Cranberries song)
Lena Hjelm-Wallén	Lena Hjelm-Wallén
Muammar Gaddafi	Muammar Gaddafi
Daredevil	Daredevil (Marvel Comics)
Associazione Calcio Fiorentina	ACF Fiorentina
Honeymoon (album)	Honeymoon (Lana Del Rey album)
Katrin Göring-Eckardt	Katrin Göring-Eckardt
Mariners du Maine	Maine Mariners
John Torchetti	John Torchetti
Haile Mariam Dessalegn	Hailemariam Desalegn
Tom DeFalco	Tom DeFalco
Saint-André-de-Restigouche	Saint-André-de-Restigouche, Quebec
Martial Asselin	Martial Asselin
Saint-Théophile	Saint-Théophile, Quebec
Western Sydney Wanderers Football Club	Western Sydney Wanderers FC
Amherst (Quebec)	Amherst, Quebec
William Pitt the Elder	William Pitt, 1st Earl of Chatham
Jadakiss	Jadakiss
Jerry Cantrell	Jerry Cantrell
Marie-Adélaïde (grand-duchess of Luxembourg)	Marie-Adélaïde, Grand Duchess of Luxembourg
Kathleen Sebelius	Kathleen Sebelius
Herbert Plumer	Herbert Plumer, 1st Viscount Plumer
WCW Fall Brawl	Fall Brawl
Cabinet Merkel II	Second Merkel cabinet
Les Sources	Les Sources Regional County Municipality
Charles of Sweden (1861-1951)	Prince Carl, Duke of Västergötland
Vitali Klitschko	Vitali Klitschko
Élisabeth Ire (empress of Russia)	Elizabeth of Russia
List of the presidents of Peru	List of Presidents of Peru
Gilbert Elliot-Murray-Kynynmound (4th earl of Minto)	Gilbert Elliot-Murray-Kynynmound, 4th Earl of Minto
Marie-Béatrice de Modène (1824-1906)	Archduchess Maria Beatrix of Austria-Este
Dariusz Michalczewski	Dariusz Michalczewski
Ludwig von Mises	Ludwig von Mises
STS-67	STS-67
Deadpool	Deadpool
Friedrich Ebert	Friedrich Ebert
Anna Bligh	Anna Bligh
Johnny Hallyday	Johnny Hallyday
Pedro de Sousa Holstein	Pedro de Sousa Holstein, 1st Duke of Palmela
Gouvernement Berlusconi III	Berlusconi III Cabinet
Charles VII (king of France)	Charles VII of France
Gamba Osaka	Gamba Osaka
Bert Koenders	Bert Koenders
Isone	Isone
Bayadha	Bayadha
John Wakeham	John Wakeham
Turkish Football Championship	Süper Lig
Papa Roach	Papa Roach
Songs in A Minor	Songs in A Minor
Francisco Sá Carneiro	Francisco de Sá Carneiro
Konstantínos Mitsotakis	Konstantinos Mitsotakis
You Can't Do That	You Can't Do That
Donald Eugene Siegelman	Don Siegelman
Plotinus	Plotinus
I Want You Back	I Want You Back
Neo soul	Neo soul
Adelaide de Saxe-Meiningen	Adelaide of Saxe-Meiningen
County of Scania	Skåne County
Alexi Laiho	Alexi Laiho
George Armstrong Custer	George Armstrong Custer
The Edge	The Edge
Nakhla	Nakhla, Algeria
Alex Turner (musician)	Alex Turner (musician)
Acid house	Acid house
Miami	Miami
Antonio Gramsci	Antonio Gramsci
Duality	Duality (song)
Bettino Craxi	Bettino Craxi
Marguerite of-Austria-Styria	Margaret of Austria, Queen of Spain
Saint-Fabien-de-Panet	Saint-Fabien-de-Panet, Quebec
Jumpin', Jumpin'	Jumpin', Jumpin'
Adam's Song	Adam's Song
Charles Fitzpatrick	Charles Fitzpatrick
Feroze Gandhi	Feroze Gandhi
Felix Pappalardi	Felix Pappalardi
Mac Miller	Mac Miller
Team Wales football prospects	Wales national under-21 football team
William Clements	Bill Clements
Richmond (provincial riding)	Richmond (Quebec provincial electoral district)
The Night Before	The Night Before (song)
Alain Badiou	Alain Badiou
Showbiz and A.G.	Showbiz and A.G.
A Real Live One	A Real Live One
Phoenix (Arizona)	Phoenix, Arizona
William Shakespeare	William Shakespeare
Haakon VII	Haakon VII of Norway
Massimo D'Alema	Massimo D'Alema
Jean-Luc Marion	Jean-Luc Marion
Nicky Morgan	Nicky Morgan (politician)
Disturbed	Disturbed (band)
Gucci Mane	Gucci Mane
Don Cherry (musician)	Don Cherry (trumpeter)
Charles Francis Adams III	Charles Francis Adams III
The Days (song)	The Days (song)
Nuno Resende	Nuno Resende
Wolfgang Schäuble	Wolfgang Schäuble
Primus (group)	Primus (band)
Little Renard	Vulpecula
Coupe de Suisse de football 2011-2012	2011–12 Swiss Cup
Football Confederation of North American, Central American and Caribbean	CONCACAF
Richard Wright (musician)	Richard Wright (musician)
CrazySexyCool	CrazySexyCool
Delaware	Delaware
Shanghai SIPG	Shanghai SIPG F.C.
Patrick Hillery	Patrick Hillery
Jason Kay	Jay Kay
Nino Bourdjanadze	Nino Burjanadze
When Your Heart Stops Beating	When Your Heart Stops Beating
Pyrénées-Orientales	Pyrénées-Orientales
Hollow (song)	Hollow (Alice in Chains song)
Ultraviolence (album)	Ultraviolence (album)
House of Representatives of Belgium	Chamber of Representatives (Belgium)
Ferdinand III of Habsburg	Ferdinand III, Holy Roman Emperor
Driss Jettou	Driss Jettou
Middleburg Heights (Ohio)	Middleburg Heights, Ohio
Disraeli Gears	Disraeli Gears
Elihu Root	Elihu Root
Doug Gilmour	Doug Gilmour
Supernatural (tv series)	Supernatural (U.S. TV series)
Ernst Kaltenbrunner	Ernst Kaltenbrunner
Guy Verhofstadt	Guy Verhofstadt
Melanie Joly	Mélanie Joly
Beatrix (queen of the Netherlands)	Beatrix of the Netherlands
Red Bull Racing	Red Bull Racing
George Fuller	George Fuller (Australian politician)
George Monckton-Arundell	George Monckton-Arundell, 8th Viscount Galway
Osvaldo Andrade	Osvaldo Andrade
Paraná (State)	Paraná (state)
South Island	South Island
Sino-Japanese War (1894-1895)	First Sino-Japanese War
Hubert Ingraham	Hubert Ingraham
Gaston Eyskens	Gaston Eyskens
Malmo	Malmö
Albert de Saxe-Cobourg-Gotha	Albert, Prince Consort
Sheffield Wednesday Football Club	Sheffield Wednesday F.C.
The Spy who loved me	The Spy Who Loved Me (film)
Yuki Kajiura	Yuki Kajiura
Charles de Bourbon-Siciles (1870-1949)	Prince Carlos of Bourbon-Two Sicilies
Ain't That a Shame	Ain't That a Shame
Iolu Abil	Iolu Abil
Henri de Goritz	Henry of Bohemia
Henri Pescarolo	Henri Pescarolo
Hot Stuff (song by Kumi Kōda)	Hot Stuff (Kumi Koda song)
Sidi Aoun	Sidi Aoun
Diet of the Republic of Poland	Sejm
Rap God	Rap God
Horror punk	Horror punk
La Redemption	La Rédemption, Quebec
Saint-Jean (New Brunswick)	Saint John, New Brunswick
John Zorn	John Zorn
Causapscal	Causapscal
Route 132 (Quebec)	Quebec Route 132
Rock néo-progressive	Neo-progressive rock
Poularies	Poularies, Quebec
Hérouxville	Hérouxville, Quebec
Looney Tunes	Looney Tunes
Sunshine pop	Sunshine pop
Government Vučić	Cabinet of Aleksandar Vučić
Meritorious Service Medal (USA)	Meritorious Service Medal (United States)
Union of Soviet Socialist Republics	Soviet Union
Côte-des-Neiges–Notre-Dame-de-Grâce	Côte-des-Neiges–Notre-Dame-de-Grâce
Pontiac Montana	Pontiac Montana
Saint-Martin (Quebec)	Saint-Martin, Quebec
Martine Aubry	Martine Aubry
Les Mondes de Ralph	Wreck-It Ralph
Okuru kotoba	Okuru Kotoba
Edi Rama	Edi Rama
Admiral Vladivostok	Admiral Vladivostok
Bob Dylan at Budokan	Bob Dylan at Budokan
Pavel Datsiouk	Pavel Datsyuk
Saint-Ferréol-les-Neiges	Saint-Ferréol-les-Neiges
Saint-Romain (Quebec)	Saint-Romain, Quebec
Iron Maiden	Iron Maiden
Frédéric Ier de Brandebourg	Frederick I, Elector of Brandenburg
Anna-Maja Henriksson	Anna-Maja Henriksson
Miles Davis	Miles Davis
Catherine de Castille	Catherine of Austria, Queen of Portugal
Mobutu Sese Seko	Mobutu Sese Seko
One Day Remains	One Day Remains
Anni Sinnemäki	Anni Sinnemäki
Denholm	Denholm, Quebec
University of Cologne	University of Cologne
Namur	Namur
Tanzania	Tanzania
Dorothée de Danemark	Dorothea of Denmark, Duchess of Brunswick-Lüneburg
Sean Paul	Sean Paul
PFC Litex Lovetch	PFC Litex Lovech
Latulipe-et-Gaboury	Latulipe-et-Gaboury, Quebec
Hot Hot Hot!!!	Hot Hot Hot!!! (The Cure song)
Charles le Téméraire	Charles the Bold
Brian Eno	Brian Eno
Zakir Hussain (politician)	Zakir Husain (politician)
Moon (single)	Moon (EP)
CryEngine	CryEngine
Venceslas de Luxembourg	Wenceslaus IV of Bohemia
Somebody That I Used to Know	Somebody That I Used to Know
Shirley Bassey	Shirley Bassey
Nami Tamaki	Nami Tamaki
Hirohisa Fujii	Hirohisa Fujii
Kraï de Perm	Perm Krai
Rivière-du-Loup	Rivière-du-Loup
Misfits (group)	Misfits (band)
Love and Honey	Love & Honey
Alleyn-and-Cawood	Alleyn-et-Cawood, Quebec
Running Up that Hill	Running Up That Hill
Poitou-Charentes	Poitou-Charentes
Orlando Pirates Football Club	Orlando Pirates
