Dimitris Sioufas	Dimitris Sioufas
La Línea	La L%C3%ADnea de la Concepci%C3%B3n
Sherry Rehman	Sherry Rehman
Fidel Castro	Fidel Castro
Mikhail Sergeyevich Gorbachev	Mikhail Gorbachev
Solomon P. Ortiz	Solomon P. Ortiz
Miriam Defensor Santiago	Miriam Defensor Santiago
Andrew Adonis	Andrew Adonis, Baron Adonis
T. Michael Moseley	T. Michael Moseley
Kōichirō Genba	K%C5%8Dichir%C5%8D Genba
Yaakov Edri	Yaakov Edri
Gnassingbé Eyadéma	Gnassingb%C3%A9 Eyad%C3%A9ma
Sheikh Hamad bin Khalifa al-Thani	Hamad bin Khalifa Al Thani
Justicialist Party	Justicialist Party
Patrick M. Hughes	Patrick M. Hughes
Isabel Carrasco	Isabel Carrasco
Tibor Navracsics	Tibor Navracsics
Paavo Lipponen	Paavo Lipponen
David Lidington	David Lidington
Jaroslaw Kaczynski	Jaros%C5%82aw Kaczy%C5%84ski
Jean-Pierre Soisson	Jean-Pierre Soisson
Karel De Gucht	Karel De Gucht
Abdurrahman Wahid	Abdurrahman Wahid
John Abizaid	John Abizaid
Jim Prentice	Jim Prentice
Luciano Pavarotti	Luciano Pavarotti
Nguyen Phu Trong	Nguy%E1%BB%85n Ph%C3%BA Tr%E1%BB%8Dng
Brian Cowen	Brian Cowen
Roland Koch	Roland Koch
Miguel Arraes	Miguel Arraes
Thad Cochran	Thad Cochran
Cantabria	Cantabria
Tamim bin Hamad Al Thani	Tamim bin Hamad Al Thani
Karl-Theodor zu Guttenberg	Karl-Theodor zu Guttenberg
Manuel Valls	Manuel Valls
Henri Emmanuelli	Henri Emmanuelli
Oleg Ivanovich Lobov	Oleg Lobov
Arsen Avakov	Arsen Avakov
Rick Boucher	Rick Boucher
University of Ottawa	University of Ottawa
Jack Markell	Jack Markell
Pavel Tigrid	Pavel Tigrid
Javier Pérez de Cuéllar	Javier P%C3%A9rez de Cu%C3%A9llar
Gerda Hasselfeldt	Gerda Hasselfeldt
Jacques Delors	Jacques Delors
Jay Rockefeller	Jay Rockefeller
Fulvio Rossi	Fulvio Rossi
Sovereign Military Hospitaller Order of Saint John of Jerusalem of Rhodes and of Malta	Sovereign Military Order of Malta
Christian Estrosi	Christian Estrosi
Victor Ponta	Victor Ponta
Khaleda Zia	Khaleda Zia
Wales	Wales
Simonetta Sommaruga	Simonetta Sommaruga
Church of Greece	Church of Greece
Gonzalo Sanchez de Lozada	Gonzalo S%C3%A1nchez de Lozada
Hartmut Bagger	Hartmut Bagger
Sergey Menyaylo	Sergey Menyaylo
Chatichai Choonhavan	Chatichai Choonhavan
Marietta Giannakou	Marietta Giannakou
C. W. Bill Young	Bill Young
Lord President of the Council	Lord President of the Council
France Cukjati	France Cukjati
Hugo Swire	Hugo Swire
Dzhokhar Dudayev	Dzhokhar Dudayev
Acoustics Research Institute	Austrian Academy of Sciences
International Business Machines Corporation	IBM
Roscoe G. Bartlett	Roscoe Bartlett
Hervé de Charette	Herv%C3%A9 de Charette
Valdemar Tomaševski	Valdemar Toma%C5%A1evski
Ole von Beust	Ole von Beust
Guillermo Ramirez	Guillermo Ram%C3%ADrez
Géza Jeszenszky	G%C3%A9za Jeszenszky
Luis V. Gutierrez	Luis Guti%C3%A9rrez
Aleksandr Tikhonov	Alexander Tikhonov
Alina Fernández	Alina Fern%C3%A1ndez
Vlad Filat	Vlad Filat
Sergiy Tigipko	Serhiy Tihipko
Spyridon Flogaitis	Spyridon Flogaitis
Yukiya Amano	Yukiya Amano
Eli Lilly	Eli Lilly
Marcus Stephen	Marcus Stephen
Binyamin Ben-Eliezer	Binyamin Ben-Eliezer
Steve Daines	Steve Daines
Patrick Buchanan	Pat Buchanan
Jay Weatherill	Jay Weatherill
Mario Barletta	Mario Barletta
Radovan Karadzic	Radovan Karad%C5%BEi%C4%87
Wangari Maathai	Wangari Maathai
Erwin Huber	Erwin Huber
Alpha Kappa Alpha	Alpha Kappa Alpha
Toivo Asmer	Toivo Asmer
Jens Weidmann	Jens Weidmann
Nikola Pejakovic	Nikola Pejakovi%C4%87
Tommy Lapid	Tommy Lapid
Giovanni Lajolo	Giovanni Lajolo
Grigory Alexeyevich Yavlinsky	Grigory Yavlinsky
Anwar as-Sadat	Anwar Sadat
Yevhen Marchuk	Yevhen Marchuk
Greta Thunberg	Greta Thunberg
Yevgeny Maksimovich Primakov	Yevgeny Primakov
Tuva	Tuva
Socialists' Party of Catalonia	Socialists%27 Party of Catalonia
Hans-Gert Pöttering	Hans-Gert P%C3%B6ttering
University of Sussex	University of Sussex
Vladimir Yegorov	Vladimir Yegorov
Ivan Safronov	Ivan Safronov
Communist Party of the Republic of Moldova	Party of Communists of the Republic of Moldova
Kostyantyn Gryshchenko	Kostyantyn Gryshchenko
Antonio Inoki	Antonio Inoki
Hannelore Kraft	Hannelore Kraft
Zuzana Roithová	Zuzana Roithov%C3%A1
Khosrov Harutyunyan	Khosrov Harutyunyan
Lee Teng Hui	Lee Teng-hui
Shlomo Ben-Ami	Shlomo Ben-Ami
Eliot Spitzer	Eliot Spitzer
Andreas Loverdos	Andreas Loverdos
Alexander Dzasokhov	Alexander Dzasokhov
Moscow State University	Moscow State University
Austrian Federal Railways	%C3%96BB
Alberto João Cardoso Gonçalves Jardim	Alberto Jo%C3%A3o Jardim
Johannes Hahn	Johannes Hahn
L'Express	L%27Express
Grace Kelly	Grace Kelly
Sally Jewell	Sally Jewell
Luiz Inacio Lula Da Silva	Luiz In%C3%A1cio Lula da Silva
Turks and Caicos Islands	Turks and Caicos Islands
Norbert Röttgen	Norbert R%C3%B6ttgen
Melchior Wathelet	Melchior Wathelet
Libération	Lib%C3%A9ration
Michel Camdessus	Michel Camdessus
Jean-Michel Baylet	Jean-Michel Baylet
Nadiya Savchenko	Nadiya Savchenko
Dmitry Livanov	Dmitry Livanov
Murtaza Rakhimov	Murtaza Rakhimov
Milan Kucan	Milan Ku%C4%8Dan
Agustín Rossi	Agust%C3%ADn Rossi
Corazon Aquino	Corazon Aquino
Keiko Fujimori	Keiko Fujimori
Heizo Takenaka	Heiz%C5%8D Takenaka
Douglas Hurd	Douglas Hurd
Fiji	Fiji
National Party of Australia	National Party of Australia
Connie Morella	Connie Morella
Mario Blejer	Mario Blejer
Harald Kujat	Harald Kujat
Al Gore	Al Gore
Bharatiya Janata	Bharatiya Janata Party
Leszek Miller	Leszek Miller
Willy Claes	Willy Claes
Kakha Kaladze	Kakha Kaladze
David Blunkett	David Blunkett
John Dawkins	John Dawkins
Julie Bishop	Julie Bishop
Shulamit Aloni	Shulamit Aloni
Nuon Chea	Nuon Chea
Liese Prokop	Liese Prokop
Port Said	Port Said
Jesús María Posada Moreno	Jes%C3%BAs Posada
Jussi Niinistö	Jussi Niinist%C3%B6
Eric Garcetti	Eric Garcetti
Yehuda Glick	Yehudah Glick
Andrew David Lansley	Andrew Lansley
John Sarbanes	John Sarbanes
Nandan Nilekani	Nandan Nilekani
Lionel Jospin	Lionel Jospin
Óscar Iván Zuluaga	%C3%93scar Iv%C3%A1n Zuluaga
Solomon Islands	Solomon Islands
Chet Edwards	Chet Edwards
Tony O'Reilly	Tony O%27Reilly
Carlos Saul Menem	Carlos Menem
Lal Krishna Advani	L. K. Advani
Mathias Cormann	Mathias Cormann
Google	Google
Ian Paisley	Ian Paisley
Israel	Israel
Mihai Tănăsescu	Mihai T%C4%83n%C4%83sescu
Viktor Pynzenyk	Viktor Pynzenyk
Jacqueline Cramer	Jacqueline Cramer
Federico Lombardi	Federico Lombardi
Kevin Rudd	Kevin Rudd
Gary Faye Locke	Gary Locke
Petro Poroshenko	Petro Poroshenko
Candice Bergen	Candice Bergen
Tatyana Golikova	Tatyana Golikova
Juan Almeida Bosque	Juan Almeida Bosque
Mário Alberto Nobre Lopes Soares	M%C3%A1rio Soares
Sajid Javid	Sajid Javid
Albio Sires	Albio Sires
Sergey Aksyonov	Sergey Aksyonov
Joachim Gauck	Joachim Gauck
Michael Kocáb	Michael Koc%C3%A1b
Vo Nguyen Giap	V%C3%B5 Nguy%C3%AAn Gi%C3%A1p
Ingibjörg Sólrún Gísladóttir	Ingibj%C3%B6rg S%C3%B3lr%C3%BAn G%C3%ADslad%C3%B3ttir
Bogdan Klich	Bogdan Klich
James G. Stavridis	James G. Stavridis
Jean-Louis Tauran	Jean-Louis Tauran
Edi Rama	Edi Rama
Indrek Tarand	Indrek Tarand
Samuel Schmid	Samuel Schmid
Kevin Spacey	Kevin Spacey
Vittorio Grilli	Vittorio Grilli
Frederic Cuvillier	Fr%C3%A9d%C3%A9ric Cuvillier
Yulia Tymoshenko	Yulia Tymoshenko
Kaspar Villiger	Kaspar Villiger
Piet Bukman	Piet Bukman
Hansford T. Johnson	Hansford T. Johnson
Oleksandr Lavrynovych	Oleksandr Lavrynovych
Ahmet Davutoglu	Ahmet Davuto%C4%9Flu
Tony Blair	Tony Blair
Lauch Faircloth	Lauch Faircloth
Jim Saxton	Jim Saxton
Shintaro Ishihara	Shintaro Ishihara
Gilles Duceppe	Gilles Duceppe
Igor Kornelyuk	Igor Kornelyuk
Front for Victory	Front for Victory
McGill University	McGill University
Takeshi Onaga	Takeshi Onaga
Adrian Smith	Adrian Smith
Sergey Gaplikov	Sergey Gaplikov
Daniel Toribio	Daniel Toribio
Ted Kulongoski	Ted Kulongoski
Vincenzo Scotti	Vincenzo Scotti
Novartis	Novartis
Viktor Borisovich Khristenko	Viktor Khristenko
Adolfo Rodríguez Saá	Adolfo Rodr%C3%ADguez Sa%C3%A1
Marine Le Pen	Marine Le Pen
Rein Lang	Rein Lang
Susan Collins	Susan Collins
Aldo Giordano	Aldo Giordano
Andrés Bello Catholic University	Andr%C3%A9s Bello Catholic University
Christos Stylianides	Christos Stylianides
Dimitris Christofias	Demetris Christofias
Sir David Richards	David Richards, Baron Richards of Herstmonceux
Lamberto Dini	Lamberto Dini
Fernando Grande-Marlaska	Fernando Grande-Marlaska
Valdis Birkavs	Valdis Birkavs
Okiharu Yasuoka	Okiharu Yasuoka
Brian Mikkelsen	Brian Mikkelsen
Chuvashia	Chuvashia
Salman Khan	Salman Khan
Terry McAuliffe	Terry McAuliffe
Rosen Plevneliev	Rosen Plevneliev
Turgut Özal	Turgut %C3%96zal
Kasymzhomart Tokayev	Kassym-Jomart Tokayev
Tassos Papadopoulos	Tassos Papadopoulos
Bradley Manning	Chelsea Manning
Steve Bracks	Steve Bracks
Francisco Blake Mora	Francisco Blake Mora
John Agyekum Kufuor	John Kufuor
Denis Berezovsky	Denis Berezovsky
France	France
Ayatollah Mohammad Beheshti	Mohammad Beheshti
Corina Casanova	Corina Casanova
Liberal Democratic Party of Russia	Liberal Democratic Party of Russia
Brazilian Social Democracy Party	Brazilian Social Democracy Party
George Shultz	George Shultz
Javier Solana	Javier Solana
Denny Tamaki	Denny Tamaki
Süleyman Demirel	S%C3%BCleyman Demirel
Rudolf Seiters	Rudolf Seiters
Anand Satyanand	Anand Satyanand
Fredrik Reinfeldt	Fredrik Reinfeldt
Gerald Klug	Gerald Klug
Paul Simon	Paul Simon
António Manuel de Oliveira Guterres	Ant%C3%B3nio Guterres
Andris Piebalgs	Andris Piebalgs
Jalaluddin Haqqani	Jalaluddin Haqqani
Gianni Letta	Gianni Letta
Jack Layton	Jack Layton
Latvia	Latvia
Saxby Chambliss	Saxby Chambliss
Aristotelis Pavlidis	Aristotelis Pavlidis
Nehru University	Jawaharlal Nehru University
Andriy Sadovyi	Andriy Sadovyi
Fethullah Gulen	Fethullah G%C3%BClen
Mirek Topolánek	Mirek Topol%C3%A1nek
Henry McLeish	Henry McLeish
Reuven Rivlin	Reuven Rivlin
Jürgen Ligi	J%C3%BCrgen Ligi
Louise Arbour	Louise Arbour
Karolos Papoulias	Karolos Papoulias
Alberto Fernández	Alberto Fern%C3%A1ndez
Guido Carli	Guido Carli
Gough Whitlam	Gough Whitlam
Carlos Lemos Simmonds	Carlos Lemos Simmonds
Ted Poe	Ted Poe
Hanno Pevkur	Hanno Pevkur
Valdis Dombrovskis	Valdis Dombrovskis
Arpad Goncz	%C3%81rp%C3%A1d G%C3%B6ncz
Valentin Inzko	Valentin Inzko
Eiki Nestor	Eiki Nestor
Alexandru Mosanu	Alexandru Mo%C8%99anu
Israeli Labor Party	Israeli Labor Party
Stephen W. Bosworth	Stephen W. Bosworth
Brigitte Zypries	Brigitte Zypries
Michel Suleiman	Michel Suleiman
Bjørn Tore Godal	Bj%C3%B8rn Tore Godal
Ton Duc Thang	T%C3%B4n %C4%90%E1%BB%A9c Th%E1%BA%AFng
Uri Rosenthal	Uri Rosenthal
Emmanuel Macron	Emmanuel Macron
Cardinal Darío Castrillón Hoyos	Dar%C3%ADo Castrill%C3%B3n Hoyos
Sofia Voultepsi	Sofia Voultepsi
Moshoeshoe II	Moshoeshoe II of Lesotho
Radical Party of the Left	Radical Party of the Left
David Emerson	David Emerson
Alfredo Barnechea	Alfredo Barnechea
Harvard University	Harvard University
Cousteau Society	Jacques Cousteau
Carlos Rodado Noriega	Carlos Rodado Noriega
Senegal	Senegal
Barney Frank	Barney Frank
Mark Rutte	Mark Rutte
University of Chile	University of Chile
Stephen Hadley	Stephen Hadley
Dan Burton	Dan Burton
Ignazio Cassis	Ignazio Cassis
Martin McGuinness	Martin McGuinness
Ilse Aigner	Ilse Aigner
Jadranka Kosor	Jadranka Kosor
Moshe Arens	Moshe Arens
Dean Heller	Dean Heller
Valentin Sergeyevich Pavlov	Valentin Pavlov
Tatar	Tatars
Robert E. Andrews	Rob Andrews
Vincent Cable	Vince Cable
Christina Romer	Christina Romer
Edward Michael Balls	Ed Balls
Beniamino Andreatta	Beniamino Andreatta
Inner Mongolia	Inner Mongolia
Ginny Brown-Waite	Ginny Brown-Waite
Bulgaria	Bulgaria
Eric H. Holder	Eric Holder
Óscar Andrés Rodríguez Maradiaga	%C3%93scar Rodr%C3%ADguez Maradiaga
Sergio Diez	Sergio Diez
Hage Geingob	Hage Geingob
Josef Pröll	Josef Pr%C3%B6ll
Commonwealth of Independent States	Commonwealth of Independent States
Dick Spring	Dick Spring
Wladyslaw Stasiak	W%C5%82adys%C5%82aw Stasiak
Edith Schippers	Edith Schippers
University of Cape Town	University of Cape Town
Allan Meltzer	Allan H. Meltzer
Leire Pajín	Leire Paj%C3%ADn
Vernon Buchanan	Vern Buchanan
Dale Bumpers	Dale Bumpers
John Linder	John Linder
Spanish Army	Spanish Army
René Teulade	Ren%C3%A9 Teulade
Karen Ellemann	Karen Ellemann
Wladyslaw Bartoszewski	W%C5%82adys%C5%82aw Bartoszewski
Abu Darda	Abu Darda
Timothy J. Keating	Timothy J. Keating
Ralph E. Eberhart	Ralph Eberhart
Eduard Shevardnadze	Eduard Shevardnadze
Arkady Rotenberg	Arkady Rotenberg
Moderate Party	Moderate Party
Siiri Oviir	Siiri Oviir
Swraj Paul	Swraj Paul, Baron Paul
Hafez al-Assad	Hafez al-Assad
National Congress Party	Indian National Congress
Antonio Brancaccio	Antonio Brancaccio
H. R. McMaster	H. R. McMaster
Giannis Ragousis	Giannis Ragousis
Yitzhak Mordechai	Yitzhak Mordechai
Bank of America	Bank of America
Vladimir Igorevich Kozhin	Vladimir Kozhin
Violeta Bulc	Violeta Bulc
Communist Party of Bohemia and Moravia	Communist Party of Bohemia and Moravia
Murat Magometovich Zyazikov	Murat Zyazikov
Robert Douglas Nicholson	Rob Nicholson
Electronic Arts Inc.	Electronic Arts
Eberhard van der Laan	Eberhard van der Laan
Catalonia	Catalonia
Jose Maria Velasco Ibarra	Jos%C3%A9 Mar%C3%ADa Velasco Ibarra
Complutense University of Madrid	Complutense University of Madrid
Marion Barry	Marion Barry
Carla Del Ponte	Carla Del Ponte
Paolo Gentiloni	Paolo Gentiloni
David Libai	David Libai
Fred Thompson	Fred Thompson
Marco Maciel	Marco Maciel
Manfred Kanther	Manfred Kanther
Charles Pasqua	Charles Pasqua
Naftali Bennett	Naftali Bennett
Aland Islands	%C3%85land
Viktor Basargin	Viktor Basargin
Justin Trudeau	Justin Trudeau
Ali Abdullah Saleh	Ali Abdullah Saleh
Mary L. Landrieu	Mary Landrieu
Swaziland	Eswatini
Carlos Santana	Carlos Santana
Cesar Camacho Quiroz	C%C3%A9sar Camacho Quiroz
Eritrea	Eritrea
Anson Chan	Anson Chan
Paavo Väyrynen	Paavo V%C3%A4yrynen
Connie Hedegaard	Connie Hedegaard
Abdus Samad Azad	Abdus Samad Azad
Hassanal Bolkiah Mu'izzadin Waddaulah	Hassanal Bolkiah
George Osborne	George Osborne
Madeira	Madeira
Arne Duncan	Arne Duncan
Anatoliy Eduardovich Serdyukov	Anatoly Serdyukov
Ramzan Akhmadovich Kadyrov	Ramzan Kadyrov
Sam Brownback	Sam Brownback
Ali Abbasov	Ali Abbasov
Evo Morales	Evo Morales
Paul Ryan	Paul Ryan
Mümtaz Soysal	M%C3%BCmtaz Soysal
African Union – United Nations Hybrid Operation in Darfur	United Nations%E2%80%93African Union Mission in Darfur
Jean-François Hory	Jean-Fran%C3%A7ois Hory
Andranik Markaryan	Andranik Margaryan
Aleksandar Vulin	Aleksandar Vulin
Alexander Stubb	Alexander Stubb
Rebecca Harms	Rebecca Harms
Mikhail Margelov	Mikhail Margelov
Gun Hellsvik	Gun Hellsvik
Michel Mercier	Michel Mercier
Yevgeny Shevchuk	Yevgeny Shevchuk
R. Nicholas Burns	R. Nicholas Burns
Audronius Ažubalis	Audronius A%C5%BEubalis
Ewald Nowotny	Ewald Nowotny
Joris Voorhoeve	Joris Voorhoeve
Brunei	Brunei
José María Gil-Robles	Jos%C3%A9 Mar%C3%ADa Gil-Robles
Bosnia and Herzegovina	Bosnia and Herzegovina
Bill Gates	Bill Gates
Kostas Skandalidis	Kostas Skandalidis
Chuck Grassley	Chuck Grassley
Morris Iemma	Morris Iemma
Dagestan	Dagestan
Antônio Carlos Magalhães	Ant%C3%B4nio Carlos Magalh%C3%A3es
Jerry Lewis	Jerry Lewis
José Montilla Aguilera	Jos%C3%A9 Montilla
Amnesty International	Amnesty International
Leonid Kravchuk	Leonid Kravchuk
Nikolai Platonovich Patrushev	Nikolai Patrushev
Kaushik Basu	Kaushik Basu
Bruno Stagno Ugarte	Bruno Stagno Ugarte
Jean Charest	Jean Charest
United Russia	United Russia
Pascale Bruderer	Pascale Bruderer
Lord Chancellor	Lord Chancellor
Central American Bank for Economic Integration	Central American Bank for Economic Integration
Jyoti Basu	Jyoti Basu
Wolfgang Gerhardt	Wolfgang Gerhardt
Nicolás Maduro	Nicol%C3%A1s Maduro
Fernando Lorenzo	Fernando Lorenzo
Antanas Mockus	Antanas Mockus
Herbert Bösch	Herbert B%C3%B6sch
Mohammad Habibur Rahman	Muhammad Habibur Rahman
Urho Kekkonen	Urho Kekkonen
Lucy Turnbull	Lucy Turnbull
Richard Caborn	Richard Caborn
Riitta Uosukainen	Riitta Uosukainen
David L. Aaron	David L. Aaron
Yaakov Neeman	Yaakov Neeman
Jörg Haider	J%C3%B6rg Haider
Brazilian Socialist Party	Brazilian Socialist Party
Mogens Lykketoft	Mogens Lykketoft
Maciej Plazynski	Maciej P%C5%82a%C5%BCy%C5%84ski
Satsuki Eda	Satsuki Eda
Doctors Without Borders	M%C3%A9decins Sans Fronti%C3%A8res
Angela Merkel	Angela Merkel
Monika Harms	Monika Harms
Rick Santorum	Rick Santorum
Henk Kamp	Henk Kamp
Marisa Matias	Marisa Matias
Carles Puigdemont	Carles Puigdemont
Huda Salih Mahdi Ammash	Huda Salih Mahdi Ammash
Umar Aliyevich Dzhabrailov	Umar Dzhabrailov
Memorial University of Newfoundland	Memorial University of Newfoundland
Bill Bradley	Bill Bradley
Gwen Moore	Gwen Moore
Party of the Democratic Revolution	Party of the Democratic Revolution
Phil Robertson	Phil Robertson
Pieter Winsemius	Pieter Winsemius
Olene S. Walker	Olene Walker
Commonwealth of Nations	Commonwealth of Nations
Serhiy Arbuzov	Serhiy Arbuzov
Smile	Smile
Mark Pryor	Mark Pryor
Norbert Lammert	Norbert Lammert
Paulo Maluf	Paulo Maluf
Luis Cruz	Luis Cruz
Communist Party of the Russian Federation	Communist Party of the Russian Federation
Cesar Gaviria Trujillo	C%C3%A9sar Gaviria
Mieczyslaw Rakowski	Mieczys%C5%82aw Rakowski
Theresa May	Theresa May
Al-Riyadh	Al-Riyadh SC
Eric Raoult	%C3%89ric Raoult
Bogdan Borusewicz	Bogdan Borusewicz
Central America	Central America
Boris Efimovich Nemtsov	Boris Nemtsov
Ayaan Hirsi Ali	Ayaan Hirsi Ali
Allyson Schwartz	Allyson Schwartz
Lucien Bouchard	Lucien Bouchard
Pedro Solbes	Pedro Solbes
Masahide Ota	Masahide %C5%8Cta
Leon Panetta	Leon Panetta
David N. Dinkins	David Dinkins
Raymond W. Kelly	Raymond Kelly
Jennifer Granholm	Jennifer Granholm
Hans Blix	Hans Blix
George V. Voinovich	George Voinovich
Gérard Longuet	G%C3%A9rard Longuet
Ivan Kyrylenko	Ivan Kyrylenko
Tom Steyer	Tom Steyer
Claus Hjort Frederiksen	Claus Hjort Frederiksen
International Criminal Court	International Criminal Court
Dov Shilansky	Dov Shilansky
Juan José Lucas	Juan Jos%C3%A9 Lucas
Valerie Amos	Valerie Amos, Baroness Amos
Pasqual Maragall i Mira	Pasqual Maragall
Kevin Brady	Kevin Brady
Mircea Geoana	Mircea Geoan%C4%83
Libya	Libya
Gonzalo Aguirre Ramírez	Gonzalo Aguirre Ram%C3%ADrez
Alexander Lentsov	Alexander Lentsov
Charles University	Charles University
Dipu Moni	Dipu Moni
Stanley McChrystal	Stanley A. McChrystal
William H. Rehnquist	William Rehnquist
Eni F. H. Faleomavaega	Eni Faleomavaega
Pascal Couchepin	Pascal Couchepin
Steingrímur J. Sigfússon	Steingr%C3%ADmur J. Sigf%C3%BAsson
Vitaly Ivanovich Churkin	Vitaly Churkin
John Key	John Key
Gaston Flosse	Gaston Flosse
Umberto Bossi	Umberto Bossi
Jean-Pierre Raffarin	Jean-Pierre Raffarin
Rudolf Hundstorfer	Rudolf Hundstorfer
Werner Hoyer	Werner Hoyer
Jason Chaffetz	Jason Chaffetz
Hanja Maij-Weggen	Hanja Maij-Weggen
Carlos Cerda	Pedro Aguirre Cerda
Georgios Alogoskoufis	Georgios Alogoskoufis
Göran Persson	G%C3%B6ran Persson
Sierra Leone	Sierra Leone
Apple Inc.	Apple Inc.
Bill Ritter	Bill Ritter
Elena Salgado	Elena Salgado
Richard Celeste	Dick Celeste
Pier Ferdinando Casini	Pier Ferdinando Casini
Ivan Petrovich Rybkin	Ivan Rybkin
Artur Rasizade	Artur Rasizade
José Manuel Durão Barroso	Jos%C3%A9 Manuel Barroso
Don Young	Don Young
Elcio Alvares	%C3%89lcio %C3%81lvares
Carroll A. Campbell	Carroll A. Campbell Jr.
Secretariat of State	Secretary of state
Christine Albanel	Christine Albanel
Hasmik Poghosyan	Hasmik Poghosyan
Hillary Clinton	Hillary Clinton
Gyanendra	Gyanendra of Nepal
Microsoft	Microsoft
Abdullah bin Abdulaziz al-Saud	Abdullah of Saudi Arabia
United Nations Children's Fund	UNICEF
Jim Ramstad	Jim Ramstad
Yury Chaika	Yury Chaika
Carlos Slim	Carlos Slim
Total S.A.	TotalEnergies
Jean Spautz	Jean Spautz
Karim Masimov	Karim Massimov
Morocco	Morocco
Bud Cramer	Robert E. Cramer
Loyola de Palacio	Loyola de Palacio
Dan Tichon	Dan Tichon
Khaled bin Sultan	Khalid bin Sultan Al Saud
Arab League	Arab League
Giuseppe Bertello	Giuseppe Bertello
Jose Luis Rodriguez Zapatero	Jos%C3%A9 Luis Rodr%C3%ADguez Zapatero
Connie Mack IV	Connie Mack IV
Lions Gate Entertainment	Lionsgate
Adrian Nastase	Adrian N%C4%83stase
Marc-Philippe Daubresse	Marc-Philippe Daubresse
Morgan Tsvangirai	Morgan Tsvangirai
Iliana Iotova	Iliana Iotova
Hungarian Democratic Forum	Hungarian Democratic Forum
Erap Estrada	Joseph Estrada
Rick Scott	Rick Scott
Anil Kakodkar	Anil Kakodkar
Aamir Khan	Aamir Khan
Neritan Ceka	Neritan Ceka
Mike Crapo	Mike Crapo
Viktor Stepanov	Viktor Stepanov
Kate Brown	Kate Brown
Bahamas	The Bahamas
Lyndon Johnson	Lyndon B. Johnson
Le Duan	L%C3%AA Du%E1%BA%A9n
Bidzina Ivanishvili	Bidzina Ivanishvili
The People of Freedom	The People of Freedom
Tzipi Livni	Tzipi Livni
Norodom Sihamoni	Norodom Sihamoni
Bruno Le Maire	Bruno Le Maire
Yuriy Luzhkov	Yury Luzhkov
Amartya Sen	Amartya Sen
JPMorgan Chase	JPMorgan Chase
Argentina	Argentina
Al Green	Al Green
Khakassia	Khakassia
Martha McSally	Martha McSally
Wim Kok	Wim Kok
Gibraltar	Gibraltar
Peter Cosgrove	Peter Cosgrove
Pascal Canfin	Pascal Canfin
Dieter Althaus	Dieter Althaus
American University of Beirut Medical Center	American University of Beirut
Oskar Lafontaine	Oskar Lafontaine
Pete Peterson	Pete Peterson
Emilio Pérez Touriño	Emilio P%C3%A9rez Touri%C3%B1o
Kamrul Hassan	Quamrul Hassan
Frank-Walter Steinmeier	Frank-Walter Steinmeier
Panos Beglitis	Panagiotis Beglitis
Dariga Nazarbayeva	Dariga Nazarbayeva
Fleur Pellerin	Fleur Pellerin
Alain Berset	Alain Berset
Burkina Faso	Burkina Faso
Zbigniew Messner	Zbigniew Messner
Office of the Director of National Intelligence	Director of National Intelligence
Andrus Ansip	Andrus Ansip
Canadian Forces Land Force Command	Canadian Army
Ben Nighthorse Campbell	Ben Nighthorse Campbell
Eliane Karp	Eliane Karp
Maurizio Lupi	Maurizio Lupi
Pavel Sergeyevich Grachev	Pavel Grachev
Klansman	Ku Klux Klan
Aloizio Mercadante	Alo%C3%ADzio Mercadante
Hirofumi Nakasone	Hirofumi Nakasone
Sony	Sony
Bibiana Aído	Bibiana A%C3%ADdo
Howard Coble	Howard Coble
Lazard Ltd	Lazard
Jean Asselborn	Jean Asselborn
Joseph Ki-Zerbo	Joseph Ki-Zerbo
Tarek William Saab	Tarek William Saab
Ratko Mladić	Ratko Mladi%C4%87
David Ben-Gurion	David Ben-Gurion
Aslan Aliyevich Maskhadov	Aslan Maskhadov
Marju Lauristin	Marju Lauristin
Rutgers University	Rutgers University
Devin Nunes	Devin Nunes
Robert Mugabe	Robert Mugabe
Spanish Navy	Spanish Navy
Arvind Kejriwal	Arvind Kejriwal
Javier González Garza	Javier Gonz%C3%A1lez Garza
Gerrit Braks	Gerrit Braks
Joseph Stiglitz	Joseph Stiglitz
Adilgerei Magomedtagirov	Adilgerei Magomedtagirov
Sadako Ogata	Sadako Ogata
Khushwant Singh	Khushwant Singh
Jesse Jackson Jr.	Jesse Jackson Jr.
Vijay Bahuguna	Vijay Bahuguna
European Aeronautic Defence and Space Company	Airbus
Marat Tazhin	Marat Tajin
Connie Mack III	Connie Mack III
Tsai Ing-wen	Tsai Ing-wen
Arlene Foster	Arlene Foster
Melanie Schultz van Haegen	Melanie Schultz van Haegen
Puerto Rico	Puerto Rico
Mahathir Mohamad	Mahathir Mohamad
Donna Shalala	Donna Shalala
Tajikistan	Tajikistan
Volodymyr Semynozhenko	Volodymyr Semynozhenko
Dominique Bussereau	Dominique Bussereau
Pavel Astakhov	Pavel Astakhov
John E. Sununu	John E. Sununu
Oleg Ostapenko	Oleg Ostapenko
Tzachi Hanegbi	Tzachi Hanegbi
Mart Laar	Mart Laar
Guyana	Guyana
Jochen Borchert	Jochen Borchert
Law and Justice Party	Law and Justice
Michel Barnier	Michel Barnier
Luisa Fernanda Rudi Úbeda	Luisa Fernanda Rudi
David Bakradze	Davit Bakradze
Mozambique	Mozambique
Russia	Russia
Massachusetts Institute of Technology	Massachusetts Institute of Technology
Amanullah Khan	Amanullah Khan
Jean-Claude Gaudin	Jean-Claude Gaudin
Shankar Sharma	Shankar Dayal Sharma
Els Borst-Eilers	Els Borst
Gladys Marín	Gladys Mar%C3%ADn
Chris Murphy	Chris Murphy
Edward Snowden	Edward Snowden
Gerasimos Arsenis	Gerasimos Arsenis
Yves Guéna	Yves Gu%C3%A9na
Richard Blumenthal	Richard Blumenthal
Jelko Kacin	Jelko Kacin
Walter Kasper	Walter Kasper
Barbara A. Mikulski	Barbara Mikulski
Juan Alfonso Fuentes Soria	Juan Alfonso Fuentes Soria
Agha Mohammad Yahya Khan	Yahya Khan
Nancy Pelosi	Nancy Pelosi
Gerrit Zalm	Gerrit Zalm
Curtis Scaparrotti	Curtis Scaparrotti
Antonis Samaras	Antonis Samaras
Alain Madelin	Alain Madelin
Beppe Grillo	Beppe Grillo
Stephen Solarz	Stephen Solarz
Susana Malcorra	Susana Malcorra
James Arbuthnot	James Arbuthnot
Raúl Rivero	Ra%C3%BAl Rivero
Lothar Bisky	Lothar Bisky
Piet Hein Donner	Piet Hein Donner
Koichiro Matsuura	K%C5%8Dichir%C5%8D Matsuura
Michael Flynn	Michael Flynn
French Armed Forces	French Armed Forces
Roberto Fernández Retamar	Roberto Fern%C3%A1ndez Retamar
Anders Samuelsen	Anders Samuelsen
Olha Bohomolets	Olha Bohomolets
Madrid	Madrid
Rebiya Kadeer	Rebiya Kadeer
Chantal Jouanno	Chantal Jouanno
John R. Allen	John R. Allen
Catherine Tasca	Catherine Tasca
Alberto Bustamante Belaunde	Alberto Bustamante Bela%C3%BAnde
Vitaliy Masol	Vitaliy Masol
Jacob J. Lew	Jack Lew
Nikitas Kaklamanis	Nikitas Kaklamanis
Terry E. Branstad	Terry Branstad
Patrick J. Hillery	Patrick Hillery
Jan Pronk	Jan Pronk
Emma Bonino	Emma Bonino
Noel Davern	Noel Davern
Mark Shuttleworth	Mark Shuttleworth
Kostas Karamanlis	Kostas Karamanlis
Jim Langevin	James Langevin
Doris Leuthard	Doris Leuthard
Todd Akin	Todd Akin
John Claggett Danforth	John Danforth
Margaritis Schinas	Margaritis Schinas
Alfred Sant	Alfred Sant
Mohammad Ali Raja'i	Mohammad-Ali Rajai
Comoros	Comoros
Taro Kono	Taro Kono
Giorgos Kaminis	Giorgos Kaminis
Herbert Kickl	Herbert Kickl
Aosta Valley	Aosta Valley
Joseph Crowley	Joe Crowley
Mozah bint Nasser Al Missned	Moza bint Nasser
Adolfo Aguilar Zínser	Adolfo Aguilar Z%C3%ADnser
Secretary of State for Communities and Local Government	Secretary of State for Levelling Up, Housing and Communities
Jacques Chirac	Jacques Chirac
Ken Starr	Ken Starr
Alastair Goodlad	Alastair Goodlad
Ernest Moniz	Ernest Moniz
David Dreier	David Dreier
Per Unckel	Per Unckel
Iberia	Iberian Peninsula
Iceland	Iceland
Pio Laghi	Pio Laghi
Ana Palacio	Ana Palacio
Edelgard Bulmahn	Edelgard Bulmahn
Irina Yarovaya	Irina Yarovaya
George Weah	George Weah
Arnold Koller	Arnold Koller
Nick Raynsford	Nick Raynsford
Kiro Gligorov	Kiro Gligorov
Johann Schneider-Ammann	Johann Schneider-Ammann
Lithuania	Lithuania
Betty Boothroyd	Betty Boothroyd
Gavin Newsom	Gavin Newsom
Chaudhry Mohammad Sarwar	Chaudhry Mohammad Sarwar
Avijit Roy	Avijit Roy
Wilhelm Molterer	Wilhelm Molterer
Academia Sinica	Academia Sinica
Charles J. Melancon	Charlie Melan%C3%A7on
Jaume Matas Palou	Jaume Matas
Hans-Jürgen Papier	Hans-J%C3%BCrgen Papier
General Electric	General Electric
Akhmetzhan Yesimov	Akhmedjan Essimov
Duncan Kerr	Duncan Kerr
Norbert Hofer	Norbert Hofer
Prem Tinsulanonda	Prem Tinsulanonda
Stavanger	Stavanger
Sebastian Kurz	Sebastian Kurz
Ashraf Ghani Ahmadzai	Ashraf Ghani
South Korea	South Korea
Gerd Leers	Gerd Leers
Taha Yasin Ramadan	Taha Yassin Ramadan
María Corina Machado	Mar%C3%ADa Corina Machado
Yuriy Kravchenko	Yuriy Kravchenko
Dominique De Villepin	Dominique de Villepin
Zviad Gamsakhurdia	Zviad Gamsakhurdia
Jorge Castañeda Gutman	Jorge Casta%C3%B1eda Gutman
Peter Phillips	Peter Phillips
Karunanidhi	M. Karunanidhi
Richard Ottaway	Richard Ottaway
Dobrica Cosic	Dobrica %C4%86osi%C4%87
Monica Lewinsky	Monica Lewinsky
General Motors	General Motors
Elizabeth Dole	Elizabeth Dole
Donald M. Payne	Donald M. Payne
Saudi Arabia	Saudi Arabia
Ukraine	Ukraine
Jane Harman	Jane Harman
Hans-Rudolf Merz	Hans-Rudolf Merz
Wolfgang Tiefensee	Wolfgang Tiefensee
Sir Paul Reeves	Paul Reeves
Jan Kohout	Jan Kohout
Dick Marty	Dick Marty
Portugal	Portugal
Bruce George	Bruce George
Romania	Romania
Wolfgang Ischinger	Wolfgang Ischinger
Julio Cesar Turbay Ayala	Julio C%C3%A9sar Turbay Ayala
Apostolos Kaklamanis	Apostolos Kaklamanis
Wolfgang Schüssel	Wolfgang Sch%C3%BCssel
University of New Brunswick	University of New Brunswick
Fritz Verzetnitsch	Fritz Verzetnitsch
Franz Vranitzky	Franz Vranitzky
Zhu Rongji	Zhu Rongji
Liberal Democracy of Slovenia	Liberal Democracy of Slovenia
Jeff Bingaman	Jeff Bingaman
Hennadiy Udovenko	Hennadiy Udovenko
Peking University	Peking University
Josef Pühringer	Josef P%C3%BChringer
Equestrian Order of the Holy Sepulchre of Jerusalem	Order of the Holy Sepulchre
Ehud Olmert	Ehud Olmert
Sam Johnson	Sam Johnson
Sergey Mikhaylovich Ignatyev	Sergey Mikhaylovich Ignatyev
L'Humanité	L%27Humanit%C3%A9
Julius Nyerere	Julius Nyerere
Pablo Escobar	Pablo Escobar
Hu Jintao	Hu Jintao
Lloyd Axworthy	Lloyd Axworthy
Aleksander Szczyglo	Aleksander Szczyg%C5%82o
Palau	Palau
Jay Carney	Jay Carney
Michael E. Ryan	Michael E. Ryan
Celso Lafer	Celso Lafer
Gresham Barrett	Gresham Barrett
Joseph Muscat	Joseph Muscat
Democratic Unionist Party	Democratic Unionist Party
C. Boyden Gray	C. Boyden Gray
Glaxosmithkline	GSK plc
Radio Television of Serbia	Radio Television of Serbia
Mintimer Sharipovich Shaimiev	Mintimer Shaimiev
Bram Peper	Bram Peper
Frank Swaelen	Frank Swaelen
Michael Ignatieff	Michael Ignatieff
Hideo Higashikokubaru	Hideo Higashikokubaru
Idi Amin	Idi Amin
Tanja Fajon	Tanja Fajon
Gazprom	Gazprom
Robert Menendez	Bob Menendez
Katy Perry	Katy Perry
Boeing	Boeing
Chadli Bendjedid	Chadli Bendjedid
Central Intelligence Agency	Central Intelligence Agency
Meir Dagan	Meir Dagan
Edmund Szoka	Edmund Szoka
Daniel Scioli	Daniel Scioli
Mark Kirk	Mark Kirk
British Monarch	Monarchy of the United Kingdom
Greg Abbott	Greg Abbott
Bendt Bendtsen	Bendt Bendtsen
Claudio Huepe	Claudio Huepe
Joaquín Almunia	Joaqu%C3%ADn Almunia
Nana Addo Dankwa Akufo-Addo	Nana Akufo-Addo
Dianne Feinstein	Dianne Feinstein
Lars Løkke Rasmussen	Lars L%C3%B8kke Rasmussen
Bojan Pajtić	Bojan Pajti%C4%87
John Hickenlooper	John Hickenlooper
Tom Carper	Tom Carper
Gabon	Gabon
Lakhdar Brahimi	Lakhdar Brahimi
R.K. Pachauri	Rajendra K. Pachauri
Audi	Audi
Taiwan	Taiwan
Jose Lopez Portillo	Jos%C3%A9 L%C3%B3pez Portillo
Javier Díez Canseco	Javier Diez Canseco
Vladimir Yevtushenkov	Vladimir Yevtushenkov
Iran	Iran
Chris Huhne	Chris Huhne
Marek Jurek	Marek Jurek
Turki bin Faisal Al Saud	Turki bin Faisal Al Saud
Tulsi Gabbard	Tulsi Gabbard
Sir Patrick Mayhew	Patrick Mayhew
Nagorno-Karabakh Republic	Republic of Artsakh
David Vitter	David Vitter
Richard Nixon	Richard Nixon
International Olympic Committee	International Olympic Committee
Emilio Eduardo Massera	Emilio Eduardo Massera
Anastasios Peponis	Anastasios Peponis
Pavlos Geroulanos	Pavlos Geroulanos
Yair Lapid	Yair Lapid
William Cohen	William Cohen
Yuli Edelstein	Yuli Edelstein
Luis Echeverria Alvarez	Luis Echeverr%C3%ADa
Guilherme d'Oliveira Martins	Guilherme d%27Oliveira Martins
George Habash	George Habash
Nauru	Nauru
Ana Brnabic	Ana Brnabi%C4%87
Taslima Nasreen	Taslima Nasrin
George Radanovich	George Radanovich
José Alencar Gomes da Silva	Jos%C3%A9 Alencar
Uzi Landau	Uzi Landau
European Commission	European Commission
Tanya Plibersek	Tanya Plibersek
Mauritania	Mauritania
Vladimir Rusakevich	Vladimir Vasilievich Rusakevich
Heinz Fischer	Heinz Fischer
Helen Clark	Helen Clark
Gilles de Robien	Gilles de Robien
Democratic Left Alliance	Democratic Left Alliance
Marialiese Flemming	Marilies Flemming
Peter Welch	Peter Welch
Siv Jensen	Siv Jensen
Central European University	Central European University
Steven Chu	Steven Chu
Lesotho	Lesotho
Roger Etchegaray	Roger Etchegaray
José María Michavila Núñez	Jos%C3%A9 Mar%C3%ADa Michavila
Steny H. Hoyer	Steny Hoyer
Nokia Corporation	Nokia
Mikhail Saakashvili	Mikheil Saakashvili
Herman Van Rompuy	Herman Van Rompuy
Marcelo Ebrard	Marcelo Ebrard
Dragoljub Ojdanić	Dragoljub Ojdani%C4%87
Fine Gael	Fine Gael
Napoleon Bonaparte	Napoleon
Christine Egerszegi	Christine Egerszegi
University of Waterloo	University of Waterloo
Beverley Hughes	Beverley Hughes
Milan Uhde	Milan Uhde
Christine Haderthauer	Christine Haderthauer
Jim Molan	Jim Molan
Valentin Yumashev	Valentin Yumashev
Frans Timmermans	Frans Timmermans
Vietnam	Vietnam
Harri Holkeri	Harri Holkeri
Amitabh Bachchan	Amitabh Bachchan
Gennady Nikolayevich Troshev	Gennady Troshev
Lars Barfoed	Lars Barfoed
Bob Dole	Bob Dole
Jerry Weller	Jerry Weller
Michael Fallon	Michael Fallon
Vladimir Voronin	Vladimir Voronin
Nebojsa Stefanovic	Neboj%C5%A1a Stefanovi%C4%87
Fulgencio Batista	Fulgencio Batista
Lincoln Chafee	Lincoln Chafee
Yasuhiro Nakasone	Yasuhiro Nakasone
Nikolai Levichev	Nikolai Levichev
Enda Kenny	Enda Kenny
Cape Verde	Cape Verde
Ricardo Rosselló	Ricardo Rossell%C3%B3
Hans van den Broek	Hans van den Broek
University of the Philippines	University of the Philippines
Joseph-Désiré Mobutu	Mobutu Sese Seko
François Patriat	Fran%C3%A7ois Patriat
Ben Cardin	Ben Cardin
Hamid Ansari	Mohammad Hamid Ansari
Anders Fogh Rasmussen	Anders Fogh Rasmussen
Nokia	Nokia
Bobby Jindal	Bobby Jindal
Estonia	Estonia
Alfredo Pérez Rubalcaba	Alfredo P%C3%A9rez Rubalcaba
John Boehner	John Boehner
Mohiuddin Khan Alamgir	Muhiuddin Khan Alamgir
Sir Michael Boyce	Michael Boyce, Baron Boyce
Almazbek Atambayev	Almazbek Atambayev
Anne Hidalgo	Anne Hidalgo
Amr Waked	Amr Waked
Jeanine Hennis-Plasschaert	Jeanine Hennis-Plasschaert
Werner Faymann	Werner Faymann
Anne-Marie Lizin	Anne-Marie Lizin
Sicily	Sicily
Leonid Gozman	Leonid Gozman
Carlo Azeglio Ciampi	Carlo Azeglio Ciampi
Yerevan State University	Yerevan State University
Otto Graf Lambsdorff	Otto Graf Lambsdorff
José Bono Martínez	Jos%C3%A9 Bono
Ruprecht Polenz	Ruprecht Polenz
Rand Paul	Rand Paul
Helen Liddell	Helen Liddell
Chuck Robb	Chuck Robb
Carolyn Cheeks Kilpatrick	Carolyn Cheeks Kilpatrick
Modibo Keita	Modibo Ke%C3%AFta
Waseda University	Waseda University
Afghanistan	Afghanistan
Andrej Plenkovic	Andrej Plenkovi%C4%87
Mehdi Bazargan	Mehdi Bazargan
Paul Martin	Paul Martin
Jeb Hensarling	Jeb Hensarling
United Socialist Party of Venezuela	United Socialist Party of Venezuela
Joaquin Balaguer	Joaqu%C3%ADn Balaguer
Nicolae Timofti	Nicolae Timofti
Evangelos Meimarakis	Vangelis Meimarakis
Richard C. Holbrooke	Richard Holbrooke
Babacar Gaye	Babacar Gaye
Miklós Réthelyi	Mikl%C3%B3s R%C3%A9thelyi
Recep Tayyip Erdoğan	Recep Tayyip Erdo%C4%9Fan
Frederik Willem De Klerk	F. W. de Klerk
Carlos Holguín Sardi	Carlos Holgu%C3%ADn Sardi
Yuval Steinitz	Yuval Steinitz
Jean-David Levitte	Jean-David Levitte
Liudmyla Suprun	Liudmyla Suprun
Aleksandr Ankvab	Alexander Ankvab
Wayne T. Gilchrest	Wayne Gilchrest
Anna Fotyga	Anna Fotyga
Yash Pal Ghai	Yash Ghai
Tigran Torosyan	Tigran Torosyan
Roh Tae Woo	Roh Tae-woo
Valeriy Khoroshkovsky	Valeriy Khoroshkovskyi
Associated Press	Associated Press
Alexander Medvedev	Alexander Medvedev
Jeune Afrique	Jeune Afrique
Meretz	Meretz
François Loos	Fran%C3%A7ois Loos
Franz Müntefering	Franz M%C3%BCntefering
Nathalie Kosciusko-Morizet	Nathalie Kosciusko-Morizet
Juan Antonio Samaranch	Juan Antonio Samaranch
Chung Mong-joon	Chung Mong-joon
Vojislav Šešelj	Vojislav %C5%A0e%C5%A1elj
Dimitrios Droutsas	Dimitrios Droutsas
Narcís Serra i Serra	Narc%C3%ADs Serra
Michal Kovac	Michal Kov%C3%A1%C4%8D
Paul Biya	Paul Biya
Sheikh Hasina Wajed	Sheikh Hasina
Anne McLellan	Anne McLellan
Russ Feingold	Russ Feingold
Cory Booker	Cory Booker
Shas	Shas
Kim Kyong-hui	Kim Kyong-hui
Martin Bursík	Martin Burs%C3%ADk
Alliance for the Future of Austria	Alliance for the Future of Austria
Robert Julian Bentley	Robert J. Bentley
Montenegro	Montenegro
Yves Cochet	Yves Cochet
Telefónica	Telef%C3%B3nica
Marco Aurélio Garcia	Marco Aur%C3%A9lio Garcia
Greta Garbo	Greta Garbo
Zine El Abidine Ben Ali	Zine El Abidine Ben Ali
Robert B. Zoellick	Robert Zoellick
Joyce Quin	Joyce Quin
Francois Zimeray	Fran%C3%A7ois Zimeray
Ahmed Galal	Ahmed Galal
Pietro Lunardi	Pietro Lunardi
John Tsang	John Tsang
Scott Garrett	Scott Garrett
Jim Florio	James Florio
R.P. Singh	R. P. Singh
Volodymyr Shkidchenko	Volodymyr Shkidchenko
Claudia Nolte	Claudia Nolte
Inter-American Development Bank	Inter-American Development Bank
Ulster Unionist Party	Ulster Unionist Party
Georgi Bliznashki	Georgi Bliznashki
Guam	Guam
Liaquat Ali	Liaquat Ali Khan
Ze'ev Elkin	Ze%27ev Elkin
Hervé Morin	Herv%C3%A9 Morin
Carlos Holmes Trujillo	Carlos Holmes Trujillo
Greece	Greece
Ivo Josipovic	Ivo Josipovi%C4%87
Richard von Weizsäcker	Richard von Weizs%C3%A4cker
Angelo Scola	Angelo Scola
Aivaras Abromavicius	Aivaras Abromavi%C4%8Dius
Movement for France	Movement for France
Richard Bruton	Richard Bruton
Korean Workers Party	Workers%27 Party of Korea
Mary McAleese	Mary McAleese
HSBC Holdings	HSBC
Secretary of State for Justice	Secretary of State for Justice
Mirko Cvetkovic	Mirko Cvetkovi%C4%87
African Union	African Union
Roman Herzog	Roman Herzog
Rush Limbaugh	Rush Limbaugh
Catherine Ashton	Catherine Ashton
Jerry Moran	Jerry Moran
Maher al-Assad	Maher al-Assad
Takeaki Matsumoto	Takeaki Matsumoto
Fidesz	Fidesz
Carolyn McCarthy	Carolyn McCarthy
Joel Villanueva	Joel Villanueva
Osama bin Laden	Osama bin Laden
Elon Musk	Elon Musk
Czech Television	Czech Television
Makiko Tanaka	Makiko Tanaka
Christoph Blocher	Christoph Blocher
Abul Maal Abdul Muhith	Abul Maal Abdul Muhith
American Psychological Association	American Psychological Association
Patty Murray	Patty Murray
Sihanouk	Norodom Sihanouk
Karel Schwarzenberg	Karel Schwarzenberg
Andrew Powell	Andrew Powell
Burundi	Burundi
Dmitry Mezentsev	Dmitry Mezentsev
Vladimir Anatolyevich Yakovlev	Vladimir Anatolyevich Yakovlev
Theodor Stolojan	Theodor Stolojan
Netherlands	Netherlands
Carolina Tohá	Carolina Toh%C3%A1
Abdelaziz Bouteflika	Abdelaziz Bouteflika
Anna Eshoo	Anna Eshoo
Ernesto Samper Pizano	Ernesto Samper
John Redwood	John Redwood
Rehavam Zeevi	Rehavam Ze%27evi
Shaul Mofaz	Shaul Mofaz
Javier Hernández	Javier Hern%C3%A1ndez
Carol Moseley Braun	Carol Moseley Braun
José Mujica	Jos%C3%A9 Mujica
Lawrence Cannon	Lawrence Cannon
Joseph W. Prueher	Joseph Prueher
Rick Larsen	Rick Larsen
Richard Danzig	Richard Danzig
Disney	The Walt Disney Company
Bill Richardson	Bill Richardson
Bob Graham	Bob Graham
Georgi Pirinski	Georgi Pirinski Jr.
Chang Song Taek	Jang Song-thaek
Odilo Scherer	Odilo Scherer
Ron DeSantis	Ron DeSantis
Alexandr Vondra	Alexandr Vondra
Raffi Hovannisian	Raffi Hovannisian
David Ige	David Ige
Adrienne Clarkson	Adrienne Clarkson
Edwin Feulner	Edwin Feulner
Barbara Prammer	Barbara Prammer
Ine Marie Eriksen Søreide	Ine Eriksen S%C3%B8reide
Saint Kitts and Nevis	Saint Kitts and Nevis
United Nations	United Nations
Josef Lux	Josef Lux
Marie Bashir	Marie Bashir
Leo Varadkar	Leo Varadkar
Frank Jensen	Frank Jensen
Ilkka Suominen	Ilkka Suominen
Winnie Madikizela-Mandela	Winnie Madikizela-Mandela
Pier Luigi Bersani	Pier Luigi Bersani
Janusz Piechocinski	Janusz Piechoci%C5%84ski
Sardinia	Sardinia
Security Service of Ukraine	Security Service of Ukraine
Steve Mnuchin	Steven Mnuchin
South Sudan	South Sudan
Henrik	Henrik
Wieslaw Chrzanowski	Wies%C5%82aw Chrzanowski
Madagascar	Madagascar
V.P. Singh	V. P. Singh
Sorin Cîmpeanu	Sorin C%C3%AEmpeanu
Hans Hillen	Hans Hillen
Luiz Gushiken	Luiz Gushiken
Blagovest Sendov	Blagovest Sendov
Euskal Herria Bildu	EH Bildu
Kirk Fordice	Kirk Fordice
Oleg Belaventsev	Oleg Belaventsev
Italo Luder	%C3%8Dtalo Argentino L%C3%BAder
Luis Videgaray Caso	Luis Videgaray Caso
Pakistan People's Party	Pakistan People%27s Party
Joe Lieberman	Joe Lieberman
Rudolf Scharping	Rudolf Scharping
Holy See	Holy See
Nicole Ameline	Nicole Ameline
Igor Konashenkov	Igor Konashenkov
Janez Stanovnik	Janez Stanovnik
African National Congress	African National Congress
Seoul National University	Seoul National University
Johannes Voggenhuber	Johannes Voggenhuber
Jørgen Hårek Kosmo	J%C3%B8rgen Kosmo
Jean Schmidt	Jean Schmidt
José Ramos-Horta	Jos%C3%A9 Ramos-Horta
Roberta Pinotti	Roberta Pinotti
Panagiotis Lafazanis	Panagiotis Lafazanis
Wolfgang Bötsch	Wolfgang B%C3%B6tsch
Boiko Borisov	Boyko Borisov
Simon Coveney	Simon Coveney
Laurent Fabius	Laurent Fabius
Srgjan Kerim	Srgjan Kerim
María Jesús Montero	Mar%C3%ADa Jes%C3%BAs Montero
Dawn Primarolo	Dawn Primarolo
Turkmenistan	Turkmenistan
Mauno Koivisto	Mauno Koivisto
Virgin Islands, U.S.	United States Virgin Islands
Robin Cook	Robin Cook
Michael Bloomberg	Michael Bloomberg
Oscar Luigi Scalfaro	Oscar Luigi Scalfaro
Oleh Lyashko	Oleh Liashko
Josh Frydenberg	Josh Frydenberg
Sufis	Sufism
French Army	French Army
Chiang Ching-kuo	Chiang Ching-kuo
Monika Wulf-Mathies	Monika Wulf-Mathies
Pepsico	PepsiCo
Ivor Seward Richard	Ivor Richard
Provisional Irish Republican Army	Provisional Irish Republican Army
Omar Bongo	Omar Bongo
Nursultan Nazarbayev	Nursultan Nazarbayev
Joe Knollenberg	Joe Knollenberg
Juan Lozano	Juan Lozano
Bucharest Academy of Economic Studies	Bucharest Academy of Economic Studies
Didier Burkhalter	Didier Burkhalter
Leonard Solis	Leonardo Rodr%C3%ADguez Sol%C3%ADs
Charlie Baker	Charlie Baker
Pontifical Catholic University of Chile	Pontifical Catholic University of Chile
Pál Vastagh	P%C3%A1l Vastagh
Fareed Zakaria	Fareed Zakaria
Karl Schlögl	Karl Schl%C3%B6gl
Luis Posada Carriles	Luis Posada Carriles
Ernie Fletcher	Ernie Fletcher
Péter Erdő	P%C3%A9ter Erd%C5%91
Vilnius University	Vilnius University
Jerry Brown	Jerry Brown
Nigel Evans	Nigel Evans
Kristiina Ojuland	Kristiina Ojuland
Alfonso Lopez Michelsen	Alfonso L%C3%B3pez Michelsen
Ioannis Varvitsiotis	Ioannis Varvitsiotis
Darrell Issa	Darrell Issa
Omar Torrijos Herrera	Omar Torrijos
Akhmad Abdulkhamidovich Kadyrov	Akhmad Kadyrov
Thierry Mariani	Thierry Mariani
Oleksandr Kuzmuk	Oleksandr Kuzmuk
Alfonso Guerra González	Alfonso Guerra
United Arab Emirates	United Arab Emirates
Filippo Mancuso	Filippo Mancuso
Raymond Barre	Raymond Barre
Robert Lepikson	Robert Lepikson
Lodewijk Asscher	Lodewijk Asscher
Mark Dayton	Mark Dayton
Luis Fortuño	Luis Fortu%C3%B1o
Baltasar Garzón	Baltasar Garz%C3%B3n
Meir Sheetrit	Meir Sheetrit
Joseph Stalin	Joseph Stalin
Walter Momper	Walter Momper
Earl Blumenauer	Earl Blumenauer
Andrew Robathan	Andrew Robathan
Chechnya	Chechnya
Bob Taft	Bob Taft
Giuseppe Pisanu	Giuseppe Pisanu
Paul Tsongas	Paul Tsongas
Ryerson University	Toronto Metropolitan University
Tom Udall	Tom Udall
Peter DeFazio	Peter DeFazio
Marko Mihkelson	Marko Mihkelson
Jorge Illueca	Jorge Illueca
Richard Branson	Richard Branson
Eli Suissa	Eli Suissa
Konstantine Gamsakhurdia	Konstantine Gamsakhurdia
Harrison Ford	Harrison Ford
Vincent Peillon	Vincent Peillon
Anthony G. Brown	Anthony G. Brown
Suriname	Suriname
Jim Doyle	Jim Doyle
Maria Elena Boschi	Maria Elena Boschi
László Kövér	L%C3%A1szl%C3%B3 K%C3%B6v%C3%A9r
Jean Corston	Jean Corston, Baroness Corston
Don Manzullo	Don Manzullo
Lionel Frost Bowen	Lionel Bowen
Stephen F. Lynch	Stephen F. Lynch
Evripidis Stylianidis	Evripidis Stylianidis
Patrick Ollier	Patrick Ollier
Mansoura	Mansoura, Egypt
Sahabzada Yaqub Khan	Sahabzada Yaqub Khan
Petar Gracanin	Petar Gra%C4%8Danin
Giuliano Amato	Giuliano Amato
Ed van Thijn	Ed van Thijn
Ehud Barak	Ehud Barak
Dan Boren	Dan Boren
Batt O'Keeffe	Batt O%27Keeffe
Dimitrij Rupel	Dimitrij Rupel
Michael Dukakis	Michael Dukakis
Tarcisio Bertone	Tarcisio Bertone
François Goulard	Fran%C3%A7ois Goulard
Amy Adams	Amy Adams
Zoltán Gál	Zolt%C3%A1n G%C3%A1l
Saken Zhasuzakov	Saken Zhasuzakov
Kristina Köhler	Kristina Schr%C3%B6der
Habib Bourguiba	Habib Bourguiba
Slovakia	Slovakia
Geoff Davis	Geoff Davis
Gabi Zimmer	Gabi Zimmer
Eduardo Brizuela del Moral	Eduardo Brizuela del Moral
Mauritius	Mauritius
Lee Kun-hee	Lee Kun-hee
José Vicente Rangel	Jos%C3%A9 Vicente Rangel
Kjell Magne Bondevik	Kjell Magne Bondevik
Yuriy Ilyin	Yuriy Ilyin
Le Point	Le Point
Communist Party of India	Communist Party of India
J Jayalalithaa	J. Jayalalithaa
Jon Tester	Jon Tester
Belgium	Belgium
Andrew H. Card	Andrew Card
Kiran Desai	Kiran Desai
Alain Juppe	Alain Jupp%C3%A9
Anke Fuchs	Anke Fuchs
Rumen Radev	Rumen Radev
Saint Vincent and the Grenadines	Saint Vincent and the Grenadines
Honduras	Honduras
Danny Pieters	Danny Pieters
Johnny Isakson	Johnny Isakson
Jordi Turull	Jordi Turull
Steven R. Rothman	Steve Rothman
Jose E. Serrano	Jos%C3%A9 E. Serrano
Abdullah II of Jordan	Abdullah II of Jordan
International Monetary Fund	International Monetary Fund
Mark Binskin	Mark Binskin
Sonny Perdue	Sonny Perdue
Pierre Werner	Pierre Werner
Mary Fallin	Mary Fallin
Krzysztof Kwiatkowski	Krzysztof Kwiatkowski
Gabor Vona	G%C3%A1bor Vona
Elizabeth II	Elizabeth II
Yoani Sánchez	Yoani S%C3%A1nchez
Alice Rivlin	Alice Rivlin
Council of Europe	Council of Europe
Victor Ciorbea	Victor Ciorbea
Kenji Goto	Kenji Goto
Cristina Garmendia	Cristina Garmendia
Carlos Alberto Tévez	Carlos Tevez
Kadima	Kadima
Susana Martinez	Susana Martinez
Secretary of State for International Development	Secretary of State for International Development
Norbert Blüm	Norbert Bl%C3%BCm
Francis Maude	Francis Maude
Dimitrios Grapsas	Dimitrios Grapsas
Peter Polt	P%C3%A9ter Polt
Arnold Schwarzenegger	Arnold Schwarzenegger
Mohammad Reza Pahlavi	Mohammad Reza Pahlavi
Pawel Kukiz	Pawe%C5%82 Kukiz
Vladimir Markin	Vladimir Markin
Kristina Keneally	Kristina Keneally
New Democratic Party	New Democratic Party
Patricia Scotland	Patricia Scotland
Ruth Dreifuss	Ruth Dreifuss
Yves Leterme	Yves Leterme
Jan Olszewski	Jan Olszewski
Dennis Daugaard	Dennis Daugaard
Josep Piqué i Camps	Josep Piqu%C3%A9
William Luther Pierce	William Luther Pierce
Lloyd Doggett	Lloyd Doggett
Peronist Youth	Peronism
Algirdas Butkevičius	Algirdas Butkevi%C4%8Dius
Melissa Bean	Melissa Bean
Redha Malek	Redha Malek
Olafur Ragnar Grimsson	%C3%93lafur Ragnar Gr%C3%ADmsson
Douglas Alexander	Douglas Alexander
Magomedali Magomedov	Magomedali Magomedov
Poul Nielson	Poul Nielson
Reinhard Klimmt	Reinhard Klimmt
Hans Hækkerup	Hans H%C3%A6kkerup
Progressive Movement	Progressivism
Ulla Schmidt	Ulla Schmidt
Union of Right Forces	Union of Right Forces
Alexis Tsipras	Alexis Tsipras
Rudy Giuliani	Rudy Giuliani
Eliot L. Engel	Eliot Engel
Santiago Creel	Santiago Creel
Nikolay Dobrev	Nikolay Dobrev
Sir Richard Dannatt	Richard Dannatt
Pope Francis	Pope Francis
Mitch Landrieu	Mitch Landrieu
Volodymyr Khandohiy	Volodymyr Khandohiy
Chaim Herzog	Chaim Herzog
Mark Robert Warner	Mark Warner
Ryszard Kalisz	Ryszard Kalisz
John F. Tierney	John F. Tierney
Rodrigo Rato	Rodrigo Rato
Caribbean Community	Caribbean Community
Sanna Marin	Sanna Marin
Jim Risch	Jim Risch
Brookings Institute	Brookings Institution
New York City Police Department	New York City Police Department
Penny Pritzker	Penny Pritzker
Serikbolsyn Abdildin	Serikbolsyn Abdildin
Sotirios Hatzigakis	Sotirios Hatzigakis
Oliver Letwin	Oliver Letwin
Ramón José Velásquez	Ram%C3%B3n Jos%C3%A9 Vel%C3%A1squez
Somnath Chatterjee	Somnath Chatterjee
Jerónimo Saavedra	Jer%C3%B3nimo Saavedra
John Brumby	John Brumby
Matti Vanhanen	Matti Vanhanen
Jaroslaw Kalinowski	Jaros%C5%82aw Kalinowski
Deve Gowda	H. D. Deve Gowda
Rosa Aguilar	Rosa Aguilar
Valeriy Horbatov	Valeriy Horbatov
Jean-Louis Bruguière	Jean-Louis Brugui%C3%A8re
Fernando Flores	Fernando Flores
York University	York University
Greg Walden	Greg Walden
Jair Bolsonaro	Jair Bolsonaro
Michael Howard	Michael Howard
Peter Szijjarto	P%C3%A9ter Szijj%C3%A1rt%C3%B3
Satya Nadella	Satya Nadella
Deutsche Bahn AG	Deutsche Bahn
Jim Bunning	Jim Bunning
Giancarlo Galan	Giancarlo Galan
Félix Houphouët-Boigny	F%C3%A9lix Houphou%C3%ABt-Boigny
Ludwik Dorn	Ludwik Dorn
Buryatia	Buryatia
Omar Abdel-Rahman	Omar Abdel-Rahman
Novruz Mammadov	Novruz Mammadov
Glenn Greenwald	Glenn Greenwald
Adán Martín Menis	Ad%C3%A1n Mart%C3%ADn Menis
Office of HM Paymaster General	Paymaster General
Yusuf al-Qaradawi	Yusuf al-Qaradawi
Fianna Fáil	Fianna F%C3%A1il
Ljiljana Zelen Karadzic	Radovan Karad%C5%BEi%C4%87
Igor Klimov	Igor Klimov
Giampaolo Di Paola	Giampaolo Di Paola
Alberto Fujimori	Alberto Fujimori
Gérard Collomb	G%C3%A9rard Collomb
John W. Warner	John Warner
Peter Hintze	Peter Hintze
French Navy	French Navy
Kongsberg	Kongsberg
Peeter Kreitzberg	Peeter Kreitzberg
Longin Pastusiak	Longin Pastusiak
True Finns	Finns Party
Ron Wyden	Ron Wyden
Vagit Alekperov	Vagit Alekperov
Hamid Karzai	Hamid Karzai
Soraya Saenz de Santamaria	Soraya S%C3%A1enz de Santamar%C3%ADa
Hezbollah	Hezbollah
Zoran Djindjic	Zoran %C4%90in%C4%91i%C4%87
Enrique Múgica Herzog	Enrique M%C3%BAgica
Tim Fischer	Tim Fischer
Renato Soru	Renato Soru
Tim Holden	Tim Holden
Chiang Kai-shek	Chiang Kai-shek
Vladimir Titov	Vladimir Georgiyevich Titov
Alexei Mordashov	Alexei Mordashov
Lech Walesa	Lech Wa%C5%82%C4%99sa
Benin	Benin
Michael Spindelegger	Michael Spindelegger
Janis Jurkans	J%C4%81nis Jurk%C4%81ns
Ginés González García	Gin%C3%A9s Gonz%C3%A1lez Garc%C3%ADa
Carlos Andrés Pérez	Carlos Andr%C3%A9s P%C3%A9rez
Uladzimir Niaklajeu	Uladzimir Nyaklyayew
Ellen Johnson-Sirleaf	Ellen Johnson Sirleaf
Muammar al-Qaddafi	Muammar Gaddafi
András Bozóki	Andr%C3%A1s Boz%C3%B3ki
Pakistan	Pakistan
Norm Coleman	Norm Coleman
Berkshire Hathaway Inc.	Berkshire Hathaway
Gabriel Oprea	Gabriel Oprea
Volodymyr Lytvyn	Volodymyr Lytvyn
Hassan II	Hassan II of Morocco
University of Buenos Aires	University of Buenos Aires
Adobe Systems	Adobe Inc.
Abdalá Bucaram Ortiz	Abdal%C3%A1 Bucaram
Dave Weldon	Dave Weldon
Guillermo Fernández de Soto	Guillermo Fern%C3%A1ndez de Soto
David Johnston	David Johnston
Cisco Systems	Cisco
Andres Pastrana Arango	Andr%C3%A9s Pastrana Arango
Jacques Santer	Jacques Santer
Edith Cresson	%C3%89dith Cresson
Tariq Aziz	Tariq Aziz
Uffe Ellemann-Jensen	Uffe Ellemann-Jensen
Solomon Passy	Solomon Passy
Jutta Urpilainen	Jutta Urpilainen
Kirsten E. Gillibrand	Kirsten Gillibrand
Nabil el-Araby	Nabil Elaraby
Hugo Banzer Suárez	Hugo Banzer
Wolfgang Priklopil	Natascha Kampusch
Bill Shorten	Bill Shorten
Robin Hayes	Robin Hayes
Pedro Carmona Estanga	Pedro Carmona
Eric Cantor	Eric Cantor
Eric Besson	%C3%89ric Besson
Laurenz Meyer	Laurenz Meyer
Peter Wittig	Peter Wittig
Irene Pivetti	Irene Pivetti
Lisa Murkowski	Lisa Murkowski
Bernd Lange	Bernd Lange
Syrian Social Nationalist Party	Syrian Social Nationalist Party
Erkki Tuomioja	Erkki Tuomioja
Norm Kelly	Norm Kelly
Alexandre Léontieff	Alexandre L%C3%A9ontieff
Israeli Defense Forces	Israel Defense Forces
Forza Italia	Forza Italia
Renaud Dutreil	Renaud Dutreil
Ahn Cheol Soo	Ahn Cheol-soo
Marilyn Musgrave	Marilyn Musgrave
Borut Pahor	Borut Pahor
Salvatore Cuffaro	Salvatore Cuffaro
Mel Carnahan	Mel Carnahan
Alu Alkhanov	Alu Alkhanov
Leonid Kozhara	Leonid Kozhara
Lamar Alexander	Lamar Alexander
Hans-Peter von Kirchbach	Hans-Peter von Kirchbach
Søren Gade	S%C3%B8ren Gade
Allan Rock	Allan Rock
Shanghai Cooperation Organization	Shanghai Cooperation Organisation
Kit Bond	Kit Bond
Guusje ter Horst	Guusje ter Horst
Lucas Papademos	Lucas Papademos
Spain	Spain
Keizo Obuchi	Keiz%C5%8D Obuchi
Cristina Fernández de Kirchner	Cristina Fern%C3%A1ndez de Kirchner
Chris Grayling	Chris Grayling
József Hámori	J%C3%B3zsef H%C3%A1mori
Royal Australian Air Force	Royal Australian Air Force
Narendra Modi	Narendra Modi
Mike Simpson	Mike Simpson
Canadian Armed Forces	Canadian Armed Forces
Hassan Rouhani	Hassan Rouhani
